Gauntlet (rev 1 - 9)
Maze number: 61
Offset for maze 60: 235038 - 0x03961e
big endian buf: [%!l(uint8=0) %!l(uint8=3) %!l(uint8=150) %!l(uint8=30)]
G:1 Maze real addr: 243233 - 0x03B621, bank 1, boff: 0x2000
Maze read from: 0x03b621 - 243233
compresssed: 251
 00 00 00 00 00 10 C1 11 A0 68 5A 44 C5 2A A0 2A
 C3 18 A0 C6 62 A1 43 E5 C1 27 A0 E3 C1 27 54 A0
 2A 42 A2 E3 E9 E2 E2 C4 A1 2C E2 C2 A4 35 E2 E4
 58 E1 E7 C9 1E E7 E2 C7 A1 E3 E2 C2 43 1D C6 1C
 C4 60 A0 E1 2C A0 C5 43 E3 C1 A2 E3 1B C0 A1 E2
 C4 43 C4 63 A0 C7 61 28 A0 E8 C7 19 A0 C7 A3 C8
 69 A0 D1 B9 E3 76 A0 E1 C4 1C E8 C3 1D B6 1B E0
 E3 1D E5 E4 E3 C0 2A E5 D0 2B A1 E2 03 83 E2 CA
 A3 BF C1 35 A0 C6 B2 C2 1B 7B 72 E1 65 1B A0 EE
 E2 C2 A1 E5 03 82 C1 B4 C2 B7 C2 2A C4 26 E2 75
 E0 C0 B3 71 A0 C1 1F A3 E4 50 A0 1E EA E2 C3 61
 2B E4 C6 B2 A0 19 E2 C2 19 A0 CF B6 C4 A1 E2 E3
 ED E0 E5 71 A0 C1 06 A0 51 B4 E9 E1 1B C8 A2 E2
 E9 C3 A9 CC 1D D6 25 C7 B5 21 CD 62 28 A0 E1 C1
 A2 0E 80 C0 AF A3 C8 0E 86 D7 0E 86 C1 18 53 C2
 2B E5 C1 05 C0 BE 0E 86 F1 C3 00
  Encoded length: 251 bytes
  Wall pattern: 00, Wall color: 01     Floor pattern: 01, Floor color: 12
  Flags: 
 02 02 02 02 02 02 02 02 02 02 02 02 02 02 02 02 02 02 02 02 02 02 02 02 02 02 02 02 02 02 02 02 02
 02 17 17 17 17 00 00 00 00 00 00 42 02 42 00 00 00 00 24 02 00 00 00 00 00 00 00 32 00 00 00 02 02
 02 17 17 17 17 00 00 00 00 00 00 02 00 00 39 02 00 00 00 00 02 00 00 39 00 00 00 00 00 40 02 42 02
 02 17 17 02 02 02 00 00 00 00 02 00 00 00 00 00 00 00 00 00 00 02 00 00 00 02 00 00 00 02 00 00 02
 02 00 00 02 02 44 00 00 00 02 00 00 00 02 02 02 02 02 53 00 00 00 02 00 00 00 00 00 02 00 00 00 02
 02 00 00 00 02 00 40 00 00 02 00 00 00 00 00 00 00 00 02 00 00 00 00 00 00 00 00 00 00 30 00 00 02
 02 00 00 00 02 00 02 00 00 00 02 00 00 00 00 00 00 00 00 02 02 00 00 00 00 02 00 00 00 02 00 00 02
 02 17 17 17 02 29 00 00 00 00 00 02 00 28 00 00 00 00 00 32 00 02 00 00 02 44 02 00 00 00 00 00 02
 02 17 17 17 02 00 00 00 00 02 00 02 02 02 02 00 00 00 00 02 27 00 02 02 00 00 00 02 00 00 00 00 02
 02 17 17 17 02 00 00 00 00 00 32 02 00 00 00 02 00 00 00 00 00 00 00 00 32 00 00 40 02 00 00 00 02
 02 00 00 00 02 00 02 00 00 00 00 02 00 00 00 25 02 00 00 00 00 00 00 00 00 02 02 02 02 00 00 00 02
 02 00 00 00 02 00 32 00 00 00 00 02 00 00 00 00 00 02 00 00 00 00 00 00 02 00 00 00 00 00 00 00 02
 02 00 00 00 02 00 00 00 00 02 00 02 00 00 00 00 00 26 02 00 00 02 00 00 02 00 00 28 00 00 00 00 02
 02 00 00 00 00 02 00 00 00 00 29 02 27 00 02 00 00 00 00 02 29 00 00 00 02 00 00 02 00 00 00 00 02
 02 02 00 00 00 00 02 00 42 00 00 00 02 00 00 02 00 00 00 00 02 00 00 00 02 00 00 00 00 00 00 00 02
 02 43 02 02 00 00 00 02 03 03 03 03 02 00 00 00 02 00 00 00 02 00 00 00 02 00 00 00 02 02 02 02 02
 02 00 00 53 02 00 00 00 02 00 00 00 02 00 00 00 27 02 00 00 02 00 00 00 02 00 00 00 00 26 00 00 02
 02 26 00 00 02 32 00 00 02 00 00 00 27 02 00 00 00 02 00 00 02 00 00 00 02 00 00 00 00 02 00 00 02
 02 02 00 00 00 02 02 00 02 00 00 00 00 02 03 03 03 02 00 00 02 00 00 00 02 00 00 00 42 00 00 00 02
 02 00 38 00 00 00 02 00 02 00 00 00 02 26 00 02 00 02 00 00 26 02 00 00 31 02 02 02 02 00 00 00 02
 02 00 02 00 40 02 30 00 02 00 00 00 02 00 00 00 00 00 02 00 00 00 02 00 00 00 00 32 02 00 43 00 02
 02 00 00 00 02 00 00 00 02 00 00 00 02 02 25 00 00 00 02 00 00 00 25 02 00 00 00 00 02 00 00 00 02
 02 00 00 02 00 00 00 00 02 00 00 00 00 00 02 02 00 00 00 02 00 00 00 00 02 00 00 00 02 00 00 00 02
 02 00 00 02 00 00 00 02 00 02 00 00 00 00 00 00 02 00 00 26 02 00 00 06 02 00 00 40 02 00 00 00 02
 02 00 00 02 00 00 00 02 00 00 02 27 00 00 00 00 00 00 00 00 00 02 02 02 00 00 00 02 00 00 00 00 02
 02 00 00 02 00 00 02 00 00 00 00 02 02 02 02 02 02 02 02 02 02 00 00 00 00 00 00 00 00 00 00 00 02
 02 00 29 02 00 00 00 00 00 00 00 00 00 00 00 00 00 00 00 00 00 00 00 00 00 00 37 00 00 00 00 00 02
 02 00 00 02 33 00 00 00 00 00 00 00 00 00 00 00 00 00 00 32 00 00 00 40 02 00 00 02 00 00 02 02 02
 02 14 14 00 02 02 02 02 02 02 02 02 02 02 02 02 02 02 02 02 02 02 02 02 00 00 00 00 00 00 00 00 02
 02 14 14 14 14 14 14 14 14 00 00 00 00 00 00 00 00 00 00 00 00 00 00 00 00 00 00 00 00 00 00 00 02
 02 14 14 14 14 14 14 14 14 00 00 24 00 00 00 00 40 00 00 00 43 00 00 00 00 00 00 02 00 00 05 00 02
 02 14 14 14 14 14 14 14 14 00 00 00 00 00 00 00 00 00 00 00 00 00 00 00 00 00 00 02 00 00 00 00 02
 02 02 02 02 02 02 02 02 02 02 02 02 02 02 02 02 02 02 02 02 02 02 02 02 02 02 02 02 02 02 02 02 02
