Gauntlet (rev 1 - 9)
Maze number: 52
Offset for maze 51: 229643 - 0x03810b
big endian buf: [%!l(uint8=0) %!l(uint8=3) %!l(uint8=129) %!l(uint8=11)]
G:1 Maze real addr: 254222 - 0x03E10E, bank 3, boff: 0x6000
Maze read from: 0x03e10e - 254222
compresssed: 169
 0E 07 02 01 08 11 EA 5D 5A 28 6A C1 2C A0 F7 41
 E4 C9 05 E8 E7 F7 E7 F3 44 E1 F7 E7 F3 E7 F7 E7
 F3 E7 C5 35 F0 40 E5 F3 C7 28 D7 28 E3 E0 E0 E0
 E0 E0 E0 E0 E0 E0 E0 E0 E0 E0 E0 E0 FF E0 E0 E0
 E0 E0 E0 E0 E0 E0 E0 E0 E0 E0 E0 E0 DF 61 70 A0
 0B 85 1A 0B 84 2A 0B 85 A0 60 C1 03 9E DF DF DF
 DF DF 1A 63 63 C1 28 C1 1B C1 28 C1 1B 63 DF DF
 C3 28 40 C0 28 41 C1 28 41 C1 28 C1 1E C0 28 41
 C1 28 40 DF C7 28 C5 28 C5 28 C7 28 C7 0E CC 0E
 C7 0E C7 18 CC 18 C7 18 73 C1 53 0E 53 74 C4 53
 0E 53 71 C2 53 06 53 C0 00
  Encoded length: 169 bytes
  Wall pattern: 01, Wall color: 10     Floor pattern: 01, Floor color: 14
  Flags: 
 02 02 02 02 02 02 02 02 02 02 02 02 02 02 02 02 02 02 02 02 02 02 02 02 02 02 02 02 02 02 02 02 02
 00 00 44 02 00 00 00 00 00 00 00 00 00 00 00 00 00 00 00 00 00 00 00 00 00 00 00 00 02 00 00 29 00
 00 00 00 00 00 02 00 00 00 00 00 00 00 00 00 00 05 00 00 00 00 00 00 00 00 00 02 00 00 00 00 00 00
 00 00 00 02 00 00 00 00 00 00 00 00 00 00 00 00 00 00 00 00 00 00 00 00 00 00 00 00 02 00 00 00 00
 00 00 00 00 00 02 00 00 00 00 00 00 00 00 00 00 00 00 00 00 00 00 00 00 00 00 02 00 00 00 00 00 00
 29 00 00 02 00 00 00 00 00 00 00 00 00 00 00 00 00 00 00 00 00 00 00 00 00 00 00 00 02 00 00 00 29
 00 00 00 00 00 02 00 00 00 00 00 00 00 00 00 00 00 00 00 00 00 00 00 00 00 00 02 00 00 00 00 00 00
 00 00 00 02 00 00 00 00 00 00 00 00 00 00 00 00 00 00 00 00 00 00 00 00 00 00 00 00 02 00 00 00 00
 00 00 00 00 00 02 00 00 00 00 00 00 00 00 00 00 00 00 00 00 00 00 00 00 00 00 02 00 00 00 00 00 00
 00 00 00 02 00 00 00 00 00 00 53 00 00 00 00 00 00 00 00 00 00 00 00 00 00 00 00 00 02 00 29 00 00
 00 00 00 00 00 02 00 00 00 00 00 00 00 00 00 00 00 00 00 00 00 00 00 00 00 00 02 00 00 00 00 00 00
 00 00 00 40 00 00 00 00 00 00 00 00 00 00 00 00 00 00 00 00 00 00 00 00 00 00 00 00 40 00 00 00 00
 00 02 00 02 00 02 00 02 00 02 00 02 00 02 00 02 00 02 00 02 00 02 00 02 00 02 00 02 00 02 00 02 00
 00 00 00 00 00 00 00 00 00 00 00 00 00 00 00 00 00 00 00 00 00 00 00 00 00 00 00 00 00 00 00 00 00
 02 00 02 00 02 00 02 00 02 00 02 00 02 00 02 00 02 00 02 00 02 00 02 00 02 00 02 00 02 00 02 00 02
 00 00 00 00 00 00 00 00 00 00 00 00 00 00 00 00 00 00 00 00 00 00 00 00 00 00 00 00 00 00 00 00 00
 00 26 00 42 02 11 11 11 11 11 11 11 26 11 11 11 11 11 11 42 11 11 11 11 11 11 11 02 00 26 00 00 00
 03 03 03 03 03 03 03 03 03 03 03 03 03 03 03 03 03 03 03 03 03 03 03 03 03 03 03 03 03 03 03 03 03
 00 00 00 00 00 00 00 00 00 00 00 00 00 00 00 00 00 00 00 00 00 00 00 00 00 00 00 00 00 00 00 00 00
 00 00 00 00 00 00 00 00 00 00 00 00 00 00 00 00 00 00 00 00 00 00 00 00 00 00 00 00 00 00 00 00 00
 00 00 00 00 00 00 00 00 00 00 00 00 00 00 00 00 00 00 00 00 00 00 00 00 00 00 00 00 00 00 00 00 00
 00 00 00 00 00 00 00 00 00 00 00 00 00 00 00 00 00 00 00 00 00 00 00 00 00 00 00 00 00 00 00 00 00
 00 00 00 00 00 00 00 00 00 00 00 00 00 00 00 00 00 00 00 00 00 00 00 00 00 00 00 00 00 00 00 00 00
 26 00 00 00 00 26 00 00 00 00 26 00 00 40 00 00 27 00 00 40 00 00 27 00 00 00 00 26 00 00 00 00 26
 00 00 00 00 00 00 00 00 00 00 00 00 00 00 00 00 00 00 00 00 00 00 00 00 00 00 00 00 00 00 00 00 00
 00 00 00 00 00 00 00 00 00 00 00 00 00 00 00 00 00 00 00 00 00 00 00 00 00 00 00 00 00 00 00 00 00
 40 00 29 00 40 00 00 29 00 00 40 00 00 29 00 00 40 00 00 30 00 40 00 00 29 00 00 40 00 29 00 00 40
 00 00 00 00 00 00 00 00 00 00 00 00 00 00 00 00 00 00 00 00 00 00 00 00 00 00 00 00 00 00 00 00 00
 00 00 00 00 00 40 40 40 00 00 00 00 00 40 00 00 00 00 00 40 40 40 00 00 00 00 00 00 40 40 40 00 00
 00 00 00 00 00 40 14 40 00 00 00 00 00 00 00 00 00 00 00 40 14 40 00 00 00 00 00 00 40 14 40 00 00
 00 00 00 00 00 40 24 40 00 00 00 00 00 00 00 00 00 00 00 40 24 40 00 00 00 00 00 00 40 24 40 00 00
 00 00 42 00 00 40 14 40 00 00 00 00 00 42 00 00 00 00 00 40 14 40 00 00 42 00 00 00 40 06 40 00 00
 02 02 02 02 02 02 02 02 02 02 02 02 02 02 02 02 02 02 02 02 02 02 02 02 02 02 02 02 02 02 02 02 02
