Gauntlet (rev 1 - 9)
Maze number: 38
Offset for maze 37: 230511 - 0x03846f
big endian buf: [%!l(uint8=0) %!l(uint8=3) %!l(uint8=132) %!l(uint8=111)]
G:1 Maze real addr: 238706 - 0x03A472, bank 1, boff: 0x2000
Maze read from: 0x03a472 - 238706
compresssed: 382
 16 1D 07 19 00 10 08 68 B5 04 0E C1 21 E0 C7 2A
 E1 21 10 67 04 0B 82 C2 04 62 A0 E2 2C C0 04 10
 AA 0B 82 E2 E2 C0 20 E0 E2 10 C0 18 0E 80 0C 0E
 0C 0E 80 0C C0 0B 82 C3 A2 C0 A2 C0 A2 10 80 C1
 03 82 A0 03 80 A3 03 41 E0 C4 0A 84 C0 10 CA 2A
 C3 0D 28 04 C1 26 A0 C0 0A 84 C0 10 E2 28 51 20
 A0 63 20 C0 35 0D 80 A0 63 0A 84 B2 28 E2 E2 E3
 C1 AC 03 A0 40 C3 A2 E5 C4 6E 20 40 06 C3 20 48
 21 C9 56 03 84 C2 35 A0 C1 0D 81 C0 67 1B C1 12
 40 A0 0C 0E 0C 18 C1 57 A1 E2 03 A6 03 A0 B4 E0
 C3 A5 B3 35 A0 C2 20 C0 2A C2 21 E1 C8 BB 44 E4
 67 04 E2 20 42 80 C0 20 C2 2A E5 C1 1B CC B6 E2
 0F 20 40 C3 20 C1 BF E0 41 C0 35 A7 C0 A2 C0 A6
 BE 35 A0 C2 62 28 C0 B2 C1 63 A0 C5 35 A0 C2 2E
 A0 C6 0D C1 04 E2 20 C1 04 C2 0F 20 C1 04 C8 1E
 C1 0A 0D E0 2A E5 2C C1 0F E2 72 72 E6 C1 AA C0
 A6 C0 A7 C3 66 28 E1 43 C1 0E C3 21 11 81 CE 04
 40 44 1E C3 35 11 C0 0D 82 C8 21 C4 72 28 C0 72
 0E 80 C1 B3 E3 03 A0 C3 05 C3 62 A2 C0 A3 E1 CF
 B5 E6 60 12 40 A0 2C E1 C2 1E C8 04 C6 04 C3 0D
 E2 C2 0D C0 0D BF E6 72 CA 0D E1 0F 42 81 AC C3
 72 71 72 B4 A2 E7 C4 61 0D 81 B6 40 CB 11 C1 12
 C0 04 C1 20 28 C3 0D 81 04 C0 1B CA 11 80 BE E2
 C4 61 0D 81 A0 C0 2A C0 B4 C7 11 21 11 00
  Encoded length: 382 bytes
  Wall pattern: 00, Wall color: 08     Floor pattern: 01, Floor color: 00
  Flags: 
 02 02 02 02 02 02 02 02 02 02 02 02 02 02 02 02 02 02 02 02 02 02 02 02 02 02 02 02 02 02 02 02 02
 02 00 33 00 02 00 00 00 00 00 00 00 00 42 00 00 02 33 16 53 00 00 00 00 00 00 00 00 04 11 11 11 02
 02 00 00 00 04 53 00 00 00 02 00 00 00 02 44 00 04 16 02 02 02 02 02 02 02 02 02 02 02 11 11 11 02
 02 00 00 00 02 00 00 00 02 00 32 00 02 00 00 00 02 16 02 24 14 14 12 14 12 14 14 12 02 11 11 11 02
 02 00 00 00 00 02 02 02 00 02 02 02 00 02 02 02 16 16 02 04 03 03 03 03 02 03 03 04 02 02 02 03 02
 02 00 40 00 02 00 00 00 00 00 10 10 10 10 10 10 02 16 02 04 00 00 00 04 00 00 00 04 02 42 00 00 02
 02 00 13 40 04 00 00 38 02 00 10 10 10 10 10 10 02 16 02 04 00 02 40 04 32 02 53 04 02 00 00 32 02
 02 53 13 13 02 53 00 00 00 00 10 10 10 10 10 10 02 40 02 04 00 02 00 00 00 02 00 04 02 00 02 00 02
 02 02 02 02 02 02 02 02 02 02 02 02 02 02 03 02 00 40 02 04 00 00 02 02 02 00 00 04 02 00 00 02 02
 02 00 00 00 00 53 00 00 00 00 00 00 02 00 00 00 02 00 02 04 00 32 00 40 06 02 00 04 02 32 00 00 02
 02 00 00 00 00 00 00 40 33 00 00 00 02 00 00 00 02 00 02 04 03 03 03 03 03 02 00 04 02 53 02 00 02
 02 13 13 13 00 53 00 00 00 00 00 00 02 00 27 00 02 18 02 40 02 12 14 12 24 02 00 04 02 02 00 00 02
 02 02 03 02 02 02 02 02 02 02 03 02 02 00 02 00 02 00 02 02 02 02 02 02 02 02 53 02 02 00 00 32 02
 02 42 00 00 02 33 00 00 02 00 00 00 00 00 00 00 02 00 02 00 00 00 00 00 40 00 00 00 02 00 02 53 02
 02 00 00 00 02 00 00 00 04 00 00 00 02 32 00 00 02 40 40 00 32 00 00 00 42 00 00 00 02 00 00 02 02
 02 00 27 00 02 00 00 00 02 00 00 00 00 00 00 00 02 00 00 00 02 15 32 00 40 00 00 00 02 32 00 00 02
 02 00 02 00 02 40 00 53 02 02 02 02 02 02 02 02 00 02 02 02 00 02 02 02 02 02 02 02 02 53 02 00 02
 02 00 53 00 02 00 40 00 02 00 00 53 00 00 00 00 02 00 00 00 00 00 00 53 02 14 14 00 46 02 00 00 02
 02 00 00 00 02 13 00 00 04 00 00 00 02 32 00 00 04 00 00 00 15 32 00 00 04 14 14 00 00 00 00 00 02
 02 00 30 00 02 10 13 00 02 42 00 00 00 00 00 00 02 44 00 00 15 00 00 00 02 14 14 00 00 00 00 00 02
 02 00 02 00 02 02 02 02 02 02 02 02 02 02 02 02 00 02 02 02 02 02 02 02 00 02 02 02 02 02 02 02 02
 02 00 00 00 02 53 00 00 00 00 00 00 02 40 00 00 02 00 00 00 14 40 00 14 14 00 00 00 02 33 17 17 02
 02 00 00 00 02 00 00 00 00 00 00 00 02 00 00 00 04 00 40 00 14 00 00 14 40 30 00 00 02 00 53 17 02
 02 13 13 13 02 00 00 00 00 00 00 00 02 00 33 00 02 00 00 00 14 40 00 14 14 14 00 00 02 00 00 00 02
 02 02 03 02 02 00 00 00 05 00 00 00 02 53 00 00 02 02 02 02 00 02 02 02 02 00 00 02 00 00 00 00 02
 02 00 00 00 02 00 00 00 00 00 00 00 02 14 00 00 02 00 00 00 02 53 00 18 02 40 02 44 00 00 02 00 02
 02 00 30 00 02 00 00 00 00 00 00 00 04 14 00 00 02 00 00 00 04 14 00 14 02 13 00 00 00 02 00 00 02
 02 13 00 13 02 00 00 00 00 00 00 00 02 14 00 00 02 00 00 00 02 14 14 14 02 13 00 00 02 15 00 00 02
 02 40 40 40 02 02 02 02 02 02 02 02 02 02 02 02 02 00 00 00 02 14 14 14 02 02 02 02 00 00 00 00 02
 02 00 00 00 02 00 00 00 00 00 53 00 00 13 13 13 02 00 40 00 02 00 00 00 00 00 00 00 00 00 00 17 02
 02 00 18 00 04 00 00 32 40 00 00 00 00 13 13 13 04 00 27 00 02 00 00 00 00 00 00 00 00 00 17 17 02
 02 00 00 00 02 00 00 00 00 00 53 00 00 13 13 13 02 00 42 00 02 00 00 00 00 00 00 00 00 17 33 17 02
 02 02 02 02 02 02 02 02 02 02 02 02 02 02 02 02 02 02 02 02 02 02 02 02 02 02 02 02 02 02 02 02 02
