Gauntlet (rev 1 - 9)
Maze number: 20
Offset for maze 19: 234540 - 0x03942c
big endian buf: [%!l(uint8=0) %!l(uint8=3) %!l(uint8=148) %!l(uint8=44)]
G:1 Maze real addr: 234543 - 0x03942F, bank 0, boff: 0x0000
Maze read from: 0x03942f - 234543
compresssed: 231
 08 04 04 01 00 41 24 11 0B 68 A1 E5 C5 2A A0 62
 E3 44 52 C2 1A C9 04 63 C3 44 54 A2 53 C0 71 A0
 63 C8 0E 83 C3 A4 B2 A6 B2 AA 0E 81 C4 1A D4 0E
 83 E4 C7 2A 7A 0E 81 A0 FD 41 03 A2 C3 AE 22 C7
 43 C1 1E 50 CB 1B A1 C7 43 E1 F4 C2 43 F6 40 A0
 C1 43 C7 A6 CC 43 C9 35 04 50 EA C1 35 81 C0 1E
 C7 05 C0 04 CC 1C 55 C2 63 E2 56 C6 BF C7 62 B4
 A3 C8 27 A2 CA 64 CC BF 18 A0 50 C0 03 A1 BF C3
 2A 63 53 EB C7 BB A9 B7 E9 40 E9 E6 FC 5A C5 22
 C0 1B C6 1B A0 C6 20 A1 C2 A1 E2 C1 B4 AF A1 BF
 27 52 C6 2C 76 22 C3 35 5D C0 B2 AF A5 E3 C8 27
 CF 04 C3 7A 28 A0 35 C5 27 C4 04 C6 AF A9 BA A1
 28 C2 04 C3 1F C0 12 C9 1C C0 12 EA C4 B2 A0 B2
 C2 A2 C3 B2 A0 B2 E2 C3 BE 06 A0 2A C8 19 A0 12
 A0 2A C7 2A A0 52 00
  Encoded length: 231 bytes
  Wall pattern: 01, Wall color: 04     Floor pattern: 04, Floor color: 02
  Flags: 
 02 02 02 02 02 02 02 02 02 02 02 02 02 02 02 02 02 02 02 02 02 02 02 02 02 02 02 02 02 02 02 02 02
 02 00 00 00 00 00 02 00 00 00 00 00 00 42 02 11 11 11 00 00 00 00 02 17 17 17 17 17 00 00 00 40 02
 02 00 00 26 00 00 00 00 00 00 02 00 00 00 04 11 11 11 02 00 00 00 00 17 17 17 17 02 00 00 00 00 02
 02 40 02 02 02 00 00 00 00 40 02 33 00 00 02 11 11 11 02 00 00 00 00 00 00 00 00 02 14 14 14 14 02
 02 00 00 00 02 02 02 02 02 02 02 02 02 02 02 02 02 02 02 02 02 02 02 02 02 02 02 02 02 02 14 14 02
 02 00 00 00 02 00 26 00 00 00 00 00 00 00 00 00 00 00 00 00 00 00 00 00 00 00 00 02 14 14 14 14 02
 02 00 00 00 02 00 02 00 00 00 00 00 00 00 00 42 33 00 00 00 00 00 00 00 00 00 00 02 14 14 14 02 02
 02 00 00 00 02 00 00 00 00 00 00 00 00 00 00 00 00 00 00 00 00 00 00 00 00 00 00 02 00 00 02 17 02
 02 03 02 02 02 00 00 00 02 02 02 02 02 02 02 02 02 02 02 02 02 02 02 02 34 00 00 02 00 00 00 00 02
 02 17 17 17 02 00 00 30 02 40 00 00 00 00 00 00 00 00 00 00 00 00 27 02 02 00 00 02 00 00 00 00 02
 02 17 17 17 02 00 00 02 02 00 00 00 00 00 00 00 00 00 00 00 00 00 00 02 00 00 00 02 00 02 00 00 02
 02 17 17 17 02 00 00 00 02 00 00 00 00 00 00 00 00 00 00 00 00 00 00 02 00 00 00 02 02 17 02 00 02
 02 17 17 17 02 00 00 00 02 00 00 00 02 02 02 02 02 02 02 02 00 00 00 02 00 00 00 02 00 00 00 00 02
 02 17 17 17 02 00 00 00 02 00 00 00 02 00 00 53 04 00 40 02 00 00 00 02 00 00 00 02 00 00 02 00 02
 02 53 53 53 02 30 00 00 02 00 00 00 02 00 05 00 04 00 00 02 00 00 00 02 00 00 00 02 00 00 28 00 02
 02 00 00 00 02 40 00 00 02 11 11 11 02 00 00 00 02 00 00 02 00 00 00 02 40 00 00 02 00 00 00 00 02
 02 00 00 00 02 00 00 00 02 11 11 11 02 02 02 02 02 00 00 02 00 00 00 02 00 00 39 02 02 02 00 00 02
 02 00 00 00 02 00 00 00 02 11 11 11 11 11 00 00 00 00 00 02 00 00 00 02 00 00 00 02 24 02 00 40 02
 02 03 02 02 02 00 00 00 02 42 11 11 11 11 00 00 00 00 40 02 00 00 00 02 00 00 00 02 00 00 00 02 02
 02 00 00 00 02 00 00 00 02 02 02 02 02 02 02 02 02 02 02 02 00 00 00 02 00 00 00 02 00 00 02 17 02
 02 00 00 00 02 00 00 00 00 00 02 00 00 00 00 00 00 00 02 00 00 00 00 02 00 00 00 02 00 00 00 00 02
 02 00 00 00 02 00 00 00 00 00 00 00 00 00 00 00 02 00 00 00 00 00 00 02 00 00 00 02 40 00 00 00 02
 02 00 00 34 02 27 00 00 00 00 00 00 00 27 02 00 00 00 00 00 00 00 32 02 02 00 00 02 02 02 00 00 02
 02 02 00 02 02 02 02 02 02 02 02 02 02 02 02 02 02 02 02 02 02 02 02 02 39 00 00 02 40 00 00 00 02
 02 00 00 02 44 33 00 00 00 00 00 00 00 34 00 00 00 00 53 00 00 00 00 00 00 00 00 02 00 00 00 00 02
 02 40 00 02 02 02 02 02 02 02 02 02 02 02 02 02 02 02 02 02 02 02 02 02 02 02 00 02 00 00 02 00 02
 02 00 00 00 00 00 00 00 39 00 00 00 00 00 00 00 00 00 00 00 00 00 00 00 00 04 00 02 00 00 33 00 02
 02 00 00 00 00 00 00 00 00 00 40 02 53 00 00 00 00 00 00 39 00 00 00 00 00 04 00 02 00 00 00 00 02
 02 02 02 02 02 02 02 02 02 02 02 02 02 02 02 02 02 02 02 02 02 02 02 02 02 02 02 02 02 02 40 00 02
 02 00 04 00 00 00 00 31 02 18 02 00 00 00 00 00 00 00 00 00 28 02 18 02 00 00 00 00 00 00 00 00 02
 02 00 02 00 00 00 00 00 02 02 02 00 00 00 02 02 02 00 00 00 00 02 02 02 00 00 00 02 00 00 00 00 02
 02 06 02 42 00 00 00 00 00 00 00 00 00 25 02 18 02 42 00 00 00 00 00 00 00 00 42 02 00 00 00 40 02
 02 02 02 02 02 02 02 02 02 02 02 02 02 02 02 02 02 02 02 02 02 02 02 02 02 02 02 02 02 02 02 02 02
