Gauntlet (rev 1 - 9)
Maze number: 21
Offset for maze 20: 234774 - 0x039516
big endian buf: [%!l(uint8=0) %!l(uint8=3) %!l(uint8=149) %!l(uint8=22)]
G:1 Maze real addr: 234777 - 0x039519, bank 0, boff: 0x0000
Maze read from: 0x039519 - 234777
compresssed: 340
 18 00 07 14 00 04 26 4B 68 0D 06 E8 CC 2A E1 C1
 2A 82 C9 2C C1 A4 1C A0 C4 A6 C5 1A C1 1A 66 A0
 C1 B2 1C E2 51 CA B3 1A E9 60 A0 1C C3 52 C9 1A
 A2 B4 A4 E1 60 A2 13 61 CB 1A 63 81 E0 1C 60 C0
 1E 0F A0 C1 35 C7 B5 A4 C1 A2 B2 E1 60 A2 28 C3
 55 CB 1A E5 1C 60 C0 1E 0F A0 63 C2 B6 A6 E8 60
 A2 28 C0 B5 03 60 CB 1A C3 A3 60 C0 1E 0F A0 C7
 A4 C3 1A 68 56 A1 28 81 C8 18 CC A4 13 21 24 C4
 A6 C3 1A E6 24 21 24 21 24 21 0F B2 C0 BC 41 80
 28 EE 18 0F 81 C2 0F 44 81 C0 05 4B E0 0F 86 C2
 BF 35 0B C9 B9 42 E1 06 85 72 C3 A1 B2 C2 B6 C5
 1A A1 0B C1 0D 80 C1 0D C2 0D 81 CA B9 A3 41 C0
 72 C2 72 C2 72 C0 06 D1 B9 1A 0B 80 C5 52 0D 82
 F1 C2 72 06 81 72 06 81 C0 76 D5 0F 86 CB A4 C6
 24 21 24 21 4A 81 C1 1A 0B 81 1A C5 B3 A3 24 81
 73 44 83 41 A5 C1 B4 63 C0 12 28 81 44 83 41 C0
 1C 0D 82 C2 A5 0B 2C 0B 28 44 83 41 A7 E4 B3 0B
 82 28 43 83 41 C7 1E 43 83 28 80 C4 A2 03 80 B6
 0B C4 A3 43 82 28 C4 A2 C2 0E CA 1E 42 28 85 C6
 0E 81 C0 B6 54 C3 A3 62 1B C6 BE 28 83 0E 80 C3
 B5 2A B3 2A A0 2A C1 1E C0 B6 28 C0 51 51 51 53
 53 53 C0 00
  Encoded length: 340 bytes
  Wall pattern: 04, Wall color: 06     Floor pattern: 00, Floor color: 02
  Flags: 
 02 02 02 02 02 02 02 02 02 02 02 02 02 02 02 02 02 02 02 02 02 02 02 02 02 02 02 02 02 02 02 02 02
 02 00 00 00 00 00 00 00 02 02 00 00 02 00 00 00 00 00 00 00 00 00 02 42 00 00 02 00 00 42 02 42 02
 02 00 00 00 00 00 02 00 02 00 00 44 02 00 02 02 02 02 02 28 02 00 02 00 00 00 02 02 13 13 02 13 02
 02 00 00 02 00 00 02 26 02 00 26 00 02 00 00 00 00 00 40 02 00 00 02 28 00 00 00 02 13 13 02 13 02
 02 00 00 02 00 00 02 00 02 26 00 00 02 00 00 00 00 00 00 00 02 00 40 02 28 00 00 00 02 13 02 13 02
 02 00 00 02 00 00 02 00 26 02 02 02 02 02 02 02 02 02 00 00 02 00 40 13 02 02 19 00 02 40 02 13 02
 02 00 00 02 00 00 02 00 00 00 26 00 00 00 00 40 40 02 00 02 28 00 40 13 30 15 02 00 02 53 02 13 02
 02 00 00 02 00 00 02 02 02 02 02 02 00 02 02 02 02 02 00 00 02 00 40 13 02 02 40 00 02 00 02 13 02
 02 00 00 02 00 00 00 00 00 00 00 00 26 02 00 00 00 00 00 02 28 00 40 13 30 15 02 00 02 00 02 40 02
 02 00 00 02 02 02 02 02 02 02 02 00 00 02 00 00 00 00 00 00 02 00 40 13 02 02 40 00 02 03 02 40 02
 02 00 00 00 00 00 00 00 00 00 02 00 26 02 00 00 02 02 02 02 02 00 40 13 30 15 02 00 00 00 02 00 02
 02 00 00 02 02 02 02 02 00 00 02 00 26 02 00 00 02 00 00 00 00 00 40 13 02 02 40 40 02 00 02 00 02
 02 00 00 00 00 00 24 02 00 00 02 00 00 02 00 00 02 00 00 00 02 02 02 02 02 19 33 36 02 00 02 00 02
 02 02 02 02 02 02 02 02 00 00 02 00 26 02 00 00 02 00 00 00 02 36 33 36 33 36 33 15 02 00 02 00 02
 02 11 11 40 00 00 00 02 00 00 02 00 00 02 00 00 02 00 00 02 24 15 15 15 00 00 00 15 06 00 06 00 02
 02 11 11 02 00 05 00 02 00 00 02 00 00 02 00 00 02 00 11 00 02 15 15 15 15 15 15 15 06 00 06 00 02
 02 53 11 02 00 00 00 02 00 00 02 00 00 02 00 00 02 11 00 06 02 06 06 06 06 06 06 06 06 00 06 00 02
 02 02 02 02 00 00 00 02 00 00 02 00 00 00 26 02 02 11 00 06 13 13 00 06 13 00 13 06 13 13 06 00 02
 02 00 00 00 00 00 00 00 00 00 02 02 02 02 02 00 02 11 00 06 00 06 00 06 00 06 13 06 00 06 06 00 02
 02 00 00 00 00 00 00 00 00 00 00 00 00 00 00 00 02 26 11 11 00 06 00 00 00 06 13 13 13 13 06 00 02
 02 00 00 00 00 00 00 00 00 00 00 00 00 00 00 00 00 02 02 00 02 06 06 06 06 06 06 06 06 00 06 00 02
 02 00 00 00 00 00 00 00 00 00 00 00 00 00 00 00 00 00 02 00 02 15 15 15 15 15 15 15 06 00 00 00 02
 02 00 00 00 00 00 00 00 02 02 02 02 02 02 00 00 00 00 02 00 02 36 33 36 33 00 00 00 06 00 00 00 02
 02 00 00 00 11 11 11 00 02 26 11 11 11 26 00 00 00 00 02 00 02 02 02 02 02 36 36 36 06 00 00 00 02
 02 00 11 11 11 11 11 00 02 11 02 02 02 02 02 02 00 00 02 00 00 00 00 40 02 18 40 40 40 00 00 00 02
 02 00 11 11 11 11 11 00 02 11 02 28 13 13 13 13 00 00 00 02 02 02 02 02 02 11 44 11 40 00 00 00 02
 02 00 11 11 11 11 11 00 02 11 02 13 02 02 02 02 02 02 00 00 00 00 02 02 02 11 11 11 11 40 00 00 02
 02 00 11 11 11 11 11 00 02 11 02 13 02 00 00 00 00 00 30 00 00 00 02 11 11 11 11 11 40 40 00 00 02
 02 00 00 02 02 02 03 03 02 11 02 13 02 00 02 02 02 02 02 00 00 00 02 11 11 11 11 40 13 13 13 00 02
 02 02 02 02 00 00 00 14 00 00 02 13 02 00 02 00 00 00 00 30 00 00 02 11 40 40 40 40 13 13 13 00 02
 02 00 00 00 00 00 14 14 14 00 02 13 02 00 02 00 02 02 02 02 00 00 02 40 27 13 13 13 13 13 13 00 02
 02 40 40 40 40 40 14 14 00 00 00 00 02 42 02 42 02 42 00 00 30 00 02 40 00 13 13 13 13 13 13 00 02
 02 02 02 02 02 02 02 02 02 02 02 02 02 02 02 02 02 02 02 02 02 02 02 02 02 02 02 02 02 02 02 02 02
