Gauntlet (rev 1 - 9)
Maze number: 107
Offset for maze 106: 234432 - 0x0393c0
big endian buf: [%!l(uint8=0) %!l(uint8=3) %!l(uint8=147) %!l(uint8=192)]
G:1 Maze real addr: 250819 - 0x03D3C3, bank 2, boff: 0x4000
Maze read from: 0x03d3c3 - 250819
compresssed: 328
 00 00 00 00 81 24 46 68 5A 58 5D 35 80 43 E0 C2
 A1 40 E4 E2 28 C3 35 C2 A1 E0 C0 19 E0 C3 A1 C0
 A1 C0 1F 2A A0 C2 A3 C3 1B E1 C2 A1 C0 A2 60 C0
 A2 E4 2C 20 A0 C2 B2 E0 EB E2 C0 A2 EA E0 B2 A0
 C0 A2 E0 C0 A2 E5 C0 A1 C0 A1 28 A1 F2 C0 B3 25
 43 E6 E0 E0 E0 E2 E4 C2 2A E4 C0 A2 CC B3 C0 B2
 C2 A1 C9 B2 E0 E4 C0 B2 E6 68 A1 C5 05 66 A0 C1
 20 A0 E0 E0 C1 B3 E7 E4 C2 B2 C8 25 E4 C0 A2 CE
 B2 E0 28 A0 C0 A3 C5 B2 E0 E0 E0 E0 C0 B2 E0 E4
 54 C3 A1 CE B2 C4 A1 E9 C0 A2 C1 A1 E2 E4 C7 BF
 A0 E0 E2 C8 A2 E2 E0 21 80 B9 E7 C4 B2 C0 A1 B2
 C4 B3 E2 68 A1 C0 A1 B3 C5 1B A0 E4 E4 B4 E8 E0
 E0 C1 A2 C2 A5 B3 42 C1 B2 E2 C2 A3 E0 41 53 E1
 28 E2 E5 71 41 A0 C2 A1 B3 A0 C0 B2 A1 E2 E3 E0
 B4 C3 A2 ED C1 B2 A0 C4 1E 2A A0 C0 B2 E3 C4 A8
 E7 E0 C2 A1 47 E5 E1 EA C3 B3 C0 B2 A5 CB A1 E0
 C1 1C 72 EB C0 B2 C0 A1 28 E7 C1 B2 A2 E5 C0 B2
 E0 E4 B4 A0 C0 A1 C3 B2 C7 B3 51 E3 03 A2 73 A0
 E1 E2 E2 B2 C4 A2 C0 04 C4 A2 2A C1 B5 E1 E0 E4
 E0 B3 41 A0 E0 C0 04 03 BE 35 A0 28 E1 E2 1D C2
 B2 E0 E5 E2 C0 04 06 00
  Encoded length: 328 bytes
  Wall pattern: 04, Wall color: 06     Floor pattern: 02, Floor color: 04
  Flags: PLAYER_OFFSCREEN SHOTS_STUN 
  ╚══> while gauntlet has these elements, these flags probably do not operate
 02 02 02 02 02 02 02 02 02 02 02 02 02 02 02 02 02 02 02 02 02 02 02 02 02 02 02 02 02 02 02 02 02
 02 53 00 00 00 00 40 00 02 00 00 00 02 02 00 40 00 00 00 00 00 02 00 00 00 02 40 00 00 00 00 53 02
 02 00 02 02 02 00 02 00 25 00 02 00 00 00 00 02 02 00 02 02 00 31 42 02 00 00 00 02 02 02 02 00 02
 02 00 02 27 00 00 02 00 02 00 02 02 00 02 02 02 00 26 00 02 02 02 00 00 00 02 00 02 44 32 02 00 02
 02 00 02 00 02 00 00 00 02 00 00 00 00 00 00 00 00 02 00 00 00 02 00 02 02 02 00 00 00 00 00 00 02
 02 00 00 00 00 02 00 02 02 02 00 02 02 02 00 02 00 02 02 02 00 00 00 00 00 02 02 00 02 02 00 02 02
 02 40 02 02 00 00 00 00 00 00 00 00 00 00 00 00 00 00 00 02 00 02 00 02 00 02 37 00 00 00 00 40 02
 02 00 00 00 00 02 00 02 00 02 00 02 00 02 00 02 00 02 00 02 00 02 00 02 00 00 00 42 02 00 02 00 02
 02 02 00 02 02 02 00 00 00 00 00 00 00 00 00 02 00 00 00 02 00 02 00 00 00 02 02 00 02 00 02 00 02
 02 00 00 00 00 02 00 02 00 00 00 00 00 02 00 02 00 02 00 00 00 00 00 02 00 00 00 00 02 00 02 00 02
 02 26 02 02 00 00 00 00 00 00 05 00 00 00 00 00 00 02 26 02 00 02 32 02 00 02 00 02 02 00 02 00 02
 02 00 00 00 00 02 00 02 00 00 00 00 00 02 00 02 00 02 00 00 00 02 00 00 00 00 00 37 02 00 00 00 02
 02 02 00 02 02 02 00 00 00 00 00 00 00 00 00 02 00 00 00 02 00 02 00 02 40 02 00 02 02 02 02 00 02
 02 00 00 00 00 02 00 02 00 02 00 02 00 02 00 02 00 02 00 02 00 00 00 02 00 00 00 00 02 24 00 00 02
 02 00 02 02 00 00 00 00 00 00 00 00 00 00 00 00 00 00 00 02 00 02 00 00 00 02 02 00 02 00 02 00 02
 02 00 00 00 00 02 00 02 02 02 00 02 02 02 00 02 00 02 00 00 00 02 00 02 00 00 00 00 02 00 02 00 02
 02 02 00 02 00 00 00 02 00 02 00 02 00 00 00 02 00 02 02 02 00 02 00 02 00 02 33 02 02 00 02 00 02
 02 00 00 00 00 02 00 00 00 02 00 02 00 02 02 02 00 00 00 00 00 02 00 00 00 02 00 02 00 00 02 00 02
 02 00 02 26 02 02 00 02 02 02 00 00 00 00 00 00 27 02 00 02 00 00 00 02 00 00 00 02 00 02 02 00 02
 02 00 02 00 02 00 00 00 02 00 02 00 02 00 00 02 02 02 00 02 00 02 02 02 02 02 02 02 00 00 00 40 02
 02 00 02 00 02 00 02 00 00 00 02 02 02 02 00 02 00 00 40 02 00 00 02 24 00 00 02 40 00 02 00 02 02
 02 00 00 00 02 00 02 00 02 29 00 00 40 02 00 00 00 02 02 02 02 00 02 02 02 00 00 00 02 02 00 00 02
 02 02 00 02 02 00 00 00 02 02 02 02 00 00 00 02 00 00 00 00 00 00 00 00 00 00 02 00 00 02 02 00 02
 02 00 00 00 30 42 02 00 02 00 00 00 00 02 00 02 00 02 00 02 02 02 02 02 02 02 02 02 00 00 00 00 02
 02 00 02 00 02 00 02 00 00 00 02 02 00 00 00 02 00 02 00 00 40 00 00 00 00 00 00 02 00 02 02 00 02
 02 00 02 00 00 00 00 00 02 00 02 00 00 02 00 02 00 02 02 02 02 02 02 02 00 02 00 00 00 02 00 00 02
 02 00 02 00 02 02 00 02 02 00 28 02 00 02 29 00 00 00 00 00 02 00 00 00 00 02 00 02 00 02 00 02 02
 02 40 02 00 00 00 00 00 02 00 02 02 00 02 02 02 02 00 02 00 02 00 02 02 00 02 00 02 00 00 00 00 02
 02 02 02 02 00 02 02 00 02 00 00 02 00 00 00 00 00 00 02 00 02 00 02 24 00 00 00 00 02 03 02 02 02
 02 00 00 00 00 29 02 00 02 02 00 00 00 02 00 02 00 02 02 00 00 00 02 00 02 02 02 00 04 00 00 00 02
 02 00 02 02 02 42 00 00 02 00 00 02 00 02 00 02 00 00 00 02 00 02 02 00 00 40 02 00 02 00 04 03 02
 02 53 02 40 00 00 02 00 00 00 02 29 00 00 00 02 00 02 00 00 00 00 00 00 02 00 00 00 02 00 04 06 02
 02 02 02 02 02 02 02 02 02 02 02 02 02 02 02 02 02 02 02 02 02 02 02 02 02 02 02 02 02 02 02 02 02
