Gauntlet (rev 1 - 9)
Maze number: 110
Offset for maze 109: 235063 - 0x039637
big endian buf: [%!l(uint8=0) %!l(uint8=3) %!l(uint8=150) %!l(uint8=55)]
G:1 Maze real addr: 251450 - 0x03D63A, bank 2, boff: 0x4000
Maze read from: 0x03d63a - 251450
compresssed: 206
 00 00 00 00 00 64 F0 03 5E 04 5B C1 1A CC 28 69
 C1 2A 2C C1 1A 51 76 C3 28 65 C5 2A 35 C2 AF AD
 D6 28 80 C4 2B A6 C0 4F 42 C1 A3 73 C3 1A C7 28
 6A CA 4D C9 A5 62 C0 35 80 61 63 C2 A2 76 C7 35
 80 6A D2 35 80 CF A5 63 C2 35 80 CB A3 28 72 C6
 47 61 66 C8 1A C2 2C C6 09 CC A5 C1 09 C6 35 C0
 09 C2 28 A3 76 C4 09 C7 53 09 64 C3 BF CE 05 E2
 09 CA A5 CC 04 C7 A3 1B C5 5C 61 E7 61 C6 1A C2
 43 A0 C3 57 4A 5B 7D C1 5D 2B 61 C1 28 64 C1 5F
 A2 C5 42 C2 4F 40 C7 28 82 65 D0 1A C1 54 2B 51
 C2 B4 AF A1 45 C0 42 DD 1B C2 1A D1 1A C5 44 54
 A2 C2 AF A3 1E 72 61 DF C0 2B D5 2B C0 2A 63 B3
 AF A3 C5 2B DA BE 06 C1 2A 62 D3 1A C1 00
  Encoded length: 206 bytes
  Wall pattern: 04, Wall color: 00     Floor pattern: 06, Floor color: 15
  Flags: 
 02 02 02 02 02 02 02 02 02 02 02 02 02 02 02 02 02 02 02 02 02 02 02 02 02 02 02 02 02 02 02 02 02
 02 00 26 04 00 00 00 00 00 00 00 00 00 00 00 00 40 00 00 00 00 00 00 00 00 00 00 30 00 00 42 44 02
 02 00 26 04 00 00 00 00 00 00 00 27 00 00 00 00 40 00 00 00 00 00 00 30 00 00 00 00 00 00 42 53 02
 02 00 00 02 02 02 02 02 02 02 02 02 02 02 02 02 02 02 02 02 02 02 02 02 02 02 02 02 02 02 02 02 02
 02 00 00 00 00 00 00 00 00 00 00 00 00 00 00 00 00 00 00 00 00 00 00 00 40 40 00 00 00 00 00 43 02
 02 02 02 02 02 02 02 00 03 03 03 03 03 03 03 03 03 03 03 03 03 03 03 03 03 03 04 00 00 02 02 02 02
 02 00 00 00 00 27 00 00 04 00 26 00 00 00 00 00 00 00 00 40 00 00 00 00 00 00 04 00 00 00 00 30 02
 02 00 00 00 00 00 00 00 04 00 04 03 03 03 03 03 03 03 03 03 03 03 03 03 03 00 04 00 00 00 00 00 02
 02 00 00 02 02 02 02 02 04 00 04 00 30 00 53 53 00 00 30 00 00 00 00 30 04 00 04 02 02 02 00 00 02
 02 00 00 00 00 27 00 00 04 00 04 00 00 00 53 53 00 00 00 00 00 00 00 00 04 00 04 30 00 00 00 00 02
 02 00 00 00 00 00 00 00 04 00 04 00 00 00 00 53 53 00 00 00 00 00 00 00 04 00 04 00 00 00 00 00 02
 02 02 02 02 02 02 02 00 04 00 04 30 00 00 00 53 53 00 00 00 00 00 00 00 04 00 04 00 00 02 02 02 02
 02 40 00 00 00 27 00 00 04 00 04 00 04 03 03 03 03 03 03 03 04 00 00 30 04 00 04 00 00 00 00 30 02
 02 00 00 00 00 00 00 00 04 26 04 00 04 44 00 00 00 00 00 00 04 09 00 00 04 00 04 00 00 00 00 00 02
 02 00 00 02 02 02 02 02 04 00 04 09 04 00 00 00 00 00 00 53 04 09 00 00 04 40 04 02 02 02 00 00 02
 02 00 00 00 00 27 00 00 04 00 04 09 04 00 00 00 00 00 00 00 04 09 00 00 04 00 04 30 00 00 00 00 02
 02 00 00 00 00 00 00 00 04 00 04 00 04 00 00 00 05 00 00 00 02 09 00 00 04 00 04 00 00 00 00 00 02
 02 02 02 02 02 02 02 00 04 00 04 00 04 00 00 00 00 00 00 00 04 00 00 00 04 00 04 00 00 02 02 02 02
 02 27 00 00 00 00 00 00 04 00 04 30 04 00 00 00 00 00 00 00 02 00 00 30 04 00 04 00 00 00 00 26 02
 02 00 04 03 03 03 03 02 02 00 04 00 04 03 03 03 03 03 03 03 03 03 03 03 04 00 04 00 00 00 00 00 02
 02 00 04 00 00 00 00 27 02 00 04 43 00 00 30 00 00 40 00 00 00 00 00 30 00 00 04 02 02 02 00 00 02
 02 00 04 00 03 03 03 00 02 00 03 03 03 03 03 03 03 03 03 03 03 03 03 03 03 03 03 00 00 00 00 00 02
 02 00 04 40 04 40 04 00 02 00 00 00 00 30 00 00 00 00 00 00 00 00 00 00 00 00 00 00 00 00 00 26 02
 02 00 04 43 04 00 04 00 02 02 02 02 02 02 02 02 02 02 02 02 02 02 02 02 02 02 02 03 03 03 03 03 02
 02 00 03 03 03 00 04 00 00 00 00 00 00 00 00 00 00 00 00 00 00 00 00 00 00 00 00 00 00 00 00 00 02
 02 00 00 27 00 00 04 26 00 00 00 00 00 00 00 00 00 00 00 00 00 00 00 00 00 00 26 00 00 00 00 00 02
 02 03 03 03 03 03 04 02 02 02 00 00 00 02 02 02 02 02 02 02 02 02 02 02 02 02 02 02 02 02 02 02 02
 02 30 00 00 00 27 00 00 30 02 00 00 00 00 00 00 00 00 00 00 00 00 00 00 00 00 00 00 00 00 00 00 02
 02 00 00 00 00 00 00 00 00 02 43 00 00 00 00 00 00 00 00 00 00 00 00 00 00 00 00 00 00 00 00 00 02
 02 43 00 42 00 00 00 00 30 02 02 02 02 02 02 02 02 02 02 02 02 02 02 02 02 02 02 02 02 02 00 00 02
 02 00 00 00 43 00 00 00 00 00 00 00 00 00 00 00 00 00 00 00 00 00 00 00 00 00 00 00 00 00 00 00 02
 02 06 00 00 42 00 00 00 30 00 00 00 00 00 00 00 00 00 00 00 00 00 00 00 00 00 00 00 00 26 00 00 02
 02 02 02 02 02 02 02 02 02 02 02 02 02 02 02 02 02 02 02 02 02 02 02 02 02 02 02 02 02 02 02 02 02
