Gauntlet (rev 1 - 9)
Maze number: 85
Offset for maze 84: 231233 - 0x038741
big endian buf: [%!l(uint8=0) %!l(uint8=3) %!l(uint8=135) %!l(uint8=65)]
G:1 Maze real addr: 247620 - 0x03C744, bank 2, boff: 0x4000
Maze read from: 0x03c744 - 247620
compresssed: 254
 00 00 00 00 00 03 52 59 A8 5D 5A C4 06 2A 52 E6
 E2 66 60 1F C2 06 2A E7 E0 E1 E1 CC 06 2A 1A 74
 A0 52 A0 CC AF AA C4 6B 1D C0 6F CC 6F DF 5E D3
 A6 C5 1F CD 62 1A 70 70 55 B6 E4 E0 E0 E0 E0 E0
 F3 1D A0 1D A0 1D A0 1D A0 1D A0 1D 5D 2A 53 A0
 1D A0 1D A0 1D A0 1D A0 1D A0 CE 2A E3 19 A0 19
 A0 19 A0 19 A0 19 A0 19 5D C2 60 19 A0 19 A0 19
 A0 19 A0 19 A0 19 A0 CD A4 B7 A0 E0 E0 C0 A5 BF
 41 B2 C2 6F 48 A0 C2 A1 B8 D6 19 A0 C3 1F C2 1B
 68 1D 61 20 64 A0 41 A8 C1 2A AA C2 1C 42 A0 C1
 67 1D D0 19 A0 FD 43 40 7A C8 1F E1 44 40 C2 2B
 C5 AB E2 41 40 53 C8 2A C1 1C C2 62 19 A0 42 40
 CC 68 19 A0 42 40 7A C3 A1 44 A0 44 40 B5 C7 B4
 EB 44 40 A0 C1 BD 28 82 C0 2A C1 1F C3 05 52 C4
 2C BB 40 C1 1F A0 D4 A3 E4 78 C1 B4 C0 A1 C0 B4
 C1 BE C7 B2 C6 BC C0 2C B2 C2 2A C5 28 00
  Encoded length: 254 bytes
  Wall pattern: 03, Wall color: 02     Floor pattern: 00, Floor color: 05
  Flags: 
 02 02 02 02 02 02 02 02 02 02 02 02 02 02 02 02 02 02 02 02 02 02 02 02 02 02 02 02 02 02 02 02 02
 02 00 00 00 00 06 42 00 00 00 29 00 00 00 00 00 00 00 02 00 00 00 02 40 00 00 00 00 00 00 00 40 02
 02 31 00 00 00 06 42 00 00 00 00 00 00 00 00 02 00 02 00 00 02 00 00 02 00 00 00 00 00 00 00 00 02
 02 00 00 00 00 06 42 26 00 00 00 00 00 26 02 00 00 00 29 02 00 00 00 00 00 00 00 00 00 00 00 00 02
 02 02 02 02 02 02 02 02 02 02 02 02 02 02 02 02 02 02 02 02 02 02 02 02 02 02 02 02 00 00 00 00 02
 02 40 00 00 00 00 00 00 00 00 00 00 00 00 29 02 40 00 00 00 00 00 00 00 00 00 00 00 00 00 00 00 02
 02 00 00 00 00 00 00 00 00 00 00 00 00 00 40 02 00 00 00 00 00 00 00 00 00 00 00 00 00 00 00 00 02
 02 00 00 00 00 00 00 00 00 00 00 00 00 00 00 02 00 00 00 00 00 00 00 00 00 00 00 00 00 00 00 00 02
 02 00 00 00 00 00 00 00 00 00 00 00 00 00 29 02 00 00 00 02 00 00 00 00 00 00 00 00 00 00 00 00 02
 02 00 00 02 02 02 02 02 02 02 00 00 00 00 00 02 31 00 00 02 00 00 00 00 00 00 00 00 00 00 00 40 02
 02 00 00 26 00 26 00 26 00 02 00 00 00 00 29 02 00 00 00 02 00 02 00 02 00 02 00 02 00 02 00 02 02
 02 00 00 00 00 00 00 00 00 02 00 00 00 00 00 00 00 00 00 02 02 29 02 29 02 29 02 29 02 29 02 29 02
 02 00 00 00 00 00 00 00 00 02 00 00 00 00 29 42 00 00 00 02 29 02 29 02 29 02 29 02 29 02 29 02 02
 02 00 00 00 00 00 00 00 00 02 00 00 00 00 00 42 00 00 00 02 02 25 02 25 02 25 02 25 02 25 02 25 02
 02 00 00 00 02 00 00 00 00 02 00 00 00 00 29 00 00 00 40 02 25 02 25 02 25 02 25 02 25 02 25 02 02
 02 00 00 00 02 00 00 00 00 02 00 00 00 02 02 02 02 02 02 02 02 00 02 00 02 00 02 02 02 02 02 02 02
 02 00 00 25 02 00 00 00 40 02 00 00 00 02 00 00 00 00 00 00 00 00 00 00 00 00 00 00 00 00 00 00 02
 02 00 25 02 00 00 00 02 02 02 00 00 00 02 00 00 00 00 00 00 00 00 00 00 00 00 00 00 00 00 00 00 02
 02 25 02 00 00 00 02 31 00 00 00 27 40 02 00 00 00 00 00 00 00 00 29 40 00 00 32 40 00 00 00 00 02
 02 02 00 00 25 02 02 02 02 02 02 02 02 02 00 00 42 02 02 02 02 02 02 02 02 02 02 02 00 00 00 28 02
 02 00 00 25 02 00 02 40 00 00 00 00 00 02 00 00 29 02 00 00 00 00 00 00 00 00 00 00 00 00 00 00 02
 02 00 25 02 00 00 02 00 00 00 00 00 00 02 00 00 00 02 00 00 00 00 00 00 00 00 00 00 00 00 00 00 02
 02 00 02 00 00 00 02 25 00 25 00 02 00 02 00 00 00 02 00 00 00 26 00 00 00 00 00 00 00 00 00 31 02
 02 00 02 00 00 00 02 00 25 00 25 02 00 02 43 00 00 02 00 00 02 02 02 02 02 02 02 02 02 02 02 02 02
 02 00 00 00 02 00 02 25 00 25 00 02 00 02 29 00 00 02 00 00 02 00 00 00 42 00 00 28 00 00 00 40 02
 02 00 00 25 02 00 02 00 25 00 25 02 00 02 00 00 00 02 00 00 02 00 00 00 40 00 00 00 00 00 00 00 02
 02 00 25 02 00 00 02 25 00 25 00 02 00 02 00 00 00 02 00 00 02 26 00 00 02 00 02 02 00 02 00 00 02
 02 25 02 00 00 00 02 00 25 00 25 02 00 02 00 00 00 02 00 00 02 00 00 00 02 00 00 00 00 02 00 00 02
 02 02 00 00 00 00 02 25 00 25 02 00 00 02 40 40 40 02 00 42 00 00 31 00 02 00 00 05 00 02 00 29 02
 02 00 00 00 00 44 02 00 25 02 00 31 02 00 00 00 00 02 00 00 02 00 00 00 02 00 00 00 00 02 00 00 02
 02 00 02 02 02 02 00 00 00 02 00 02 00 00 00 00 00 02 00 00 02 26 00 00 02 00 02 02 00 02 00 00 02
 02 00 00 00 00 00 00 00 00 02 00 00 00 00 00 00 00 02 00 44 02 00 00 00 42 00 00 00 00 00 00 40 02
 02 02 02 02 02 02 02 02 02 02 02 02 02 02 02 02 02 02 02 02 02 02 02 02 02 02 02 02 02 02 02 02 02
