Gauntlet (rev 1 - 9)
Maze number: 19
Offset for maze 18: 234364 - 0x03937c
big endian buf: [%!l(uint8=0) %!l(uint8=3) %!l(uint8=147) %!l(uint8=124)]
G:1 Maze real addr: 234367 - 0x03937F, bank 0, boff: 0x0000
Maze read from: 0x03937f - 234367
compresssed: 173
 02 2B 07 15 00 03 52 68 64 5B 9A CA 1A 2A A0 55
 2C A0 1E 46 C1 05 C5 A4 C0 A7 EE D9 AF AA C4 2A
 73 24 44 65 CB AF AA 44 4D D1 A1 53 A0 C3 B2 A2
 C2 1E A0 DF 46 C4 AF AB 64 67 CD 1A 2A C4 AF AB
 E7 C4 2A D5 A1 C2 A1 E2 28 C1 A1 28 E1 E2 28 41
 E6 D5 BF AF AA 44 63 C6 19 CA 75 AF AA DF DF 42
 C4 AF AB E4 72 A0 28 A0 E2 1E C1 78 22 DF E5 73
 28 A0 1E 42 81 C2 2A C1 26 42 AF AA 56 A0 24 C5
 B2 42 80 40 80 C0 2A A0 28 80 A0 56 A0 59 B2 C4
 B3 EB E3 E2 C0 19 A0 C2 B4 CF 06 E1 1B A0 FB 1B
 E1 D6 BE E3 51 A0 C3 19 E1 61 68 28 00
  Encoded length: 173 bytes
  Wall pattern: 03, Wall color: 02     Floor pattern: 00, Floor color: 05
  Flags: 
 02 02 02 02 02 02 02 02 02 02 02 02 02 02 02 02 02 02 02 02 02 02 02 02 02 02 02 02 02 02 02 02 02
 02 00 00 00 00 00 00 00 00 00 00 26 42 02 00 00 00 00 00 00 27 44 02 30 00 00 00 00 00 00 00 40 02
 02 00 05 00 00 00 00 00 00 02 02 02 02 02 00 02 02 02 02 02 02 02 02 00 00 00 00 00 00 00 00 00 02
 02 00 00 00 00 00 02 00 00 00 00 00 00 00 00 00 00 00 00 00 00 00 00 00 00 00 00 00 00 00 00 00 02
 02 02 02 02 02 02 02 02 02 02 02 02 02 02 02 02 02 02 02 02 02 02 02 02 02 02 02 02 00 00 00 00 02
 02 42 26 00 00 00 00 36 00 00 00 00 00 40 00 00 00 00 00 00 36 00 00 00 00 00 00 00 00 00 00 00 02
 02 02 02 02 02 02 02 02 02 02 02 02 02 02 02 02 02 02 02 02 02 02 02 02 02 02 02 02 00 00 00 00 02
 02 40 00 00 00 00 00 00 00 00 00 00 00 00 00 02 40 00 00 00 00 00 00 00 00 00 00 00 00 00 00 00 02
 02 00 00 02 02 00 00 00 00 27 02 00 00 00 00 02 02 02 02 00 00 00 30 02 00 00 00 00 00 00 00 00 02
 02 00 00 00 00 00 00 00 00 00 00 00 00 00 00 00 00 00 00 00 00 00 00 00 00 00 00 00 00 00 00 40 02
 02 00 00 00 00 02 02 02 02 02 02 02 02 02 02 02 02 02 02 02 02 02 02 02 02 02 02 02 02 02 02 02 02
 02 00 00 00 00 00 36 00 00 00 00 00 00 00 00 36 00 00 00 00 00 00 00 00 00 00 00 00 00 00 26 42 02
 02 00 00 00 00 02 02 02 02 02 02 02 02 02 02 02 02 02 02 02 02 02 02 02 02 02 02 02 02 02 02 02 02
 02 00 00 00 00 00 00 00 00 02 00 00 00 00 00 42 00 00 00 00 00 00 00 00 00 00 00 00 00 00 00 00 02
 02 00 00 00 00 00 02 02 00 00 00 02 02 00 00 00 02 40 00 00 02 02 40 00 00 02 00 00 00 02 40 00 02
 02 40 00 00 00 00 00 00 00 02 00 00 00 00 00 00 00 00 00 00 00 00 00 00 00 00 00 00 00 00 00 00 02
 02 02 02 02 02 02 02 02 02 02 02 02 02 02 02 02 02 02 02 02 02 02 02 02 02 02 02 02 00 00 00 00 02
 02 40 00 00 00 00 36 00 00 00 00 00 00 00 25 00 00 00 00 00 00 00 00 00 00 00 26 00 00 00 00 00 02
 02 02 02 02 02 02 02 02 02 02 02 02 02 02 02 02 02 02 02 02 02 02 02 02 02 02 02 02 00 00 00 00 02
 02 00 00 00 00 00 00 00 00 00 00 00 00 00 00 00 00 00 00 00 00 00 00 00 00 00 00 00 00 00 00 00 02
 02 00 00 00 00 00 00 00 00 00 00 00 00 00 00 00 00 00 00 00 00 00 00 00 00 00 00 00 00 00 00 40 02
 02 00 00 00 00 02 02 02 02 02 02 02 02 02 02 02 02 02 02 02 02 02 02 02 02 02 02 02 02 02 02 02 02
 02 00 00 00 00 00 02 26 00 00 00 02 40 02 00 00 00 02 30 00 00 26 00 00 00 00 00 00 00 00 00 34 02
 02 00 00 00 00 00 00 00 00 00 00 00 00 00 00 00 00 00 00 00 00 00 00 00 00 00 00 00 00 00 00 00 02
 02 00 00 00 00 00 02 26 00 00 00 02 40 02 30 00 00 02 40 40 02 00 00 00 42 00 00 38 00 00 00 40 02
 02 02 02 02 02 02 02 02 02 02 02 02 02 02 02 02 02 02 02 02 02 02 02 02 02 02 02 00 00 00 00 00 02
 02 00 27 02 36 00 00 00 00 00 00 02 00 00 02 40 40 02 40 40 02 42 02 40 40 02 00 00 00 00 00 00 02
 02 27 02 00 00 00 00 00 00 00 00 00 00 27 02 00 00 02 00 00 02 00 00 00 00 00 00 00 00 00 00 00 02
 02 02 00 00 00 00 02 00 00 00 02 00 25 02 00 00 00 02 00 00 00 00 00 00 00 00 00 00 00 00 00 00 02
 02 00 06 00 00 02 27 02 00 00 00 00 00 00 00 00 00 00 00 00 00 00 00 00 00 00 00 00 00 00 00 00 02
 02 00 00 00 02 27 00 00 02 00 00 00 00 00 00 00 00 00 00 00 00 00 00 00 00 00 00 00 00 00 00 00 02
 02 00 00 00 00 02 00 00 27 02 00 00 00 00 25 00 00 02 00 00 36 00 00 00 00 00 00 00 00 00 36 40 02
 02 02 02 02 02 02 02 02 02 02 02 02 02 02 02 02 02 02 02 02 02 02 02 02 02 02 02 02 02 02 02 02 02
