Gauntlet (rev 1 - 9)
Maze number: 100
Offset for maze 99: 233008 - 0x038e30
big endian buf: [%!l(uint8=0) %!l(uint8=3) %!l(uint8=142) %!l(uint8=48)]
G:1 Maze real addr: 249395 - 0x03CE33, bank 2, boff: 0x4000
Maze read from: 0x03ce33 - 249395
compresssed: 174
 00 00 00 00 80 10 C8 68 6A 04 59 2C 80 DC 35 C0
 06 E0 1D A0 61 E0 1B 42 1A E3 75 43 DE AB C1 A3
 C1 A9 41 DE 06 E0 1D A0 E3 1B 42 1A E3 75 63 DE
 AB C1 A3 C1 A9 41 DE 28 E0 1D A0 61 E0 1B 42 1A
 43 75 43 DE AB C1 A3 C1 A9 61 DE 06 E0 1E A0 E3
 1B 42 1A E3 75 C3 2C DD BF AB C1 A3 C1 A8 5F 05
 40 DE 28 E0 1C A0 62 A0 1B 42 1A E3 75 43 DE AB
 C1 A3 C1 A9 61 DE 2A E0 1E A0 E3 1B 42 1A E3 75
 63 DE AB C1 A3 C1 A9 41 DE 06 E0 1D A0 E3 1B 42
 1A E3 75 63 DE AB C1 A3 C1 A9 41 DE 28 E0 1C A0
 62 A0 1B 42 1A 43 75 C2 BE 28 DB 5E C0 00
  Encoded length: 174 bytes
  Wall pattern: 00, Wall color: 08     Floor pattern: 01, Floor color: 12
  Flags: PLAYER_OFFSCREEN 
  ╚══> while gauntlet has these elements, these flags probably do not operate
 02 02 02 02 02 02 02 02 02 02 02 02 02 02 02 02 02 02 02 02 02 02 02 02 02 02 02 02 02 02 02 02 02
 02 44 00 00 00 00 00 00 00 00 00 00 00 00 00 00 00 00 00 00 00 00 00 00 00 00 00 00 00 00 04 53 02
 02 06 00 02 29 02 00 00 42 00 02 27 00 00 00 40 26 00 00 00 00 02 00 00 00 00 00 00 25 00 04 00 02
 02 40 00 00 00 00 00 00 00 00 00 00 00 00 00 00 00 00 00 00 00 00 00 00 00 00 00 00 00 00 04 00 02
 02 02 02 02 02 02 02 02 02 02 02 02 02 00 00 02 02 02 02 00 00 02 02 02 02 02 02 02 02 02 04 00 02
 02 40 00 00 00 00 00 00 00 00 00 00 00 00 00 00 00 00 00 00 00 00 00 00 00 00 00 00 00 00 04 00 02
 02 06 00 02 29 02 00 00 00 00 02 27 00 00 00 40 26 00 00 00 00 02 00 00 00 00 00 00 25 00 04 00 02
 02 42 00 00 00 00 00 00 00 00 00 00 00 00 00 00 00 00 00 00 00 00 00 00 00 00 00 00 00 00 04 00 02
 02 02 02 02 02 02 02 02 02 02 02 02 02 00 00 02 02 02 02 00 00 02 02 02 02 02 02 02 02 02 04 00 02
 02 40 00 00 00 00 00 00 00 00 00 00 00 00 00 00 00 00 00 00 00 00 00 00 00 00 00 00 00 00 04 00 02
 02 40 00 02 29 02 00 00 42 00 02 27 00 00 00 40 26 00 00 00 00 40 00 00 00 00 00 00 25 00 04 00 02
 02 40 00 00 00 00 00 00 00 00 00 00 00 00 00 00 00 00 00 00 00 00 00 00 00 00 00 00 00 00 04 00 02
 02 02 02 02 02 02 02 02 02 02 02 02 02 00 00 02 02 02 02 00 00 02 02 02 02 02 02 02 02 02 04 00 02
 02 42 00 00 00 00 00 00 00 00 00 00 00 00 00 00 00 00 00 00 00 00 00 00 00 00 00 00 00 00 04 00 02
 02 06 00 02 30 02 00 00 00 00 02 27 00 00 00 40 26 00 00 00 00 02 00 00 00 00 00 00 25 00 04 00 02
 02 44 00 00 00 00 00 00 00 00 00 00 00 00 00 00 00 00 00 00 00 00 00 00 00 00 00 00 00 00 04 00 02
 02 02 02 02 02 02 02 02 02 02 02 02 02 00 00 02 02 02 02 00 00 02 02 02 02 02 02 02 02 02 04 05 02
 02 40 00 00 00 00 00 00 00 00 00 00 00 00 00 00 00 00 00 00 00 00 00 00 00 00 00 00 00 00 04 00 02
 02 40 00 02 28 02 00 00 00 42 02 27 00 00 00 40 26 00 00 00 00 02 00 00 00 00 00 00 25 00 04 00 02
 02 40 00 00 00 00 00 00 00 00 00 00 00 00 00 00 00 00 00 00 00 00 00 00 00 00 00 00 00 00 04 00 02
 02 02 02 02 02 02 02 02 02 02 02 02 02 00 00 02 02 02 02 00 00 02 02 02 02 02 02 02 02 02 04 00 02
 02 42 00 00 00 00 00 00 00 00 00 00 00 00 00 00 00 00 00 00 00 00 00 00 00 00 00 00 00 00 04 00 02
 02 42 00 02 30 02 00 00 00 00 02 27 00 00 00 40 26 00 00 00 00 02 00 00 00 00 00 00 25 00 04 00 02
 02 42 00 00 00 00 00 00 00 00 00 00 00 00 00 00 00 00 00 00 00 00 00 00 00 00 00 00 00 00 04 00 02
 02 02 02 02 02 02 02 02 02 02 02 02 02 00 00 02 02 02 02 00 00 02 02 02 02 02 02 02 02 02 04 00 02
 02 40 00 00 00 00 00 00 00 00 00 00 00 00 00 00 00 00 00 00 00 00 00 00 00 00 00 00 00 00 04 00 02
 02 06 00 02 29 02 00 00 00 00 02 27 00 00 00 40 26 00 00 00 00 02 00 00 00 00 00 00 25 00 04 00 02
 02 42 00 00 00 00 00 00 00 00 00 00 00 00 00 00 00 00 00 00 00 00 00 00 00 00 00 00 00 00 04 00 02
 02 02 02 02 02 02 02 02 02 02 02 02 02 00 00 02 02 02 02 00 00 02 02 02 02 02 02 02 02 02 04 00 02
 02 40 00 00 00 00 00 00 00 00 00 00 00 00 00 00 00 00 00 00 00 00 00 00 00 00 00 00 00 00 04 00 02
 02 40 00 02 28 02 00 00 00 42 02 27 00 00 00 40 26 00 00 00 00 40 00 00 00 00 00 00 25 00 04 00 02
 02 40 00 00 00 00 00 00 00 00 00 00 00 00 00 00 00 00 00 00 00 00 00 00 00 00 00 00 00 00 04 00 02
 02 02 02 02 02 02 02 02 02 02 02 02 02 02 02 02 02 02 02 02 02 02 02 02 02 02 02 02 02 02 02 02 02
