Gauntlet (rev 1 - 9)
Maze number: 55
Offset for maze 54: 230487 - 0x038457
big endian buf: [%!l(uint8=0) %!l(uint8=3) %!l(uint8=132) %!l(uint8=87)]
G:1 Maze real addr: 255066 - 0x03E45A, bank 3, boff: 0x6000
Maze read from: 0x03e45a - 255066
compresssed: 315
 5F 11 01 00 00 02 DF 68 5B 61 9E 43 D4 39 70 28
 C2 26 C2 A2 C0 A2 C0 A1 C1 A2 C0 A1 C2 39 70 28
 C7 2A E0 E2 E2 E2 2A C1 35 C7 26 C2 A2 C2 20 E0
 2E A0 50 C2 A4 21 62 EE E2 51 80 2C 51 C1 B2 C4
 2A C4 20 80 E2 C9 B3 C6 03 81 C0 20 E0 C0 A1 C1
 2A 04 2C 6C EC C1 04 C1 B2 E3 51 62 C5 B4 C1 20
 C0 13 C1 A4 50 B3 54 C1 B3 45 E0 C2 06 C0 2A 56
 C2 2A B3 48 C0 38 D6 1B 40 80 40 C1 38 C2 B4 C5
 A3 C1 B3 51 62 50 C3 26 C0 38 81 C0 A5 E4 52 C1
 B3 4A C3 26 35 E2 C3 2A B3 C8 26 43 D3 35 60 C1
 BF A9 E4 27 54 62 C1 B3 C5 35 C2 75 A0 55 C1 B3
 C5 35 C7 7A B3 E1 C6 72 A3 C4 B6 C3 B6 E4 61 50
 CB B3 C2 38 C5 71 38 1B C1 B3 66 C8 38 41 C2 71
 38 03 80 38 CA 73 38 81 42 C0 B3 C2 11 3B 18 38
 C3 79 B2 C4 13 C5 03 81 A0 C3 2A E8 C6 13 C2 3B
 C0 3A 21 E0 51 62 C2 B3 C2 A5 B7 A1 B2 C1 11 B3
 A2 C5 A2 C2 A2 C0 70 28 C4 04 CB 72 1B 47 C2 35
 C0 04 C7 11 80 A0 C3 B8 C5 71 A9 C1 11 A3 C5 A8
 51 51 C1 3B E2 C3 05 61 D3 B4 E1 C4 BE 1B 2A 1B
 A0 63 80 A0 4A C1 04 C0 35 C2 00
  Encoded length: 315 bytes
  Wall pattern: 02, Wall color: 15     Floor pattern: 00, Floor color: 13
  Flags: 
 02 02 02 02 02 02 02 02 02 02 02 02 02 02 02 02 02 02 02 02 02 02 02 02 02 02 02 02 02 02 02 02
 02 00 00 00 40 00 00 00 00 00 00 00 00 00 00 00 00 00 00 00 00 00 00 00 00 00 57 30 00 40 00 00
 02 38 00 00 00 02 02 02 00 02 02 02 00 02 02 00 00 02 02 02 00 02 02 00 00 00 57 30 00 40 00 00
 02 00 00 00 00 00 42 00 02 00 00 00 02 00 00 00 02 00 00 00 02 42 00 00 53 02 00 00 00 02 00 00
 02 38 00 00 00 02 02 02 00 00 00 32 00 02 46 02 00 33 00 00 00 02 02 02 02 02 33 00 00 02 27 00
 02 00 00 00 02 00 00 00 00 00 00 00 00 00 02 00 00 00 02 00 00 33 33 44 00 02 33 00 00 02 00 00
 02 00 00 42 02 00 00 00 00 32 32 00 00 00 02 00 00 02 00 02 00 00 00 00 00 02 00 00 02 00 00 00
 02 03 03 03 02 32 00 02 00 02 02 00 00 42 04 44 00 02 00 02 00 00 00 00 02 00 00 00 02 27 00 00
 02 00 00 00 02 00 00 00 02 00 00 02 00 00 04 00 00 02 00 02 00 00 02 00 02 33 00 00 02 27 00 00
 02 00 00 00 02 00 00 32 02 19 00 00 02 02 02 02 02 00 33 02 00 02 00 00 02 33 00 00 02 00 00 00
 02 00 00 40 00 02 00 00 02 06 00 42 00 00 00 00 00 00 00 33 00 02 00 42 02 00 00 02 00 00 00 00
 02 00 40 00 56 00 00 00 02 00 00 00 00 00 00 00 00 00 00 00 00 02 00 02 00 00 00 02 27 00 40 40
 02 40 00 00 56 00 00 00 02 00 00 00 00 00 00 02 02 02 02 00 00 02 00 02 33 00 00 02 27 00 33 00
 02 00 00 38 00 56 56 56 00 02 02 02 02 02 02 00 00 00 00 02 02 00 00 02 33 00 00 02 00 00 02 00
 02 00 00 00 00 00 00 40 00 00 00 00 38 53 02 00 00 02 00 02 00 00 42 02 00 00 02 00 00 00 02 00
 02 38 00 00 00 00 40 00 00 00 00 00 00 00 02 00 00 00 00 02 00 00 02 00 00 00 02 53 00 27 02 00
 02 02 02 02 02 02 02 02 02 02 02 00 00 00 02 00 02 39 00 02 00 00 02 33 00 00 02 27 00 00 02 00
 02 00 00 00 00 53 00 00 00 30 00 02 00 00 02 00 02 00 00 02 00 00 02 33 00 00 02 00 00 02 00 00
 02 53 00 00 00 00 00 00 00 00 30 02 00 00 02 00 00 02 00 02 00 00 02 00 00 02 00 00 00 02 00 00
 02 30 00 00 00 02 02 02 02 00 00 02 00 00 02 00 00 02 00 02 00 02 00 00 00 02 00 00 27 02 33 00
 02 00 00 00 02 00 00 00 00 00 00 02 00 00 00 56 00 02 00 00 00 02 30 00 00 56 27 00 00 02 00 00
 02 00 00 00 02 27 00 00 00 00 00 00 02 00 00 56 00 02 40 00 00 02 30 00 00 56 03 03 56 00 00 00
 02 00 00 00 02 00 00 02 30 00 00 00 02 56 56 56 00 02 00 40 00 02 00 00 02 17 59 24 56 00 00 00
 02 30 00 00 02 00 00 02 00 00 00 00 02 00 00 00 00 02 19 00 02 00 00 00 02 03 03 03 02 00 00 00
 02 42 00 00 02 00 00 02 00 00 00 02 00 00 00 00 00 02 00 19 02 00 00 59 02 58 33 00 02 00 00 33
 02 00 00 27 02 00 00 02 00 00 00 02 02 02 02 02 02 02 02 02 02 00 00 17 02 02 02 02 00 00 00 00
 02 00 02 02 02 00 00 00 02 02 02 00 30 00 40 00 00 00 00 00 04 00 00 02 00 00 00 00 00 00 00 00
 02 30 00 00 02 27 00 00 00 00 00 00 00 00 40 00 00 00 53 00 04 00 00 02 00 00 00 00 00 17 17 02
 02 00 00 00 02 00 00 00 00 00 00 30 00 00 02 02 02 02 02 02 02 02 02 02 00 00 17 02 02 02 02 00
 02 00 00 00 00 02 02 02 02 02 02 02 02 02 00 00 33 00 00 33 00 00 59 02 00 00 02 00 00 00 00 05
 02 00 27 00 00 00 00 00 00 00 00 00 00 00 00 00 00 00 00 00 00 00 00 02 00 00 02 00 00 00 00 00
 02 27 42 27 02 00 00 00 00 27 27 02 00 00 00 00 00 00 00 00 00 00 00 40 00 00 04 00 53 00 00 00
 02 02 02 02 02 02 02 02 02 02 02 02 02 02 02 02 02 02 02 02 02 02 02 02 02 02 02 02 02 02 02 02
