Gauntlet (rev 1 - 9)
Maze number: 15
Offset for maze 14: 232897 - 0x038dc1
big endian buf: [%!l(uint8=0) %!l(uint8=3) %!l(uint8=141) %!l(uint8=193)]
G:1 Maze real addr: 232900 - 0x038DC4, bank 0, boff: 0x0000
Maze read from: 0x038dc4 - 232900
compresssed: 377
 08 14 07 1B 00 00 13 5B 75 17 04 64 40 A0 1B 81
 64 C1 21 80 A0 C0 13 A0 1B 81 A0 1E 81 C1 21 A0
 46 80 A1 E1 C0 A1 21 61 C8 A6 41 A0 E1 E1 E1 21
 C1 A4 0B C2 21 C7 03 A0 E0 E0 E1 C5 17 C1 0E 0B
 CB 2B A1 E2 1B C9 0E 0B E2 E2 C5 18 A1 C2 1E C3
 B3 52 0E 82 0B CE 05 C6 B3 C5 0E 0B C8 0B 80 C0
 06 73 69 C9 2B A2 C1 03 A3 B2 C9 03 84 A0 CA B9
 C5 03 C1 B5 C2 18 C8 21 6B C1 B5 11 80 A0 C0 72
 03 72 E7 C1 28 AA E1 11 80 A0 C1 2A 80 58 4B 80
 04 C2 12 81 E2 11 80 A2 B8 11 43 C0 28 C3 BB C4
 B2 A1 B7 35 E2 60 C1 28 11 C0 17 51 0B 81 C2 13
 C8 2B 35 A0 C8 28 BC C1 BF 0B 61 BB A0 28 A9 C0
 A9 28 C0 17 C0 0B C2 28 80 A0 C2 B3 C2 1A 1B 80
 A0 E5 C4 A1 0B BF E1 C4 04 E5 E1 E7 28 40 E3 C2
 A2 E2 C0 28 C0 A9 2A C1 0B C3 28 80 C0 27 81 C1
 B4 C2 21 A0 11 80 A0 C4 18 40 A0 C1 B2 C2 A1 B5
 E5 28 A1 11 C3 71 60 71 03 E1 C1 04 CD B2 11 C0
 A5 43 E2 35 B5 A5 B4 A4 E1 44 A1 E1 C1 A1 E1 43
 E2 E2 61 A0 E0 40 A0 C1 2A C5 28 42 A0 1B E4 E2
 E0 1B E0 C7 A5 03 A6 E2 E1 2C A0 11 A0 E8 C0 13
 E5 E3 C1 28 2D A0 E0 43 C1 B2 E0 E0 C0 B2 C1 20
 61 E2 E2 E7 E6 20 A1 1E A5 E2 C0 A6 C4 A1 E0 E0
 C0 B2 A0 2B C3 0C A0 E3 C4 BB C1 BE 1A A0 1A CC
 0C 18 A0 E5 1E C0 04 C1 00
  Encoded length: 377 bytes
  Wall pattern: 00, Wall color: 03     Floor pattern: 00, Floor color: 01
  Flags: 
 02 02 02 02 02 02 02 02 02 02 02 02 02 02 02 02 02 02 02 02 02 02 02 02 02 02 02 02 02 02 02 02 02
 02 00 00 00 00 53 00 27 02 27 27 02 00 00 00 00 00 53 00 00 33 33 02 00 19 02 27 27 27 02 30 30 02
 02 00 00 33 02 00 00 00 00 00 00 02 27 27 02 02 00 00 02 00 02 02 33 00 00 53 00 00 00 00 00 00 02
 02 00 02 02 02 02 02 02 02 02 00 02 27 02 00 00 02 00 00 02 00 00 02 33 00 02 02 02 02 02 02 11 02
 02 00 02 33 00 00 00 00 02 00 00 02 03 02 00 02 00 02 00 00 02 00 00 02 00 02 23 23 23 02 14 11 02
 02 00 02 00 00 02 00 00 02 00 00 02 43 04 02 00 00 00 02 27 00 02 00 02 00 02 23 02 23 02 14 11 02
 02 00 02 02 00 02 00 02 02 00 00 02 00 04 24 02 02 00 00 02 30 02 00 02 00 02 23 02 23 02 14 11 02
 02 00 02 00 00 02 00 00 02 00 00 02 00 04 02 05 00 02 00 02 00 02 00 02 00 00 00 02 23 02 14 11 02
 02 00 02 00 00 02 00 00 02 11 11 02 06 04 02 00 00 02 00 02 00 02 00 00 53 00 00 02 23 02 00 00 02
 02 00 02 43 02 02 02 00 02 03 02 02 02 02 02 00 00 02 00 02 00 02 00 00 04 03 04 02 23 02 03 02 02
 02 00 02 00 00 02 00 00 02 00 00 02 00 00 00 00 00 02 03 02 00 02 00 00 04 24 04 02 23 02 00 00 02
 02 00 02 33 00 02 00 00 02 00 00 00 00 00 00 00 53 02 00 02 17 17 02 00 04 03 04 02 23 02 00 00 02
 02 00 02 02 00 02 40 02 02 02 02 02 02 02 02 02 02 02 00 00 02 17 17 02 00 00 42 02 23 02 00 00 02
 02 00 02 00 00 02 00 00 02 27 27 04 00 00 02 18 18 02 00 00 00 02 17 17 02 02 02 02 17 02 00 23 02
 02 27 02 40 00 02 00 00 02 00 00 02 00 00 02 02 02 02 53 00 00 00 02 00 53 00 00 40 17 02 23 23 02
 02 11 02 00 00 02 19 00 00 00 00 02 00 00 00 00 43 53 02 00 00 00 00 00 00 00 00 00 40 02 00 00 02
 02 11 02 00 53 02 02 40 02 02 02 02 02 02 02 02 02 02 00 02 02 02 02 02 02 02 02 02 02 40 00 23 02
 02 11 02 00 00 40 40 02 02 00 00 02 00 00 02 26 27 27 02 00 00 00 00 00 00 02 00 00 00 00 00 02 02
 02 11 02 00 02 02 00 00 02 00 00 04 00 00 02 00 00 00 02 00 00 02 00 00 00 00 00 00 00 00 02 40 02
 02 27 02 00 02 00 02 00 02 00 02 02 02 00 02 00 02 00 40 00 02 02 02 02 02 02 02 02 02 02 42 00 02
 02 11 02 00 02 00 40 40 02 39 39 02 00 00 02 00 00 02 33 02 17 17 02 00 04 00 00 04 24 02 27 02 02
 02 00 02 00 02 00 02 02 02 00 00 02 00 00 00 02 40 02 02 17 00 00 00 00 04 00 53 04 03 02 00 02 02
 02 00 04 00 02 00 00 00 00 00 00 02 00 00 00 00 00 02 17 00 02 02 02 02 02 02 00 00 00 02 27 00 02
 02 00 02 53 02 02 02 02 02 02 02 02 02 02 02 02 02 00 00 02 00 00 00 00 00 27 02 02 00 02 02 00 02
 02 02 02 00 00 02 00 00 00 00 27 00 00 00 02 00 00 00 02 00 00 53 02 00 02 00 27 02 00 02 42 00 02
 02 00 00 00 00 40 00 00 00 27 02 27 00 00 00 00 00 02 00 00 00 02 00 02 27 00 02 00 00 02 00 00 02
 02 00 02 02 02 02 02 02 02 03 02 02 02 02 02 02 02 00 00 00 02 00 00 02 44 02 17 02 00 02 00 00 02
 02 00 02 00 00 02 00 19 02 00 00 00 00 00 02 00 00 00 00 02 00 00 40 45 02 00 02 00 00 02 00 27 02
 02 00 02 00 02 00 02 00 02 00 02 32 00 00 53 00 00 00 02 00 00 00 02 00 00 00 00 00 00 02 00 02 02
 02 00 00 00 00 00 00 02 32 02 02 30 02 02 02 02 02 02 00 00 00 02 00 02 02 02 02 02 02 02 00 00 02
 02 00 00 02 02 00 02 00 02 00 02 02 43 00 00 00 00 12 02 00 00 00 00 02 00 00 00 00 00 02 00 00 02
 02 26 02 26 00 00 00 00 00 00 00 00 00 00 00 00 00 12 24 02 00 00 00 00 00 00 02 30 00 04 00 00 02
 02 02 02 02 02 02 02 02 02 02 02 02 02 02 02 02 02 02 02 02 02 02 02 02 02 02 02 02 02 02 02 02 02
