Gauntlet (rev 1 - 9)
Maze number: 32
Offset for maze 31: 235895 - 0x039977
big endian buf: [%!l(uint8=0) %!l(uint8=3) %!l(uint8=153) %!l(uint8=119)]
G:1 Maze real addr: 252282 - 0x03D97A, bank 2, boff: 0x4000
Maze read from: 0x03d97a - 252282
compresssed: 263
 09 28 00 00 80 13 2F 4B 68 5E 61 14 80 CD 1B 2C
 28 55 43 2A CF 1B 2A 28 3A 70 55 40 81 C2 AF A0
 C2 A5 0B 81 C7 0E 81 1E 0E 85 B3 C3 1A 43 81 50
 54 0E 81 C0 0E 86 A0 47 81 C5 A9 C3 27 A4 62 81
 73 C3 18 C1 39 70 E0 6B 81 CB 39 C2 06 A0 2A C1
 1A 46 81 C8 AD 18 71 41 81 C1 B7 D9 28 81 D1 1E
 74 63 80 C0 27 CA A7 CB 39 80 A3 C3 27 D8 3B 81
 C5 A4 1B 63 CD 2A 1E C4 04 C1 35 A5 3B C6 BF C5
 A2 3B 14 C1 04 C0 05 C0 04 C1 14 3B A3 CC 3B A2
 B5 A1 35 C1 04 54 2A 6D C3 1B A4 C5 3B 81 C0 BF
 D6 27 C4 A2 39 81 75 C3 A7 B5 C9 27 60 81 C1 BF
 55 CB BF 65 81 DC 0B 81 70 C1 18 BE AC BE 48 81
 C5 1A C3 2A A0 06 C2 39 6A 81 EC 70 C0 39 18 73
 64 81 C1 B4 A4 27 C4 A7 B4 45 81 E7 0E 86 1E 57
 41 80 BF C3 1A C4 0E 81 1E 0E 81 C3 27 46 80 A6
 71 AF B7 42 80 51 68 2C 1B CD BE 2A 0B 54 C3 B3
 3A 28 2A 1B CC 14 00
  Encoded length: 263 bytes
  Wall pattern: 03, Wall color: 15     Floor pattern: 01, Floor color: 02
  Flags: PLAYER_OFFSCREEN 
  ╚══> while gauntlet has these elements, these flags probably do not operate
 02 02 02 02 02 02 02 02 02 02 02 02 02 02 02 02 02 02 02 02 02 02 02 02 02 02 02 02 02 02 02 02 02
 02 20 00 00 00 00 00 00 00 00 00 00 00 00 00 00 27 44 40 00 02 00 00 00 00 30 00 00 00 00 11 42 02
 02 00 00 00 00 00 00 00 00 00 00 00 00 00 00 00 27 42 40 58 02 33 00 00 00 00 00 00 30 00 11 11 02
 02 00 00 02 02 02 02 02 02 02 02 02 02 02 02 02 02 02 02 02 02 00 00 00 02 02 02 02 02 02 11 11 02
 02 00 00 02 00 00 00 00 00 14 14 14 30 14 14 14 14 14 14 14 02 00 00 00 00 26 00 00 00 02 11 11 02
 02 00 30 02 00 00 00 00 30 14 14 14 00 14 14 14 14 14 14 14 14 02 00 00 00 00 00 00 00 02 11 11 02
 02 00 00 02 00 00 02 02 02 02 02 02 02 02 02 02 02 00 00 00 00 39 02 02 02 02 02 00 00 02 40 40 02
 02 00 00 02 00 33 02 00 00 00 24 00 00 57 00 33 00 02 00 00 00 00 00 00 00 00 02 00 00 02 40 40 02
 02 00 00 02 00 00 02 00 00 00 00 00 00 57 00 00 00 06 02 42 00 00 26 00 00 00 02 00 00 02 11 11 02
 02 00 00 02 00 00 02 00 00 02 02 02 02 02 02 02 02 02 02 02 02 02 02 02 24 00 02 33 00 02 11 11 02
 02 00 00 02 00 00 02 00 00 02 00 00 00 00 00 00 00 00 00 00 00 00 00 02 00 00 02 00 00 02 40 40 02
 02 00 00 00 00 00 02 00 00 02 00 00 00 00 00 00 00 00 00 30 00 00 00 02 00 33 02 00 00 02 40 40 02
 02 39 00 00 00 00 02 00 00 02 00 00 02 02 02 02 02 02 02 02 02 00 00 02 00 00 02 00 00 02 00 00 02
 02 57 57 02 02 02 02 00 00 02 00 39 02 00 00 00 00 00 00 00 00 00 00 02 00 00 02 00 00 02 00 00 02
 02 00 00 02 00 59 02 59 00 02 00 00 02 00 02 02 02 02 02 27 00 00 00 02 40 00 02 00 00 02 00 00 02
 02 00 00 02 00 00 02 42 30 02 00 00 02 00 04 00 00 53 02 02 02 02 02 02 59 00 02 00 00 02 00 00 02
 02 00 00 02 00 00 02 02 02 02 59 20 02 00 04 00 05 00 04 00 02 20 59 02 02 02 02 00 00 02 00 00 02
 02 00 00 02 00 00 02 00 59 02 02 02 02 02 02 53 00 00 04 00 02 00 00 02 30 42 02 00 00 02 00 00 02
 02 00 00 02 00 00 02 00 40 02 00 00 00 27 02 02 02 02 02 00 02 00 00 02 00 59 02 59 00 02 00 00 02
 02 00 00 02 00 00 02 00 00 02 00 00 00 00 00 00 00 00 00 00 02 39 00 02 00 00 02 02 02 02 57 57 02
 02 00 00 02 00 00 02 33 00 02 00 00 02 02 02 02 02 02 02 02 02 00 00 02 00 00 02 00 00 00 00 39 02
 02 40 40 02 00 00 02 00 00 02 00 00 00 30 00 00 00 00 00 00 00 00 00 02 00 00 02 00 00 00 00 00 02
 02 40 40 02 00 00 02 00 00 02 00 00 00 00 00 00 00 00 00 00 00 00 00 02 00 00 02 00 00 02 00 00 02
 02 11 11 02 00 33 02 00 24 02 02 02 02 02 02 02 02 02 02 02 02 02 02 02 00 00 02 00 00 02 00 00 02
 02 11 11 02 00 00 02 00 00 00 26 00 00 00 00 42 02 06 00 00 00 57 00 00 00 00 02 00 00 02 00 00 02
 02 40 40 02 00 00 02 00 00 00 00 00 00 00 00 00 00 02 00 33 00 57 24 00 00 00 02 33 00 02 00 00 02
 02 40 40 02 00 00 02 02 02 02 02 02 39 00 00 00 00 00 02 02 02 02 02 02 02 02 02 00 00 02 00 00 02
 02 11 11 02 00 00 00 00 00 00 00 00 02 14 14 14 14 14 14 14 14 30 00 00 00 00 00 00 00 02 30 00 02
 02 11 11 02 00 00 00 00 26 00 00 00 00 02 14 14 14 30 14 14 14 00 00 00 00 39 00 00 00 02 00 00 02
 02 11 11 02 02 02 02 02 02 02 00 00 33 02 02 02 02 02 02 02 02 02 02 02 02 02 02 02 02 02 00 00 02
 02 11 11 00 00 30 00 00 00 00 00 00 00 02 00 40 44 27 00 00 00 00 00 00 00 00 00 00 00 00 00 00 02
 02 42 11 00 00 00 00 00 30 00 00 00 00 02 58 40 42 27 00 00 00 00 00 00 00 00 00 00 00 00 00 20 02
 02 02 02 02 02 02 02 02 02 02 02 02 02 02 02 02 02 02 02 02 02 02 02 02 02 02 02 02 02 02 02 02 02
