Gauntlet (rev 1 - 9)
Maze number: 6
Offset for maze 5: 230663 - 0x038507
big endian buf: [%!l(uint8=0) %!l(uint8=3) %!l(uint8=133) %!l(uint8=7)]
G:1 Maze real addr: 230666 - 0x03850A, bank 0, boff: 0x0000
Maze read from: 0x03850a - 230666
compresssed: 110
 00 00 00 00 00 31 03 68 5A A5 66 2C 80 44 40 C5
 54 28 40 C4 27 2A FC 65 FF DB 1A D3 B4 EA C3 B5
 DF D5 28 40 D7 AB D8 28 40 DF DF 79 76 CE A8 B9
 C4 B9 A8 DF DF C2 BF 5D 05 CD 5F DF D3 A9 C5 A8
 7E 76 DF 49 DA AB C1 2B D4 28 40 DF D4 A5 C1 19
 E3 D5 1A 66 DF E1 C5 B9 C4 B9 C5 A6 63 D8 28 DB
 1B 41 BE 06 45 B5 28 C4 53 28 B6 2A 46 00
  Encoded length: 110 bytes
  Wall pattern: 01, Wall color: 03     Floor pattern: 03, Floor color: 00
  Flags: 
 02 02 02 02 02 02 02 02 02 02 02 02 02 02 02 02 02 02 02 02 02 02 02 02 02 02 02 02 02 02 02 02 02
 02 44 00 00 00 00 00 40 02 40 00 00 00 00 00 00 37 00 00 00 00 00 40 02 40 00 00 00 00 00 39 42 02
 02 00 00 00 00 00 00 00 02 00 00 00 00 00 00 00 00 00 00 00 00 00 00 02 00 00 00 00 00 02 00 00 02
 02 00 00 00 26 00 00 00 02 00 00 00 00 00 00 00 00 00 00 00 00 00 00 02 00 00 00 00 00 00 00 00 02
 02 00 00 00 00 02 00 00 02 00 00 00 00 02 00 00 00 00 00 02 00 00 00 02 00 00 00 00 00 00 00 00 02
 02 00 26 00 00 00 00 00 02 00 00 00 00 02 00 00 00 00 00 02 00 00 00 02 00 00 00 00 00 00 00 00 02
 02 00 00 02 00 00 00 00 02 00 00 00 00 02 00 00 00 00 00 02 00 00 00 00 00 00 00 00 00 00 00 00 02
 02 00 00 00 00 00 00 00 00 00 00 00 00 02 00 00 00 00 00 02 00 00 00 00 00 00 00 00 00 00 00 40 02
 02 40 00 00 00 00 00 00 00 00 00 00 00 02 00 00 00 00 00 02 00 00 00 00 00 00 02 02 02 02 02 02 02
 02 02 02 02 02 02 00 00 00 00 00 00 00 02 00 00 00 00 00 02 00 00 00 00 00 00 00 00 00 00 00 40 02
 02 40 00 00 00 00 00 00 00 00 00 00 00 02 00 00 00 00 00 02 00 00 00 00 00 00 00 00 00 00 00 00 02
 02 00 00 00 00 00 00 00 00 00 00 00 00 02 00 00 00 00 00 02 00 00 00 00 00 00 00 00 00 00 00 00 02
 02 00 00 00 00 00 00 00 00 00 00 00 38 02 00 00 00 00 00 02 38 00 00 00 00 00 00 00 00 00 00 00 02
 02 00 00 00 02 02 02 02 02 02 02 02 02 02 00 00 00 00 00 02 02 02 02 02 02 02 02 02 02 00 00 00 02
 02 00 00 00 00 00 00 00 00 00 00 00 00 00 00 00 00 00 00 00 00 00 00 00 00 00 00 00 00 00 00 00 02
 02 00 00 00 00 00 00 00 00 00 00 00 00 00 00 00 00 00 00 00 00 00 00 00 00 00 00 00 00 00 00 00 02
 02 37 00 00 00 00 00 00 00 00 00 00 00 00 00 00 05 00 00 00 00 00 00 00 00 00 00 00 00 00 00 37 02
 02 00 00 00 00 00 00 00 00 00 00 00 00 00 00 00 00 00 00 00 00 00 00 00 00 00 00 00 00 00 00 00 02
 02 00 00 00 00 00 00 00 00 00 00 00 00 00 00 00 00 00 00 00 00 00 00 00 00 00 00 00 00 00 00 00 02
 02 00 00 00 02 02 02 02 02 02 02 02 02 02 00 00 00 00 00 02 02 02 02 02 02 02 02 02 02 00 00 00 02
 02 00 00 00 00 00 00 00 00 00 00 00 38 02 00 00 00 00 00 02 38 00 00 00 00 00 00 00 00 00 00 00 02
 02 00 00 00 00 00 00 00 00 00 00 00 00 02 00 00 00 00 00 02 00 00 00 00 00 00 00 00 00 00 00 40 02
 02 00 00 00 00 00 00 00 00 00 00 00 00 02 00 00 00 00 00 02 00 00 00 00 00 00 00 02 02 02 02 02 02
 02 02 02 02 02 02 02 00 00 43 00 00 00 02 00 00 00 00 00 02 00 00 00 00 00 00 00 00 00 00 00 40 02
 02 40 00 00 00 00 00 00 00 00 00 00 00 02 00 00 00 00 00 02 00 00 00 00 00 00 00 00 00 00 00 00 02
 02 00 00 00 00 00 00 00 00 00 00 00 00 02 00 00 00 00 00 02 00 00 02 02 02 02 02 02 02 00 00 25 02
 02 00 00 00 02 00 00 00 00 02 00 00 00 02 00 00 00 00 00 02 00 00 02 00 00 00 00 26 00 00 00 00 02
 02 00 00 26 00 00 00 00 00 02 00 00 00 02 00 00 00 00 00 02 00 00 02 00 00 00 00 00 00 00 00 00 02
 02 00 00 00 00 00 02 00 00 02 00 00 00 02 00 00 00 00 00 02 00 00 02 00 00 00 02 02 02 02 02 02 02
 02 00 00 00 00 26 00 00 00 02 00 00 00 00 00 00 00 00 00 00 00 00 02 00 00 00 00 00 00 00 00 40 02
 02 00 00 00 00 00 00 00 00 02 00 00 00 00 00 00 00 00 00 00 00 00 02 00 00 00 00 00 27 00 00 40 02
 02 06 00 00 00 00 00 00 40 02 40 00 00 00 00 00 37 00 00 00 00 40 02 42 00 00 00 00 00 00 00 40 02
 02 02 02 02 02 02 02 02 02 02 02 02 02 02 02 02 02 02 02 02 02 02 02 02 02 02 02 02 02 02 02 02 02
