Gauntlet (rev 1 - 9)
Maze number: 9
Offset for maze 8: 231059 - 0x038693
big endian buf: [%!l(uint8=0) %!l(uint8=3) %!l(uint8=134) %!l(uint8=147)]
G:1 Maze real addr: 231062 - 0x038696, bank 0, boff: 0x0000
Maze read from: 0x038696 - 231062
compresssed: 264
 06 33 02 01 00 24 57 68 7B 98 4A 2A 80 62 41 C2
 06 28 C0 2A 60 C0 19 C0 2A 0A 81 1A 81 C2 06 CC
 19 D2 28 66 DB 19 70 81 41 40 0A 81 28 68 77 B4
 AC 28 60 40 40 42 C0 19 40 70 80 38 28 C3 2A 70
 82 28 AF A3 1A 40 C3 51 3B C1 2A C2 50 19 C2 50
 28 09 C0 50 28 44 D0 3B C1 09 4C C2 18 81 CA 19
 61 63 C4 A5 28 83 40 83 C0 09 4A 44 4C 09 42 A7
 60 65 C8 A6 28 C3 5A 53 3B 50 28 C3 5D AB 28 61
 63 44 C2 18 81 42 C0 2A 70 80 28 BF 28 CB BF A4
 BF 41 C1 BF DF 4C C3 52 3B CE 53 28 A6 B2 67 C2
 51 3B 18 A7 28 C3 18 38 CB A5 2C C3 51 3B C3 38
 C1 05 48 42 C6 BF C6 A5 28 42 C6 19 62 06 47 18
 06 18 28 A6 4C 43 C2 52 2A C2 56 28 43 A7 68 64
 C1 A6 C4 1A 4C C2 50 28 C3 51 3B C4 38 A4 28 83
 A6 0A 4C C0 19 40 70 84 70 81 71 62 7E 84 75 D2
 28 84 61 C1 BE 2A 0A 81 40 B8 28 43 B9 61 C1 BE
 3B 0B 82 BE 2C C2 1A 00
  Encoded length: 264 bytes
  Wall pattern: 04, Wall color: 07     Floor pattern: 02, Floor color: 05
  Flags: 
 02 02 02 02 02 02 02 02 02 02 02 02 02 02 02 02 02 02 02 02 02 02 02 02 02 02 02 02 02 02 02 02 02
 02 42 00 00 00 59 00 02 40 00 00 00 06 40 02 42 00 59 00 25 02 42 10 10 10 26 02 26 00 00 00 06 02
 02 00 00 00 00 00 00 02 00 00 00 00 00 25 02 00 00 00 00 00 02 00 00 00 00 00 02 00 00 00 00 00 02
 02 40 00 00 00 00 00 02 00 59 00 00 00 00 02 00 00 00 00 00 02 00 00 00 00 00 02 00 00 00 00 00 02
 02 00 00 00 00 00 25 02 10 10 10 00 00 40 02 40 10 10 10 40 02 00 00 00 00 00 02 00 00 59 00 00 02
 02 00 00 00 00 00 10 02 02 02 02 02 02 02 02 02 02 02 02 02 02 40 00 59 00 40 02 40 00 00 00 40 02
 02 25 00 40 00 10 10 56 40 00 00 00 00 42 02 10 10 10 10 40 02 02 02 02 02 02 02 02 02 02 02 02 02
 02 02 02 02 02 02 02 02 26 00 40 00 00 00 02 24 00 00 59 00 02 42 00 00 00 24 02 25 00 00 00 24 02
 02 40 09 00 24 00 40 02 00 00 00 00 40 00 02 00 00 00 00 00 02 00 00 00 00 00 02 00 00 00 59 00 02
 02 09 00 00 00 00 00 02 00 00 00 00 00 00 02 40 00 00 00 24 02 24 00 00 00 00 02 00 00 00 00 00 02
 02 25 00 00 59 00 00 02 00 59 00 00 00 00 02 02 02 02 02 02 02 40 40 40 40 40 02 40 40 40 40 40 02
 02 09 00 00 00 00 00 02 00 00 00 00 00 40 02 00 00 00 00 40 02 00 00 00 00 00 02 00 00 00 00 00 02
 02 40 09 00 00 00 40 02 02 02 02 02 02 02 02 00 59 00 00 00 02 00 00 59 00 00 02 00 00 00 00 00 02
 02 02 02 02 02 02 02 02 40 00 00 00 00 24 02 00 00 00 00 00 02 00 00 00 00 24 02 00 00 00 59 24 02
 02 40 00 00 00 00 24 02 00 00 00 00 00 00 02 00 00 00 00 00 02 02 02 02 02 02 02 02 02 02 02 02 02
 02 40 00 00 59 00 00 02 00 59 00 00 00 00 02 40 00 00 00 24 02 24 00 00 00 40 02 42 00 10 10 40 02
 02 40 00 00 00 00 00 02 00 00 00 00 00 00 02 02 02 02 02 02 02 00 00 40 00 00 02 00 00 00 00 00 02
 02 00 00 00 00 00 00 02 00 00 00 00 00 00 02 00 00 00 00 00 02 00 00 00 00 00 02 00 00 00 00 00 02
 02 00 00 00 00 00 00 02 40 00 00 00 00 24 02 00 00 59 00 00 02 00 00 00 00 00 02 00 00 00 00 00 02
 02 24 00 00 00 00 40 02 02 02 02 02 02 02 02 00 00 00 00 00 02 00 00 59 00 00 02 24 00 00 59 24 02
 02 02 02 02 02 02 02 02 40 00 00 00 00 24 56 00 00 00 00 00 02 00 00 00 00 00 02 02 02 02 02 02 02
 02 44 00 00 00 00 24 02 00 59 00 00 00 00 56 00 00 05 00 00 02 00 00 00 00 00 02 40 00 00 00 40 02
 02 00 00 00 00 00 00 02 00 00 00 00 00 00 02 02 02 02 02 02 02 40 00 00 00 40 02 00 00 00 00 00 02
 02 25 00 00 00 59 06 02 00 00 00 00 00 00 02 40 24 06 24 40 02 02 02 02 02 02 02 00 00 00 00 00 02
 02 00 00 00 00 00 00 02 40 00 00 00 00 40 02 00 00 24 00 00 02 42 00 00 00 24 02 00 00 00 00 00 02
 02 40 00 00 00 00 40 02 02 02 02 02 02 02 02 00 00 00 00 00 02 00 00 00 59 00 02 00 00 00 59 00 02
 02 02 02 02 02 02 02 02 00 00 00 00 00 26 02 00 00 00 00 00 02 00 00 00 00 00 02 40 00 00 00 24 02
 02 40 00 00 00 00 24 02 00 59 00 00 00 00 02 56 02 02 02 02 02 40 40 40 40 40 02 02 02 02 02 02 02
 02 10 00 00 00 00 00 02 00 00 00 00 00 00 02 40 00 25 00 40 02 10 10 10 10 10 02 00 10 10 10 00 02
 02 10 00 00 00 59 00 02 00 00 00 00 00 00 02 00 00 00 00 00 02 10 10 10 10 10 02 00 00 00 00 00 02
 02 10 00 00 00 00 00 02 00 00 00 00 00 00 02 00 00 00 00 00 02 40 40 40 40 40 02 00 00 59 00 00 02
 02 42 10 10 10 00 40 02 40 00 00 00 00 40 02 00 00 59 00 00 02 59 11 11 11 11 02 44 00 00 00 26 02
 02 02 02 02 02 02 02 02 02 02 02 02 02 02 02 02 02 02 02 02 02 02 02 02 02 02 02 02 02 02 02 02 02
