Gauntlet (rev 1 - 9)
Maze number: 18
Offset for maze 17: 234053 - 0x039245
big endian buf: [%!l(uint8=0) %!l(uint8=3) %!l(uint8=146) %!l(uint8=69)]
G:1 Maze real addr: 234056 - 0x039248, bank 0, boff: 0x0000
Maze read from: 0x039248 - 234056
compresssed: 308
 08 06 07 15 00 14 46 68 9E 09 84 2C 80 C0 35 44
 C3 19 28 CD 06 81 C0 21 44 C3 19 A0 03 8B C4 35
 C0 35 42 C3 19 A0 CC 72 27 45 C3 19 A0 E2 35 C0
 03 84 70 72 2A 40 83 C3 19 A0 E2 C2 0D 80 0E 82
 7E 19 A0 E2 C0 20 C1 18 0E 28 82 04 03 82 C2 19
 C5 1B A0 E2 C3 B3 0D 0E 28 43 14 81 C2 A8 E1 E0
 42 0D 0E 28 35 2A 80 35 28 14 80 C0 61 1B E8 C2
 20 41 0D 80 0E 81 0D 0E 80 18 24 C0 2A C2 AD B3
 AC 4D 0E 81 61 28 80 0B 80 1B 80 09 83 C8 AF A6
 C9 0F 81 11 80 20 CA 2A 1B E6 C3 03 A3 11 AB 1B
 C4 61 1A C9 27 C9 24 C5 2A BF C4 B4 C7 A6 C5 55
 BF D0 20 C2 2A 18 CF A2 B4 C5 03 C2 A1 B2 EB C1
 1F D1 28 80 54 C2 62 1A CA B4 C5 A3 B5 03 42 45
 83 C0 35 C2 64 1D 0D 84 D0 A1 C7 A3 BA D0 60 6A
 78 28 84 C2 A2 C3 0D C1 05 E8 C2 1B C0 1B C3 66
 0D C8 61 1A C2 1B 81 C2 BB A1 41 C2 0D C3 35 43
 C3 BF E0 E0 C1 64 35 C3 B5 A3 B3 CD BB A4 BA 03
 C2 1D C0 0D 80 C1 75 2A C1 1E 81 C1 0F 81 75 B9
 A7 BC 62 A0 C0 B2 AB CE BE C0 1C C0 72 72 73 35
 BD 2C CB 00
  Encoded length: 308 bytes
  Wall pattern: 04, Wall color: 06     Floor pattern: 01, Floor color: 04
  Flags: 
 02 02 02 02 02 02 02 02 02 02 02 02 02 02 02 02 02 02 02 02 02 02 02 02 02 02 02 02 02 02 02 02 02
 02 44 00 53 00 00 00 00 00 40 00 00 00 00 25 40 00 00 00 00 00 00 00 00 00 00 00 00 00 02 06 06 02
 02 00 33 00 00 00 00 00 40 00 00 00 00 25 02 03 03 03 03 03 03 03 03 03 03 03 03 03 00 02 00 00 02
 02 53 00 53 00 00 00 40 00 00 00 00 25 02 00 00 00 00 00 00 00 00 00 00 00 00 00 04 00 02 00 39 02
 02 00 00 00 00 00 40 00 00 00 00 25 02 00 00 00 02 53 02 03 03 03 03 03 03 04 00 04 00 02 00 42 02
 02 40 40 40 40 40 00 00 00 00 25 02 00 00 00 02 00 00 02 13 13 14 14 14 14 04 00 00 00 02 00 00 02
 02 00 00 00 00 00 00 00 00 25 02 00 00 00 02 00 32 00 02 24 14 40 40 40 40 04 03 03 03 02 00 00 02
 02 25 00 00 00 00 00 00 27 02 00 00 00 02 00 00 02 00 02 13 14 40 00 00 00 00 40 20 20 02 00 00 02
 02 02 02 02 02 02 02 02 02 02 00 00 02 00 02 00 02 00 40 13 14 40 53 42 42 53 40 20 20 02 30 00 02
 02 27 00 00 00 00 00 00 00 00 00 02 00 00 00 32 02 00 40 13 13 14 14 14 13 14 14 24 36 02 42 00 02
 02 00 02 02 02 02 02 02 02 02 02 02 02 02 02 02 02 02 02 02 02 02 02 02 02 02 02 02 02 02 00 00 02
 02 00 00 00 00 00 00 00 00 00 00 00 40 14 14 14 30 00 00 40 40 11 11 27 27 09 09 09 09 02 00 00 02
 02 00 00 00 02 00 02 02 02 02 02 02 02 02 02 02 02 02 02 02 02 02 02 02 02 02 02 02 09 02 00 00 02
 02 00 00 00 02 00 02 00 15 15 15 17 17 32 00 00 00 00 00 00 00 00 00 00 00 42 27 02 09 02 00 00 02
 02 00 02 00 02 00 02 03 02 02 02 02 17 02 02 02 02 02 02 02 02 02 02 02 02 27 00 02 09 02 00 30 02
 02 00 26 00 02 00 02 00 02 00 00 00 02 39 00 00 00 00 00 00 00 00 00 00 36 02 09 02 09 02 00 42 02
 02 00 00 00 02 00 02 00 02 00 00 00 02 00 02 02 02 02 02 02 02 02 00 00 00 02 09 02 09 02 00 00 02
 02 00 00 00 02 00 00 00 02 00 02 00 02 00 02 32 00 00 00 42 24 02 00 00 00 02 09 02 00 02 00 00 02
 02 00 00 00 02 02 02 02 02 00 02 00 02 00 02 03 02 00 02 02 02 02 00 00 00 02 09 02 00 02 00 00 02
 02 00 02 00 02 31 00 00 00 00 02 00 02 00 02 00 02 00 02 00 00 00 00 00 40 02 09 02 00 02 30 00 02
 02 00 26 00 02 00 00 00 00 00 02 00 02 00 02 00 02 00 02 00 02 02 02 02 02 02 03 02 00 02 40 00 02
 02 00 00 00 02 40 40 40 40 40 02 53 02 00 00 30 02 00 02 00 02 29 13 13 13 13 13 02 00 02 00 00 02
 02 00 00 00 02 00 00 00 00 00 02 00 02 02 02 00 02 00 02 00 02 00 02 02 02 02 02 02 00 02 00 00 02
 02 00 00 00 02 00 00 00 00 00 02 00 02 30 00 30 02 00 02 00 02 00 02 00 00 00 00 04 00 02 00 00 02
 02 00 00 00 02 40 40 40 40 40 02 00 02 00 02 02 02 00 02 00 02 13 02 00 05 00 00 02 00 02 00 00 02
 02 00 02 00 02 00 27 00 27 00 02 00 02 30 00 00 02 00 02 00 02 13 02 00 00 00 00 02 00 02 00 30 02
 02 00 26 00 02 00 27 27 27 00 02 00 02 02 02 00 02 40 02 00 02 13 02 00 00 00 53 02 00 02 00 40 02
 02 00 00 00 02 00 02 00 02 00 02 30 00 00 00 00 02 53 02 00 02 00 02 02 02 02 02 02 00 02 00 00 02
 02 00 00 00 02 00 00 00 00 00 02 02 02 02 02 02 02 03 02 00 02 29 00 13 13 00 00 04 00 02 00 00 02
 02 00 42 00 02 30 30 30 00 00 15 15 15 04 00 00 00 00 02 00 02 02 02 02 02 02 02 02 02 02 30 00 02
 02 00 02 00 02 02 02 02 02 02 02 02 02 02 02 02 02 00 02 00 00 00 00 00 00 00 00 00 00 00 00 00 02
 02 00 28 00 04 00 00 00 04 00 00 00 04 00 00 00 00 53 02 44 00 00 00 00 00 00 00 00 00 00 00 00 02
 02 02 02 02 02 02 02 02 02 02 02 02 02 02 02 02 02 02 02 02 02 02 02 02 02 02 02 02 02 02 02 02 02
