Gauntlet (rev 1 - 9)
Maze number: 56
Offset for maze 55: 230805 - 0x038595
big endian buf: [%!l(uint8=0) %!l(uint8=3) %!l(uint8=133) %!l(uint8=149)]
G:1 Maze real addr: 255384 - 0x03E598, bank 3, boff: 0x6000
Maze read from: 0x03e598 - 255384
compresssed: 238
 00 0D 01 03 00 54 40 68 5B A1 54 06 80 C0 2A 43
 44 43 44 19 2A 79 40 70 42 71 40 71 41 72 C6 A9
 39 AF A0 28 82 D3 28 40 C1 21 2C 44 C1 57 53 51
 28 41 C1 55 28 C0 AF A1 CD 3A C0 27 A0 48 CA 19
 D2 28 7C C7 27 C1 27 A0 C1 1E 80 A0 47 43 C7 A3
 C0 A3 E4 43 C0 2A C4 B4 DA 14 C3 A1 DD 1E 80 D1
 27 C3 19 C0 2A C1 3B 44 80 A4 24 C0 B3 43 E0 E3
 B8 A0 BC A2 3B E8 41 C3 19 28 61 C0 BF C4 3B C8
 05 C1 A6 63 CA 1E B7 E5 41 4A 80 A0 43 80 A0 C2
 A4 50 28 C3 52 1B 63 65 E2 54 28 C3 52 A0 28 69
 42 E6 E2 28 81 64 49 C4 2A C3 BF C2 BF 6B B3 A8
 B2 D4 28 DA BB 42 CB 2E E9 C3 A6 C5 A3 B3 46 80
 1E C8 1E A0 E5 27 C0 27 40 C2 2A 28 D4 28 C4 2A
 C7 BA 4F 45 C0 55 AB B7 AA B7 1E 64 E0 1B 61 28
 E7 1B 60 2A 1B 42 C1 BE 41 45 48 47 C1 00
  Encoded length: 238 bytes
  Wall pattern: 04, Wall color: 00     Floor pattern: 05, Floor color: 04
  Flags: 
 02 02 02 02 02 02 02 02 02 02 02 02 02 02 02 02 02 02 02 02 02 02 02 02 02 02 02 02 02 02 02 02 02
 02 06 00 42 00 00 00 00 40 00 00 00 00 00 40 00 00 00 00 40 00 00 00 00 00 40 25 42 00 00 00 00 02
 02 00 00 00 00 00 20 00 40 00 20 00 00 00 40 00 00 20 00 40 00 00 20 00 00 40 00 00 00 20 00 00 02
 02 00 00 00 02 02 02 02 02 02 02 02 02 02 02 57 02 02 02 02 02 02 02 02 02 02 02 02 02 02 02 02 02
 02 40 40 40 02 00 00 00 00 00 00 00 00 00 00 00 00 00 00 00 00 00 00 00 00 40 00 40 00 00 33 44 02
 02 00 00 00 02 40 00 00 33 00 00 00 00 00 00 00 00 33 00 00 00 00 33 00 00 40 00 00 40 00 00 33 02
 02 00 00 00 02 00 40 00 02 02 02 02 02 02 02 02 02 02 02 02 02 02 02 02 02 02 00 00 00 02 00 00 02
 02 00 02 00 02 00 00 02 58 00 39 02 00 00 00 00 00 00 00 00 00 40 00 00 00 02 00 00 00 02 00 00 02
 02 25 02 00 02 00 00 02 00 00 00 00 00 00 00 00 00 00 00 00 00 40 00 00 00 02 00 00 00 02 00 00 02
 02 00 02 20 02 00 00 02 00 00 00 00 39 00 00 39 02 00 00 30 30 02 00 00 00 02 00 00 00 02 40 00 02
 02 00 02 40 02 00 00 02 00 00 00 02 02 02 02 02 00 02 02 02 02 00 00 00 00 02 02 00 00 02 00 40 02
 02 42 02 00 02 00 00 02 00 00 00 02 00 00 00 00 00 00 00 00 00 02 00 00 00 02 00 00 00 02 00 00 02
 02 00 02 20 02 00 00 00 02 02 00 02 00 00 00 00 00 00 00 00 00 02 00 00 00 02 00 00 00 02 00 00 02
 02 00 02 00 02 00 00 02 30 30 00 02 00 00 00 00 00 00 00 00 00 02 00 00 00 02 00 00 39 02 00 00 02
 02 25 02 42 02 00 59 02 00 00 00 02 40 40 02 02 02 02 02 36 00 02 00 00 00 02 40 00 02 02 00 00 02
 02 02 02 02 02 02 02 02 59 00 00 02 00 00 00 00 00 00 02 00 00 40 00 00 00 02 25 40 00 02 27 00 02
 02 00 00 00 00 00 59 02 00 00 00 02 00 00 00 00 05 00 00 02 02 02 02 02 02 02 00 00 00 02 27 00 02
 02 00 00 00 00 00 00 02 00 00 30 02 00 00 00 00 00 00 02 00 00 40 00 00 00 02 00 00 00 02 00 00 02
 02 40 40 02 02 00 00 02 40 40 02 00 00 00 02 02 02 02 02 33 00 40 00 00 00 02 33 00 00 02 27 00 02
 02 00 00 27 02 00 00 02 00 00 27 02 00 00 02 33 00 00 00 00 00 40 00 00 00 02 33 00 00 02 02 40 02
 02 00 00 00 02 00 00 02 00 00 27 02 00 00 40 00 00 00 00 00 00 02 02 00 00 02 02 40 40 02 00 00 02
 02 00 00 27 02 00 00 02 00 00 00 02 00 00 40 00 00 00 00 00 42 02 00 00 00 02 00 00 00 02 00 00 02
 02 00 00 00 02 00 00 02 00 00 27 02 02 02 02 02 02 02 02 02 02 02 00 00 00 02 00 00 00 02 00 00 02
 02 00 00 00 02 00 00 02 00 00 00 40 00 00 00 00 00 02 00 00 00 00 00 00 00 02 00 00 00 02 00 00 02
 02 00 00 00 02 00 00 02 00 00 00 40 00 00 00 00 00 02 00 00 00 00 00 00 46 02 00 00 00 02 00 00 02
 02 00 00 02 02 00 00 00 02 02 02 02 02 02 02 00 00 02 00 00 00 02 02 02 02 02 00 00 00 02 00 00 02
 02 40 40 30 02 00 00 00 00 00 00 00 00 30 02 00 00 02 00 00 00 02 39 00 39 00 40 00 00 02 42 40 02
 02 00 00 00 02 00 00 00 00 00 00 00 00 00 00 00 00 02 00 00 00 40 00 00 00 00 00 42 00 02 00 00 02
 02 00 00 00 02 00 00 00 00 00 00 00 00 00 00 00 00 02 00 00 00 40 00 00 00 00 00 00 40 02 33 00 02
 02 00 00 00 00 02 02 02 02 02 02 02 02 02 02 02 02 02 02 02 02 02 02 02 02 02 02 02 02 02 30 00 02
 02 00 00 00 27 00 02 27 00 00 27 40 00 00 00 00 00 00 00 00 02 27 00 27 42 27 00 00 00 40 00 00 02
 02 00 00 40 00 00 00 00 00 00 40 00 00 00 00 00 00 00 00 00 40 00 00 00 00 00 00 00 00 40 00 00 02
 02 02 02 02 02 02 02 02 02 02 02 02 02 02 02 02 02 02 02 02 02 02 02 02 02 02 02 02 02 02 02 02 02
