Gauntlet (rev 1 - 9)
Maze number: 2
Offset for maze 1: 230206 - 0x03833e
big endian buf: [%!l(uint8=0) %!l(uint8=3) %!l(uint8=131) %!l(uint8=62)]
G:1 Maze real addr: 230209 - 0x038341, bank 0, boff: 0x0000
Maze read from: 0x038341 - 230209
compresssed: 95
 00 00 00 00 00 51 10 09 A8 59 5A 28 80 C2 2C A0
 45 70 C3 2B CA 06 E5 46 79 CC 04 45 70 CD 1B C6
 35 04 46 D7 04 46 C6 6F C0 46 DF DF DF DF DF DF
 DF DF DF D1 BF CB BF CA BF DF DF DF D8 BF D1 BF
 DF DF DF DF C8 6F DF CB BA CA BA 6F D7 05 53 51
 53 DF CE BE C4 B9 C5 64 BA C1 1B C5 1B C1 00
  Encoded length:  95 bytes
  Wall pattern: 01, Wall color: 00     Floor pattern: 05, Floor color: 01
  Flags: 
 02 02 02 02 02 02 02 02 02 02 02 02 02 02 02 02 02 02 02 02 02 02 02 02 02 02 02 02 02 02 02 02 02
 02 40 00 00 00 44 02 09 09 09 09 09 09 02 26 00 00 00 00 43 00 00 00 00 00 02 00 00 00 00 00 06 02
 02 00 00 00 00 00 02 09 09 09 09 09 09 02 00 00 00 00 00 00 00 00 00 00 26 02 00 00 00 00 00 00 02
 02 00 00 00 00 00 04 09 09 09 09 09 09 02 26 00 00 00 00 00 00 00 00 00 00 02 00 00 00 27 00 00 02
 02 00 00 00 00 53 04 09 09 09 09 09 09 02 00 00 00 00 00 00 00 00 00 00 00 02 00 00 00 00 00 00 02
 02 00 00 00 00 00 04 09 09 09 09 09 09 02 00 00 00 00 00 02 00 40 00 00 00 02 00 00 00 00 00 00 02
 02 00 00 00 00 00 02 09 09 09 09 09 09 02 00 00 00 00 00 02 00 00 00 00 00 02 00 00 00 00 00 00 02
 02 00 00 00 00 00 02 00 00 00 00 00 00 02 00 00 00 00 00 02 00 00 00 00 00 02 00 00 00 00 00 00 02
 02 00 00 00 00 00 02 00 00 00 00 00 00 02 00 00 00 00 00 02 00 00 00 00 00 02 00 00 00 00 00 00 02
 02 00 00 00 00 00 02 00 00 00 00 00 00 02 00 00 00 00 00 02 00 00 00 00 00 02 00 00 00 00 00 00 02
 02 00 00 00 00 00 02 00 00 00 00 00 00 02 00 00 00 00 00 02 00 00 00 00 00 02 00 00 00 00 00 00 02
 02 00 00 00 00 00 02 00 00 00 00 00 00 02 00 00 00 00 00 02 00 00 00 00 00 02 00 00 00 00 00 00 02
 02 00 00 00 00 00 02 00 00 00 00 00 00 02 00 00 00 00 00 02 00 00 00 00 00 02 00 00 00 00 00 00 02
 02 00 00 00 00 00 02 00 00 00 00 00 00 02 00 00 00 00 00 02 00 00 00 00 00 02 00 00 00 00 00 00 02
 02 00 00 00 00 00 02 00 00 00 00 00 00 02 00 00 00 00 00 02 00 00 00 00 00 02 00 00 00 00 00 00 02
 02 00 00 00 00 00 02 00 00 00 00 00 00 02 00 00 00 00 00 02 00 00 00 00 00 02 00 00 00 00 00 00 02
 02 00 00 00 00 00 02 00 00 00 00 00 00 02 00 00 00 00 00 02 00 00 00 00 00 02 00 00 00 00 00 00 02
 02 00 00 00 00 00 02 00 00 00 00 00 00 02 00 00 00 00 00 02 00 00 00 00 00 02 00 00 00 00 00 00 02
 02 00 00 00 00 00 02 00 00 00 00 00 00 02 00 00 00 00 00 02 00 00 00 00 00 02 00 00 00 00 00 00 02
 02 00 00 00 00 00 02 00 00 00 00 00 00 02 00 00 00 00 00 02 00 00 00 00 00 02 00 00 00 00 00 00 02
 02 00 00 00 00 00 02 00 00 00 00 00 00 02 00 00 00 00 00 02 00 00 00 00 00 02 00 00 00 00 00 00 02
 02 00 00 00 00 00 02 00 00 00 00 00 00 02 00 00 00 00 00 02 00 00 00 00 00 02 00 00 00 00 00 00 02
 02 00 00 00 00 00 02 00 00 00 00 00 00 02 00 00 00 00 00 02 00 00 00 00 00 02 00 00 00 00 00 00 02
 02 00 00 00 00 00 02 00 00 00 00 00 00 02 00 00 00 00 00 02 00 00 00 00 00 02 00 00 00 00 00 00 02
 02 00 00 00 00 00 02 00 00 00 00 00 00 02 00 00 00 00 00 02 00 00 00 00 00 02 00 00 00 00 00 00 02
 02 00 00 00 00 00 02 00 00 00 00 00 00 02 00 00 40 00 00 02 00 00 00 00 00 02 00 00 00 00 00 00 02
 02 00 00 00 00 00 02 00 00 00 00 00 00 02 00 00 00 00 00 02 00 00 00 00 00 02 00 00 00 00 00 00 02
 02 00 00 00 00 00 02 00 00 00 00 00 00 02 00 00 00 00 00 02 00 00 00 00 00 02 40 00 00 00 00 00 02
 02 00 00 00 00 00 02 00 00 00 00 00 00 00 00 00 00 00 00 02 00 00 00 00 00 00 00 00 00 00 00 00 02
 02 00 00 05 00 00 02 00 25 00 00 25 00 00 00 00 25 00 00 02 00 00 00 00 00 00 00 00 00 00 00 00 02
 02 00 00 00 00 00 02 00 00 00 00 00 00 00 00 00 00 00 00 02 00 00 00 00 00 00 00 00 00 00 00 00 02
 02 00 00 00 00 00 02 00 00 00 00 00 00 40 00 00 00 00 00 02 00 00 27 00 00 00 00 00 00 27 00 00 02
 02 02 02 02 02 02 02 02 02 02 02 02 02 02 02 02 02 02 02 02 02 02 02 02 02 02 02 02 02 02 02 02 02
