Gauntlet (rev 1 - 9)
Maze number: 44
Offset for maze 43: 232318 - 0x038b7e
big endian buf: [%!l(uint8=0) %!l(uint8=3) %!l(uint8=139) %!l(uint8=126)]
G:1 Maze real addr: 240513 - 0x03AB81, bank 1, boff: 0x2000
Maze read from: 0x03ab81 - 240513
compresssed: 162
 00 00 00 00 00 51 60 0B A8 4A 75 35 80 43 C0 66
 04 D0 44 C8 04 C9 1D C0 06 C1 2B 45 C8 04 D0 44
 C9 AF A0 44 C9 4F 40 DF CE 47 1B 47 DF 5E 8F D4
 2A C0 2C C0 2A C5 6B 60 09 8E A8 03 80 A4 D0 6B
 6F D8 35 C9 1A E3 D6 BF C5 A1 DC A1 FD C3 B3 C0
 1A C1 6F 2A C1 63 A1 35 C2 BF A2 CD A3 B2 03 80
 A1 B2 A4 1A C0 04 CD 6F 04 FE 6F C9 1A AD D0 A1
 C1 04 52 E0 C0 42 D4 04 E2 50 E0 C0 B2 D8 0A E0
 50 C0 04 C6 1A C3 1A C5 05 E4 50 E0 75 D3 0A E0
 C0 42 D3 35 70 D8 B6 A3 B4 CC BE 6F C8 28 B4 60
 19 00
  Encoded length: 162 bytes
  Wall pattern: 01, Wall color: 00     Floor pattern: 05, Floor color: 06
  Flags: 
 02 02 02 02 02 02 02 02 02 02 02 02 02 02 02 02 02 02 02 02 02 02 02 02 02 02 02 02 02 02 02 02 02
 02 53 11 11 11 11 00 40 00 00 00 00 00 00 00 04 00 00 00 00 00 00 00 00 00 00 00 00 00 00 00 00 02
 02 11 11 11 11 11 00 00 00 00 00 00 00 00 00 04 00 00 00 00 00 00 00 00 00 00 29 00 06 00 00 43 02
 02 11 11 11 11 11 00 00 00 00 00 00 00 00 00 04 00 00 00 00 00 00 00 00 00 00 00 00 00 00 00 00 02
 02 11 11 11 11 11 00 00 00 00 00 00 00 00 00 02 02 02 02 02 02 02 02 02 02 02 02 02 02 02 02 02 02
 02 11 11 11 11 11 00 00 00 00 00 00 00 00 00 02 11 11 11 11 11 11 11 11 11 11 11 11 11 11 11 11 02
 02 00 00 00 00 00 00 00 00 00 00 00 00 00 00 02 00 00 00 00 00 00 00 00 00 00 00 00 00 00 00 00 02
 02 00 00 00 00 00 00 00 00 00 00 00 00 00 00 02 11 11 11 11 11 11 11 11 27 11 11 11 11 11 11 11 02
 02 00 00 00 00 00 00 00 00 00 00 00 00 00 00 02 00 00 00 00 00 00 00 00 00 00 00 00 00 00 00 00 02
 02 00 00 00 00 00 00 00 00 00 00 00 00 00 00 02 10 10 10 10 10 10 10 10 10 10 10 10 10 10 10 10 02
 02 00 00 00 00 00 00 00 00 00 00 00 00 00 00 02 00 00 00 00 00 00 42 00 44 00 42 00 00 00 00 00 02
 02 40 00 00 00 00 00 00 00 00 00 00 00 00 40 02 09 09 09 09 09 09 09 09 09 09 09 09 09 09 09 09 02
 02 02 02 02 02 02 02 02 02 03 03 02 02 02 02 02 00 00 00 00 00 00 00 00 00 00 00 00 00 00 00 00 02
 02 40 00 00 00 00 00 00 00 00 00 00 00 00 40 02 00 00 00 00 00 00 00 00 00 00 00 00 00 00 00 00 02
 02 00 00 00 00 00 00 00 00 00 00 00 00 00 00 02 00 00 00 00 00 00 00 00 53 00 00 00 00 00 00 00 02
 02 00 00 26 00 00 00 00 02 00 00 02 00 00 00 02 00 00 00 00 00 00 00 00 00 00 00 00 00 00 00 00 02
 02 00 00 00 00 00 00 02 02 00 00 02 00 00 00 02 00 00 00 00 00 00 00 00 00 00 00 00 00 00 00 00 02
 02 00 00 00 00 00 02 02 00 00 00 02 00 00 00 02 00 00 00 00 00 00 00 00 00 00 00 00 00 00 00 00 02
 02 00 00 00 00 02 02 00 00 00 02 02 00 26 00 02 40 00 00 00 00 00 00 00 00 00 00 00 00 00 00 00 02
 02 42 00 00 40 02 00 00 00 02 02 53 00 00 00 02 02 02 02 00 00 00 00 00 00 00 00 00 00 00 00 00 02
 02 02 02 02 02 02 03 03 02 02 02 02 02 02 02 02 26 00 04 00 00 00 00 00 00 00 00 00 00 00 00 00 02
 02 40 00 00 00 00 00 00 00 00 00 00 00 00 00 00 00 00 04 00 00 00 00 00 00 00 00 00 00 00 00 00 02
 02 00 00 00 00 00 00 00 00 00 00 00 00 00 00 00 00 00 02 40 00 00 00 00 00 00 00 00 00 00 00 00 02
 02 00 00 00 00 00 00 00 00 00 00 00 00 00 26 02 02 02 02 02 02 02 02 02 02 02 02 02 02 00 00 00 02
 02 00 00 00 00 00 00 00 00 00 00 00 00 02 02 02 00 00 04 00 00 00 10 00 02 00 11 11 02 00 00 00 02
 02 00 00 00 00 00 00 00 00 00 00 00 00 02 00 00 00 00 04 00 00 00 02 00 10 00 02 00 02 00 00 00 02
 02 00 00 00 00 00 00 00 00 00 00 00 00 02 00 00 00 00 02 00 00 00 10 00 02 00 10 00 04 00 00 00 02
 02 00 00 00 26 00 00 00 00 26 00 00 00 02 00 00 05 00 02 00 00 00 02 00 10 00 02 00 02 00 00 00 02
 02 53 00 00 00 00 00 00 00 00 00 00 00 02 00 00 00 00 02 00 00 00 10 00 02 00 11 11 02 00 00 00 02
 02 00 00 00 00 00 00 00 00 00 00 00 00 02 00 00 00 53 02 53 00 00 00 00 00 00 00 00 02 00 00 00 02
 02 00 00 00 00 00 00 00 00 00 00 00 00 02 02 02 02 02 02 00 00 00 00 00 00 00 00 00 02 00 00 00 02
 02 40 00 00 00 00 00 00 00 00 00 00 00 00 00 00 00 00 00 00 00 00 00 00 00 00 00 40 02 40 00 25 02
 02 02 02 02 02 02 02 02 02 02 02 02 02 02 02 02 02 02 02 02 02 02 02 02 02 02 02 02 02 02 02 02 02
