Gauntlet (rev 1 - 9)
Maze number: 23
Offset for maze 22: 235503 - 0x0397ef
big endian buf: [%!l(uint8=0) %!l(uint8=3) %!l(uint8=151) %!l(uint8=239)]
G:1 Maze real addr: 235506 - 0x0397F2, bank 0, boff: 0x0000
Maze read from: 0x0397f2 - 235506
compresssed: 199
 0B 2C 00 00 00 02 10 0B D4 75 44 06 80 A0 DA A3
 18 FB E2 03 AB C5 A1 79 C9 19 1B C5 A1 E4 D0 19
 C4 A1 E4 EF 42 C2 A1 C3 1E A0 EF 43 C1 A1 E4 5E
 A0 44 C6 1E A0 5E A0 EC EF EC C3 2A A0 E9 EC E4
 E9 F2 E9 F2 D2 03 80 BB A0 2A A6 D3 04 55 C7 A1
 BF C1 BB AA C0 05 C1 03 AA B2 E9 E2 51 7A CA B2
 C3 2A A2 B3 79 C2 A2 C3 B3 76 EB C2 A2 E2 F3 C3
 14 E3 F3 14 A0 E6 E4 C9 18 E0 E0 14 C0 14 A0 E4
 E4 5C A0 E2 E4 E4 EB 35 A0 C3 20 A0 E8 C4 B6 E7
 C0 06 E2 E8 E4 E7 E6 C1 14 E3 E4 E7 14 E5 E2 E2
 E4 E7 14 E7 C1 14 A0 24 A0 E4 2A C4 03 80 A0 E0
 14 A0 20 A0 E0 E4 14 A0 24 F0 E0 E0 E0 C0 A1 BE
 61 60 58 BB CC A1 00
  Encoded length: 199 bytes
  Wall pattern: 02, Wall color: 00     Floor pattern: 00, Floor color: 01
  Flags: 
 02 02 02 02 02 02 02 02 02 02 02 02 02 02 02 02 02 02 02 02 02 02 02 02 02 02 02 02 02 02 02 02 02
 02 06 02 00 00 00 00 00 00 00 00 00 00 00 00 00 00 00 00 00 00 00 00 00 00 00 00 00 00 00 02 02 02
 02 02 24 00 00 00 00 00 00 00 00 00 00 00 00 00 00 00 00 00 00 00 00 00 00 00 00 00 00 00 00 02 02
 02 00 00 02 03 02 02 02 02 02 02 02 02 02 02 02 02 00 00 00 00 00 00 02 02 00 00 00 00 00 00 00 02
 02 00 00 04 00 00 00 00 00 00 00 00 00 00 25 27 02 00 00 00 00 00 02 02 00 00 00 00 00 02 00 00 02
 02 00 00 02 00 00 00 00 00 00 00 00 00 00 00 25 02 00 00 00 00 02 02 00 00 00 00 00 02 00 00 00 02
 02 00 00 02 00 00 00 00 00 00 00 00 00 02 11 11 02 00 00 00 02 02 00 00 00 00 30 02 00 00 00 00 02
 02 00 00 02 00 00 00 00 00 00 00 00 02 11 11 11 02 00 00 02 02 00 00 00 00 00 02 00 00 00 00 00 02
 02 00 00 02 00 00 00 00 00 00 53 02 11 11 11 11 02 00 00 00 00 00 00 00 30 02 00 00 00 00 00 00 02
 02 00 00 02 00 00 00 00 00 53 02 00 00 00 00 00 02 00 00 00 00 00 00 00 02 00 00 00 00 00 00 00 02
 02 00 00 02 00 00 00 00 00 02 00 00 00 00 00 00 02 00 00 00 00 00 00 02 00 00 00 00 42 02 00 00 02
 02 00 00 02 00 00 00 00 02 00 00 00 00 00 00 00 02 00 00 00 00 00 02 00 00 00 00 00 02 00 00 00 02
 02 00 00 02 00 00 00 02 00 00 00 00 00 00 00 00 02 00 00 00 00 00 00 00 00 00 00 02 00 00 00 00 02
 02 00 00 02 00 00 02 00 00 00 00 00 00 00 00 00 02 00 00 00 00 00 00 00 00 00 02 00 00 00 00 00 02
 02 00 00 02 00 00 00 00 00 00 00 00 00 00 03 03 02 02 42 02 02 02 02 02 02 02 00 00 00 00 00 02 02
 02 00 00 02 00 00 00 00 00 00 00 00 00 00 04 00 00 00 02 00 00 53 00 00 00 00 00 00 00 00 02 02 02
 02 00 00 02 02 02 02 02 02 02 02 02 02 02 02 00 05 00 02 03 02 02 02 02 02 02 02 02 02 02 02 02 02
 02 00 00 00 00 00 00 00 02 02 02 00 00 00 02 00 00 53 02 00 00 00 00 00 00 00 00 00 00 04 00 00 02
 02 00 00 00 00 00 00 00 02 02 00 00 00 00 42 02 02 02 02 00 00 00 00 00 00 00 00 00 00 04 00 00 02
 02 02 02 02 00 00 00 00 02 00 00 00 00 00 02 00 04 00 00 00 00 00 00 00 00 00 00 00 00 02 00 00 02
 02 02 02 02 00 00 00 02 00 00 00 00 00 00 02 00 02 00 00 00 00 00 00 00 00 00 00 00 02 00 00 00 02
 02 20 00 00 00 00 02 00 00 00 00 00 00 00 02 00 02 00 00 00 00 00 00 00 00 00 00 02 20 02 00 00 02
 02 00 00 00 00 02 00 00 00 00 00 02 00 00 02 00 02 00 00 00 00 00 24 00 02 00 02 20 00 20 02 00 02
 02 00 00 00 02 00 00 00 00 00 02 00 00 00 02 00 02 00 00 00 00 00 00 00 53 02 00 00 00 02 00 00 02
 02 00 00 02 00 00 00 00 00 02 00 00 00 00 02 00 02 00 00 00 00 00 02 53 02 00 00 00 00 32 02 00 02
 02 00 00 00 00 00 00 00 02 00 00 00 00 00 02 00 02 00 00 00 00 00 00 02 00 06 00 00 00 02 00 00 02
 02 00 00 00 00 00 00 02 00 00 00 00 00 02 00 00 02 00 00 00 00 00 02 00 00 00 00 00 00 00 02 00 02
 02 20 00 00 00 00 02 00 00 00 00 00 02 00 00 00 02 00 00 00 00 02 20 00 00 00 00 00 00 02 00 00 02
 02 02 00 00 00 02 00 00 00 00 00 02 00 00 00 00 02 00 00 00 02 20 00 00 00 00 00 00 00 00 02 00 02
 02 20 02 36 02 00 00 00 00 00 02 42 00 00 00 00 02 03 03 02 00 02 20 02 32 02 00 02 00 00 00 00 02
 02 02 20 02 36 00 00 00 00 00 00 00 00 00 00 00 02 00 00 00 00 00 02 00 02 00 02 00 02 00 02 02 02
 02 02 02 20 02 20 00 00 00 00 00 00 00 00 00 53 02 00 00 00 00 00 00 00 00 00 00 00 00 00 02 02 02
 02 02 02 02 02 02 02 02 02 02 02 02 02 02 02 02 02 02 02 02 02 02 02 02 02 02 02 02 02 02 02 02 02
