Gauntlet (rev 1 - 9)
Maze number: 67
Offset for maze 66: 236365 - 0x039b4d
big endian buf: [%!l(uint8=0) %!l(uint8=3) %!l(uint8=155) %!l(uint8=77)]
G:1 Maze real addr: 244560 - 0x03BB50, bank 1, boff: 0x2000
Maze read from: 0x03bb50 - 244560
compresssed: 139
 00 00 00 00 02 00 75 68 59 6A 58 E4 28 80 C8 20
 2A 20 47 51 C1 05 E1 D8 21 E5 D7 21 E6 51 5A E1
 C6 A1 E4 19 ED 47 E0 E4 EC 48 E1 E4 EA 41 69 A0
 E4 19 F8 E4 44 F3 E4 D8 19 A0 E4 19 D0 2A E6 E4
 47 C7 20 E7 E4 CF 20 67 A0 E4 19 F8 E4 CC BF 42
 E7 E4 4F 67 A0 E4 19 F8 E4 F9 E4 47 6F A0 E4 19
 45 F1 E4 EF 47 A0 E4 5A E1 EA E4 19 EA 6B A0 E4
 E9 41 EB C4 A2 E5 F0 DE 19 A0 75 DF DF D8 B2 C5
 BE 2A 21 80 28 4D 80 75 C2 06 00
  Encoded length: 139 bytes
  Wall pattern: 00, Wall color: 05     Floor pattern: 00, Floor color: 07
  Flags: SHOTS_HURT 
  ╚══> while gauntlet has these elements, these flags probably do not operate
 02 02 02 02 02 02 02 02 02 02 02 02 02 02 02 02 02 02 02 02 02 02 02 02 02 02 02 02 02 02 02 02 02
 02 00 00 00 00 02 40 40 00 00 00 00 00 00 00 00 00 32 42 32 00 00 00 00 00 00 00 00 40 00 00 42 02
 02 00 05 00 00 02 00 00 00 00 00 00 00 00 00 00 00 00 00 00 00 00 00 00 00 00 00 00 00 00 00 33 02
 02 00 00 00 00 00 02 00 00 00 00 00 00 00 00 00 00 00 00 00 00 00 00 00 00 00 00 00 00 00 00 33 02
 02 00 00 00 00 00 00 02 00 00 42 00 00 00 00 00 00 00 00 00 00 00 42 00 00 02 00 00 00 00 00 00 02
 02 02 02 00 00 00 00 00 02 25 00 00 00 00 00 00 00 00 00 00 00 00 00 00 02 00 00 00 00 00 00 00 02
 02 40 00 02 00 00 00 00 00 02 00 00 00 00 00 00 00 00 00 00 00 00 00 02 00 00 00 00 00 00 00 00 02
 02 40 00 00 02 00 00 00 00 00 02 00 00 00 00 00 00 00 00 00 00 00 02 00 00 40 00 00 00 00 00 00 02
 02 00 00 00 25 02 00 00 00 00 00 02 25 00 00 00 00 00 00 00 00 00 00 00 00 00 00 00 00 00 00 00 02
 02 00 00 00 00 00 02 00 00 00 00 00 02 00 00 00 00 00 40 00 00 00 00 00 00 00 00 00 00 00 00 00 02
 02 00 00 00 00 00 00 02 00 00 00 00 00 02 00 00 00 00 00 00 00 00 00 00 00 00 00 00 00 00 00 00 02
 02 00 00 00 00 00 00 25 02 00 00 00 00 00 02 25 00 00 00 00 00 00 00 00 00 00 00 00 00 00 00 00 02
 02 42 00 00 00 00 00 00 00 02 00 00 00 00 00 02 00 00 00 00 00 00 00 00 40 00 00 00 00 00 00 00 02
 02 32 00 00 00 00 00 00 00 00 02 00 00 00 00 00 02 00 00 00 00 00 00 00 00 00 00 00 00 00 00 00 02
 02 32 00 00 00 00 00 00 00 00 25 02 00 00 00 00 00 02 25 00 00 00 00 00 00 00 00 00 00 00 00 00 02
 02 00 00 00 00 00 00 00 00 00 00 00 02 00 00 00 00 00 02 00 00 00 00 00 00 00 00 00 00 00 00 00 02
 02 00 00 00 40 00 00 00 00 00 00 00 00 02 00 00 00 00 00 02 00 00 00 00 00 00 00 00 00 00 00 00 02
 02 00 00 00 40 00 00 00 00 00 00 00 00 25 02 00 00 00 00 00 02 25 00 00 00 00 00 00 00 00 00 00 02
 02 00 00 00 00 00 00 00 00 00 00 00 00 00 00 02 00 00 00 00 00 02 00 00 00 00 00 00 00 00 00 00 02
 02 00 00 00 00 00 00 00 00 00 00 00 00 00 00 00 02 00 00 00 00 00 02 00 00 00 00 00 00 00 00 40 02
 02 00 00 00 00 00 00 00 00 00 00 00 00 00 00 00 25 02 00 00 00 00 00 02 25 00 00 00 00 00 00 40 02
 02 00 00 00 00 00 00 00 00 00 00 00 00 00 00 00 00 00 02 00 00 00 00 00 02 00 00 00 00 00 00 00 02
 02 00 00 00 00 00 00 00 00 02 00 00 00 00 00 00 00 00 40 02 00 00 00 00 00 02 00 00 00 00 00 00 02
 02 00 00 00 00 42 00 00 02 00 00 00 00 00 00 00 00 00 00 00 02 00 00 00 00 00 02 25 00 00 00 00 02
 02 00 00 00 00 00 00 02 00 00 00 00 00 00 00 00 00 00 00 00 25 02 00 00 00 00 00 02 00 00 00 00 02
 02 00 00 00 00 00 02 00 00 40 00 00 00 00 00 00 00 00 00 00 00 00 02 00 00 00 00 00 02 02 02 00 02
 02 00 00 00 00 02 00 00 00 00 00 00 00 00 00 00 00 00 00 00 00 00 00 02 00 00 00 00 00 00 00 00 02
 02 00 00 00 00 00 00 00 00 00 00 00 00 00 00 00 00 00 00 00 00 00 00 25 02 00 00 00 00 00 00 24 02
 02 00 00 00 00 00 00 00 00 00 00 00 00 00 00 00 00 00 00 00 00 00 00 00 00 02 00 00 00 00 00 00 02
 02 00 00 00 00 00 00 00 00 00 00 00 00 00 00 00 00 00 00 00 00 00 00 00 00 02 00 00 00 00 00 00 02
 02 00 00 00 00 00 00 00 00 00 00 00 00 00 00 00 00 00 00 00 00 00 00 00 00 02 00 00 00 00 00 00 02
 02 42 33 33 40 00 00 00 00 00 00 00 00 00 00 00 00 00 00 40 40 00 00 00 00 00 00 24 00 00 00 06 02
 02 02 02 02 02 02 02 02 02 02 02 02 02 02 02 02 02 02 02 02 02 02 02 02 02 02 02 02 02 02 02 02 02
