Gauntlet (rev 1 - 9)
Maze number: 83
Offset for maze 82: 230797 - 0x03858d
big endian buf: [%!l(uint8=0) %!l(uint8=3) %!l(uint8=133) %!l(uint8=141)]
G:1 Maze real addr: 247184 - 0x03C590, bank 2, boff: 0x4000
Maze read from: 0x03c590 - 247184
compresssed: 220
 00 00 00 00 00 11 51 0A A8 61 6A C7 62 2C 63 18
 6C 2A 52 5B A6 1A A3 C1 A7 2A 82 E1 E0 C0 28 A8
 21 C2 A7 C9 28 81 B2 B2 C0 B2 A0 C0 B2 E0 EF E0
 C0 28 80 B3 C6 A1 C7 B3 B3 73 C0 62 2A C2 A4 C9
 B4 D3 A5 56 C0 28 AC E0 C9 61 A3 B8 B7 B2 B2 B2
 B2 B2 B2 B2 B7 B2 A5 C6 B3 A3 1A C1 4A C2 1A A3
 CC 28 43 28 43 66 B2 CA 60 44 21 44 C0 64 21 C2
 1B A2 50 73 78 C3 20 CA A8 C3 A7 D3 2A 82 C8 B5
 C2 BF C1 A2 D5 1B C5 1E C0 A6 CA A6 C7 A5 CA 1B
 C4 B5 DE 21 E7 DB B3 C4 A2 1B A0 C6 B4 B4 CB 1B
 52 C7 05 E9 C0 B2 C7 A1 B2 E1 CE 2C A0 1E EB E0
 C0 BA A2 BA A5 B4 EC E4 C1 06 A0 2A F2 61 A0 C6
 28 A0 E2 61 A0 EA E3 E4 E4 F5 D2 B6 A2 1E A7 1B
 A9 1E A0 B5 DF C1 BE 6B 68 65 28 00
  Encoded length: 220 bytes
  Wall pattern: 01, Wall color: 01     Floor pattern: 01, Floor color: 05
  Flags: 
 02 02 02 02 02 02 02 02 02 02 02 02 02 02 02 02 02 02 02 02 02 02 02 02 02 02 02 02 02 02 02 02 02
 02 00 00 00 00 00 00 00 40 00 00 02 44 40 00 00 00 00 24 40 00 00 00 00 00 00 00 00 00 00 00 00 02
 02 42 00 00 00 33 00 00 00 00 00 02 02 00 00 00 00 00 33 02 02 02 02 02 02 02 26 02 02 02 02 00 02
 02 02 02 02 02 02 02 02 02 42 42 02 02 00 00 02 00 02 00 40 02 02 02 02 02 02 02 02 02 33 00 00 02
 02 02 02 02 02 02 02 02 02 00 00 02 02 00 00 00 00 00 00 40 02 02 02 02 00 02 02 00 02 00 02 00 02
 02 00 00 00 00 00 02 02 02 00 00 02 02 00 00 02 00 02 00 40 02 02 00 00 00 00 00 00 00 02 02 00 02
 02 00 00 00 00 00 02 02 02 00 00 02 02 42 00 40 00 00 00 42 02 00 00 02 02 02 02 02 00 00 00 00 02
 02 00 00 02 00 00 02 00 00 00 00 02 02 02 02 02 02 02 02 02 02 02 00 00 00 00 00 02 02 02 02 02 02
 02 00 00 02 00 00 00 00 33 00 40 02 02 02 02 02 02 02 02 02 02 02 02 02 00 02 00 00 00 00 00 00 02
 02 00 00 02 40 00 00 02 02 02 02 02 02 02 02 02 02 02 02 02 02 02 02 02 02 02 02 02 00 02 00 00 02
 02 00 00 02 02 02 02 02 26 00 00 10 10 10 10 10 10 10 10 10 10 10 00 00 00 26 02 02 02 02 00 00 02
 02 00 00 00 00 00 00 00 00 00 00 40 10 10 10 10 40 10 10 10 10 40 00 00 00 00 00 00 02 02 00 00 02
 02 00 00 00 00 00 00 00 00 40 00 10 10 10 10 10 33 10 10 10 10 10 00 40 00 00 00 00 02 33 00 00 02
 02 27 02 02 02 00 33 00 00 00 00 42 00 00 00 00 00 00 00 00 00 42 00 00 00 00 32 00 02 02 00 00 02
 02 00 00 00 00 00 02 02 02 02 02 02 02 02 02 00 00 00 02 02 02 02 02 02 02 02 02 00 02 02 00 00 02
 02 00 00 00 00 00 00 00 00 00 00 00 00 00 02 42 42 42 02 00 00 00 00 00 00 00 00 00 02 02 00 00 02
 02 00 00 02 02 02 00 00 00 00 00 00 00 00 02 00 00 00 02 00 00 00 00 00 00 00 00 00 27 02 00 00 02
 02 00 00 30 00 02 02 02 02 02 02 02 00 00 02 00 00 00 02 00 00 02 02 02 02 02 02 02 02 02 00 00 02
 02 00 00 02 00 00 02 02 02 02 02 02 00 00 02 00 00 00 02 00 00 02 02 27 00 00 00 00 00 02 00 00 02
 02 00 00 02 00 00 00 00 00 00 00 00 00 00 02 00 00 00 02 00 00 02 02 00 00 00 00 00 00 33 00 00 02
 02 00 00 02 00 00 02 00 00 00 00 00 00 00 02 00 00 00 02 00 00 02 02 00 00 02 00 00 00 02 00 00 02
 02 00 00 02 00 00 00 00 02 02 02 02 27 02 02 00 00 00 02 00 00 02 02 00 00 02 00 00 00 02 00 00 02
 02 00 00 27 00 00 00 33 02 00 00 00 00 00 02 00 05 00 02 00 00 00 00 00 00 02 00 02 00 02 00 00 02
 02 00 00 02 00 00 02 02 02 00 00 02 00 00 02 00 00 00 02 00 00 00 00 00 00 02 00 44 02 30 00 00 02
 02 00 00 02 00 00 00 00 00 00 02 00 02 00 02 02 02 02 02 02 02 02 02 02 02 02 00 00 00 02 00 00 02
 02 00 00 02 00 00 00 02 00 00 00 00 00 02 00 00 06 02 42 00 00 00 00 00 00 00 00 00 00 02 00 00 02
 02 00 00 02 00 00 02 40 00 00 02 00 00 00 00 00 00 00 40 02 00 00 00 02 40 00 00 02 00 02 00 00 02
 02 00 00 02 00 00 00 02 00 00 00 00 02 00 00 00 00 00 02 00 00 00 00 00 02 00 00 00 00 02 00 00 02
 02 00 00 02 00 00 00 00 00 00 00 00 00 00 00 02 00 00 00 00 00 00 00 00 00 00 00 00 00 02 00 00 02
 02 00 00 02 02 02 02 30 02 02 02 02 02 02 02 02 27 02 02 02 02 02 02 02 02 02 02 30 02 02 00 00 02
 02 00 00 00 00 00 00 00 00 00 00 00 00 00 00 00 00 00 00 00 00 00 00 00 00 00 00 00 00 00 00 00 02
 02 40 00 00 00 00 00 00 00 00 00 00 00 00 40 00 00 00 00 00 00 00 00 00 40 00 00 00 00 00 00 40 02
 02 02 02 02 02 02 02 02 02 02 02 02 02 02 02 02 02 02 02 02 02 02 02 02 02 02 02 02 02 02 02 02 02
