Gauntlet (rev 1 - 9)
Maze number: 111
Offset for maze 110: 235272 - 0x039708
big endian buf: [%!l(uint8=0) %!l(uint8=3) %!l(uint8=151) %!l(uint8=8)]
G:1 Maze real addr: 251659 - 0x03D70B, bank 2, boff: 0x4000
Maze read from: 0x03d70b - 251659
compresssed: 192
 00 00 00 00 00 40 66 A8 5E 6B 9D 35 80 2A CE 2A
 1E CC 77 1A 2A D7 AF A9 C5 7F C6 19 CD 44 1B DA
 AE C7 75 1A C0 42 44 1A C1 1B DA 35 A0 B2 68 D2
 A1 CB 76 B4 C8 4F C8 2A 1A C3 28 7F CC B3 A1 C6
 73 71 2B A9 C4 A2 2C C0 1A C5 BB A4 C3 06 C1 47
 A7 CB 42 B2 A2 C3 04 2B 43 BF C8 05 E1 C4 40 1B
 E2 C8 A5 C3 06 C0 43 B2 A7 C7 70 2C A4 C0 B2 A3
 C0 04 1C C1 41 1E CE 1A C0 41 04 C0 A3 D5 B7 A3
 62 A1 C3 2C D7 2A C0 A2 C0 A1 B4 C3 4F DF 61 DF
 DF 6B 61 61 2A 60 61 61 C0 40 1E 61 C0 2A 1E 61
 C2 AF AF 2B C2 49 47 2B 54 C1 2C 50 52 CC 2C C4
 49 2C 52 51 51 52 53 C4 BE 47 48 46 2C C1 28 00
  Encoded length: 192 bytes
  Wall pattern: 00, Wall color: 06     Floor pattern: 04, Floor color: 06
  Flags: 
 02 02 02 02 02 02 02 02 02 02 02 02 02 02 02 02 02 02 02 02 02 02 02 02 02 02 02 02 02 02 02 02 02
 02 53 42 00 00 00 00 00 00 00 00 00 00 00 00 00 00 00 42 30 00 00 00 00 00 00 00 00 00 00 00 00 02
 02 29 00 00 00 00 00 00 00 00 26 42 00 00 00 00 00 00 00 00 00 00 00 00 00 00 00 00 00 00 00 00 02
 02 00 00 02 02 02 02 02 02 02 02 02 02 02 02 02 02 02 02 02 02 02 02 02 02 02 02 02 02 02 00 00 02
 02 00 00 02 29 00 00 00 00 00 00 00 00 00 00 00 00 00 00 00 00 00 00 00 00 00 00 00 25 00 00 00 02
 02 00 00 02 00 00 00 00 00 00 00 40 00 00 00 00 00 27 00 00 00 00 00 00 00 00 00 00 00 00 00 00 02
 02 00 00 02 00 00 00 00 00 00 00 00 02 02 02 02 02 02 02 02 02 02 02 02 02 02 02 02 00 00 00 00 02
 02 00 00 02 29 00 00 00 00 00 00 26 02 40 00 00 00 40 00 00 00 00 00 26 02 00 27 00 00 00 00 00 02
 02 00 00 02 00 00 00 00 00 00 00 00 02 00 00 00 00 00 00 00 00 00 53 02 02 00 00 00 00 00 00 00 02
 02 00 30 02 00 00 00 00 00 00 00 00 02 00 00 00 00 00 00 00 00 02 02 02 00 00 00 00 00 00 00 00 02
 02 00 00 02 29 00 00 00 00 00 00 00 02 00 00 00 00 00 00 00 00 02 40 00 00 00 00 00 00 00 00 00 02
 02 00 00 02 00 00 00 00 00 00 00 00 00 00 00 00 42 26 00 00 00 02 40 29 00 00 00 00 00 00 00 00 02
 02 00 00 02 00 00 00 00 00 00 00 00 00 00 00 00 00 00 00 00 00 02 02 02 00 00 00 00 00 00 00 29 02
 02 00 00 02 29 00 00 43 02 02 02 02 02 02 02 02 02 02 00 00 00 00 00 02 02 02 44 00 26 00 00 00 02
 02 00 00 02 02 02 02 02 02 00 00 00 02 06 00 00 40 02 00 00 00 00 00 00 00 02 02 02 02 02 02 02 02
 02 00 00 00 00 00 00 00 00 00 00 00 02 40 00 00 00 02 02 02 02 00 00 00 00 04 43 40 00 00 00 00 02
 02 00 00 00 00 00 00 00 00 00 05 00 02 02 02 00 00 00 00 40 02 27 00 00 00 02 00 00 00 00 00 00 02
 02 00 00 02 02 02 02 02 02 00 00 00 02 06 02 40 00 00 00 00 02 02 02 02 02 02 02 02 02 00 00 00 02
 02 00 00 00 00 29 00 44 02 02 02 02 02 00 02 02 02 02 02 00 04 28 00 00 40 00 00 30 02 00 00 00 02
 02 00 00 00 00 00 00 00 00 00 00 26 02 40 00 00 04 00 02 02 02 02 00 00 00 00 00 00 02 00 00 00 02
 02 00 00 00 00 00 00 00 00 00 00 00 02 02 02 02 02 00 00 00 30 02 02 00 00 00 00 44 02 00 00 00 02
 02 00 00 00 00 00 00 00 00 00 00 00 00 00 00 00 00 00 00 00 42 00 02 02 02 00 02 02 02 00 00 00 02
 02 40 00 00 00 00 00 00 00 00 00 00 00 00 00 00 00 00 00 00 00 00 00 00 00 00 00 00 00 00 00 00 02
 02 00 00 00 00 00 00 00 00 00 00 00 00 00 00 00 00 00 00 00 30 00 00 00 00 00 00 00 00 00 00 00 02
 02 00 00 00 00 00 00 00 00 00 00 00 00 00 00 00 00 00 00 00 00 00 00 00 00 00 00 00 00 00 00 00 02
 02 00 00 00 00 00 00 00 00 00 00 00 00 00 00 00 00 00 00 00 00 00 00 00 00 00 00 00 00 00 00 00 02
 02 30 00 00 30 00 00 30 42 00 30 00 00 30 00 00 30 00 40 00 30 00 00 30 00 42 30 00 00 30 00 00 02
 02 02 02 02 02 02 02 02 02 02 02 02 02 02 02 02 02 02 02 02 02 02 02 02 02 02 02 02 02 02 02 02 02
 02 43 00 00 00 40 00 00 00 00 00 00 00 00 00 00 40 00 00 00 00 00 00 00 00 43 00 00 00 00 00 43 02
 02 00 44 00 43 00 00 00 43 00 00 00 00 00 00 00 00 00 00 00 00 00 44 00 00 00 00 00 40 00 00 00 02
 02 00 00 00 00 00 00 44 00 00 00 43 00 00 43 00 00 43 00 00 00 43 00 00 00 00 43 00 00 00 00 00 02
 02 40 00 00 00 00 00 00 00 00 40 00 00 00 00 00 00 00 00 00 40 00 00 00 00 00 00 00 44 00 00 40 02
 02 02 02 02 02 02 02 02 02 02 02 02 02 02 02 02 02 02 02 02 02 02 02 02 02 02 02 02 02 02 02 02 02
