Gauntlet (rev 1 - 9)
Maze number: 96
Offset for maze 95: 233145 - 0x038eb9
big endian buf: [%!l(uint8=0) %!l(uint8=3) %!l(uint8=142) %!l(uint8=185)]
G:1 Maze real addr: 257724 - 0x03EEBC, bank 3, boff: 0x6000
Maze read from: 0x03eebc - 257724
compresssed: 242
 08 14 0C 00 82 43 FD 7B 4E 39 04 1E 80 61 C8 13
 35 13 CA 06 A1 1E A2 60 C9 28 CB A1 C2 06 A1 0E
 C7 52 39 81 52 C8 A1 C5 A1 E8 3A A0 C8 A1 C7 A1
 E7 38 A0 C7 A1 C9 A1 D0 A1 CB A1 46 C6 A1 CD AF
 A0 D1 1C C8 1C D3 B2 A0 43 E3 B2 D2 1C A1 C6 A1
 1C CA 39 83 C4 A1 03 83 A1 CC 20 C1 11 C9 35 CC
 39 82 C2 11 52 D3 A2 C3 35 2E C0 3A 38 40 41 C3
 05 43 41 C1 38 3A C1 2D 18 BF C2 11 D4 A2 C6 11
 C6 74 C1 35 C1 74 C8 54 39 81 C0 20 E9 03 83 A1
 CC 39 82 53 C4 A1 C5 A1 1C D2 1C A1 42 E3 D3 A1
 1E C7 1E F3 B2 A9 B2 BE A0 EE BF 45 C6 A1 CC A1
 C6 3A C7 A1 CA A1 D1 A1 65 81 A1 E7 38 A0 C8 A1
 C6 A1 2A D3 2A A1 C3 1E A1 C8 39 51 C0 51 39 C9
 A1 C2 A1 CA 10 35 10 6A A1 06 A1 CA 14 09 81 14
 69 C0 A1 BE 06 C9 53 14 2A 14 2A 14 53 68 C0 1E
 A0 00
  Encoded length: 242 bytes
  Wall pattern: 03, Wall color: 13     Floor pattern: 04, Floor color: 15
  Flags: PLAYER_OFFSCREEN SHOTS_HURT 
  ╚══> while gauntlet has these elements, these flags probably do not operate
 02 02 02 02 02 02 02 02 02 02 02 02 02 02 02 02 02 02 02 02 02 02 02 02 02 02 02 02 02 02 02 02 02
 02 30 00 00 14 00 00 00 00 00 00 00 00 57 19 53 19 57 00 00 00 00 00 00 00 00 00 00 06 02 02 30 02
 02 02 02 00 14 00 00 00 00 00 00 00 00 57 00 40 00 57 00 00 00 00 00 00 00 00 00 00 02 02 00 00 02
 02 06 02 02 14 00 00 00 00 00 00 00 00 57 57 57 57 57 00 00 00 00 00 00 00 00 00 02 02 00 00 00 02
 02 00 00 02 02 00 00 00 00 00 00 00 00 00 02 58 02 00 00 00 00 00 00 00 00 00 02 02 00 00 00 00 02
 02 00 00 00 02 02 00 00 00 00 00 00 00 00 02 56 02 00 00 00 00 00 00 00 00 02 02 00 00 00 00 00 02
 02 00 00 00 00 02 02 00 00 00 00 00 00 00 00 00 00 00 00 00 00 00 00 00 02 02 00 00 00 00 00 00 02
 02 00 00 00 00 00 02 02 00 00 00 00 00 00 00 59 00 00 00 00 00 00 00 02 02 00 00 00 00 00 00 00 02
 02 00 00 00 00 00 00 02 02 02 02 02 02 02 02 02 02 02 02 02 02 02 02 02 00 00 00 00 00 00 00 00 02
 02 00 00 00 00 00 00 00 02 02 28 00 00 00 00 00 00 00 00 00 28 02 02 00 00 00 00 00 00 00 00 00 02
 02 00 00 00 00 00 00 00 02 02 02 00 00 00 00 59 00 00 00 00 02 02 02 00 00 00 00 00 00 00 00 00 02
 02 00 00 00 00 00 00 00 02 28 02 02 00 00 00 00 00 00 00 02 02 28 02 00 00 00 00 00 00 00 00 00 02
 02 57 57 57 57 57 00 00 02 00 00 02 02 03 03 03 03 03 02 02 00 00 02 00 00 00 00 00 00 00 00 00 02
 02 32 00 00 17 57 00 00 02 00 00 00 04 00 00 53 00 00 04 00 00 00 02 00 00 00 00 00 57 57 57 57 02
 02 00 00 00 17 57 00 00 02 00 00 00 04 00 00 00 00 00 04 00 00 00 02 00 00 00 02 02 57 00 00 00 02
 02 53 46 00 58 56 00 59 02 00 59 00 04 00 00 05 00 00 04 00 59 00 02 59 00 00 56 58 57 00 45 24 02
 02 00 00 00 17 57 00 00 02 00 00 00 04 00 00 00 00 00 04 00 00 00 02 00 00 00 02 02 57 00 00 00 02
 02 00 00 00 17 57 00 00 02 00 00 00 04 00 00 53 00 00 04 00 00 00 02 00 00 00 00 00 57 57 57 57 02
 02 32 00 00 00 57 00 00 02 00 00 00 02 03 03 03 03 03 02 02 00 00 02 00 00 00 00 00 00 00 00 00 02
 02 57 57 57 57 57 00 00 02 00 00 02 02 00 00 00 00 00 00 02 02 28 02 00 00 00 00 00 00 00 00 00 02
 02 00 00 00 00 00 00 00 02 28 02 02 00 00 00 59 00 00 00 00 02 02 02 00 00 00 00 00 00 00 00 00 02
 02 00 00 00 00 00 00 00 02 02 02 30 00 00 00 00 00 00 00 00 30 02 02 00 00 00 00 00 00 00 00 00 02
 02 00 00 00 00 00 00 00 02 02 02 02 02 02 02 02 02 02 02 02 02 02 02 02 00 00 00 00 00 00 00 00 02
 02 00 00 00 00 00 00 02 02 00 00 00 00 00 00 59 00 00 00 00 00 00 00 02 02 00 00 00 00 00 00 00 02
 02 00 00 00 00 00 02 02 00 00 00 00 00 00 00 58 00 00 00 00 00 00 00 00 02 02 00 00 00 00 00 00 02
 02 00 00 00 00 02 02 00 00 00 00 00 00 00 00 00 00 00 00 00 00 00 00 00 00 02 02 00 00 00 00 00 02
 02 14 14 14 02 02 00 00 00 00 00 00 00 00 02 56 02 00 00 00 00 00 00 00 00 00 02 02 00 00 00 00 02
 02 00 00 02 02 42 00 00 00 00 00 00 00 00 57 00 57 00 00 00 00 00 00 00 00 00 42 02 02 00 00 00 02
 02 30 02 02 00 00 00 00 00 00 00 00 57 57 57 00 57 57 57 00 00 00 00 00 00 00 00 00 02 02 00 00 02
 02 02 02 00 00 00 00 00 00 00 00 00 57 00 16 53 16 00 57 00 00 00 00 00 00 00 00 00 14 02 02 06 02
 02 02 00 00 00 00 00 00 00 00 00 00 57 20 09 09 09 20 57 00 00 00 00 00 00 00 00 00 14 00 02 02 02
 02 06 00 00 00 00 00 00 00 00 00 00 57 20 42 20 42 20 57 00 00 00 00 00 00 00 00 00 14 00 30 02 02
 02 02 02 02 02 02 02 02 02 02 02 02 02 02 02 02 02 02 02 02 02 02 02 02 02 02 02 02 02 02 02 02 02
