Gauntlet (rev 1 - 9)
Maze number: 25
Offset for maze 24: 235941 - 0x0399a5
big endian buf: [%!l(uint8=0) %!l(uint8=3) %!l(uint8=153) %!l(uint8=165)]
G:1 Maze real addr: 235944 - 0x0399A8, bank 0, boff: 0x0000
Maze read from: 0x0399a8 - 235944
compresssed: 325
 17 3B 0C 1F 80 74 6D 49 5A 04 A8 06 80 C0 2A C1
 2A 60 41 C2 A1 71 09 61 C2 71 06 67 41 E2 35 1A
 A0 42 61 C7 2A 63 41 E2 0B 82 A0 71 09 61 6A 41
 E2 0A 84 A0 42 61 C2 74 1A 41 E2 09 86 A0 71 09
 61 C4 2A 60 C2 03 81 A0 E9 03 82 61 64 41 D3 09
 61 62 41 D5 09 61 43 C1 53 C2 A4 03 80 A5 C1 53
 41 44 E2 C2 35 C9 35 E2 71 09 42 E2 C5 19 C5 19
 E5 42 E4 09 C7 A3 47 A0 75 A0 0A 09 C7 04 C1 04
 47 0A A0 E4 0B 0A 09 C2 B5 C2 03 A0 E1 03 C2 B5
 42 0A 0B A0 28 A2 1A 0B 0A 09 C9 05 48 0A 0B 35
 A1 BF A0 35 0B 0A 09 C2 51 C4 35 C5 51 42 0A 0B
 1A A0 BF 28 80 A0 0B 0A 09 C5 B3 03 A0 E1 03 B3
 45 0A 0B A0 E4 0A 09 C7 04 C1 04 47 0A A0 C5 28
 A0 09 C7 A3 47 A0 44 E2 C5 19 C5 19 E5 42 42 E2
 C2 35 C9 35 E2 42 44 C4 B5 A4 03 80 A4 B5 44 63
 41 D5 09 61 62 41 52 D2 09 61 C2 70 1A C1 03 82
 A0 E9 03 81 53 61 C0 2A 64 41 E2 09 86 A0 42 61
 68 41 E2 0A 84 A0 42 61 6A 41 C1 28 A0 0B 82 A0
 42 61 C3 2A C1 74 1A 41 E2 1A 35 A0 42 61 C7 06
 72 70 1A 41 C1 28 A1 42 61 C0 2A C1 2A C0 06 80
 BE AF AD BE 00
  Encoded length: 325 bytes
  Wall pattern: 04, Wall color: 13     Floor pattern: 07, Floor color: 06
  Flags: PLAYER_OFFSCREEN 
  ╚══> while gauntlet has these elements, these flags probably do not operate
 02 02 02 02 02 02 02 02 02 02 02 02 02 02 02 02 02 02 02 02 02 02 02 02 02 02 02 02 02 02 02 02 02
 02 06 00 42 00 00 42 00 26 00 00 09 00 00 00 02 02 40 00 00 09 00 00 26 00 00 00 40 00 00 06 02 02
 02 00 00 00 00 00 00 26 00 00 09 00 00 00 02 53 26 02 00 00 00 09 00 00 26 00 00 00 00 00 00 02 02
 02 42 00 00 00 00 26 00 00 09 00 00 00 02 11 11 11 11 02 40 00 00 09 00 00 26 00 00 00 00 00 02 02
 02 00 00 00 00 26 00 00 09 00 00 00 02 10 10 10 10 10 10 02 00 00 00 09 00 00 26 00 00 00 40 02 02
 02 00 00 00 26 00 00 09 00 00 00 02 09 09 09 09 09 09 09 09 02 40 00 00 09 00 00 26 00 00 00 02 02
 02 42 00 26 00 00 04 03 03 03 02 00 00 00 00 00 00 00 00 00 00 02 03 03 03 04 00 00 26 00 00 02 02
 02 00 26 00 00 09 04 00 00 00 00 00 00 00 00 00 00 00 00 00 00 00 00 00 00 04 09 00 00 26 00 02 02
 02 26 00 00 09 00 04 00 00 00 00 00 00 00 00 00 00 00 00 00 00 00 00 00 00 04 00 09 00 00 26 02 02
 02 00 00 09 00 00 04 00 00 02 02 02 02 02 02 03 03 02 02 02 02 02 02 00 00 04 00 00 09 00 00 02 02
 02 00 09 00 00 00 02 00 00 02 53 00 00 00 00 00 00 00 00 00 00 53 02 00 00 02 40 00 00 09 00 02 02
 02 09 00 00 00 02 00 00 00 02 00 00 25 00 00 00 00 00 00 25 00 00 02 00 00 00 02 00 00 00 09 02 02
 02 00 00 00 02 09 00 00 00 02 00 00 00 00 02 02 02 02 00 00 00 00 02 00 00 00 09 02 40 00 00 02 02
 02 00 00 02 10 09 00 00 00 02 00 00 00 00 04 00 00 04 00 00 00 00 02 00 00 00 09 10 02 00 00 02 02
 02 00 02 11 10 09 00 00 00 02 00 00 02 03 02 00 00 02 03 02 00 00 02 00 00 00 09 10 11 02 40 02 02
 02 02 26 11 10 09 00 00 00 04 00 00 02 00 00 00 05 00 00 02 00 00 04 00 00 00 09 10 11 53 02 02 02
 02 02 53 11 10 09 00 00 00 04 00 00 02 00 00 53 00 00 00 02 00 00 04 00 00 00 09 10 11 26 02 02 02
 02 40 02 11 10 09 00 00 00 02 00 00 02 03 02 00 00 02 03 02 00 00 02 00 00 00 09 10 11 02 00 02 02
 02 00 00 02 10 09 00 00 00 02 00 00 00 00 04 00 00 04 00 00 00 00 02 00 00 00 09 10 02 00 00 02 02
 02 00 00 40 02 09 00 00 00 02 00 00 00 00 02 02 02 02 00 00 00 00 02 00 00 00 09 02 00 00 00 02 02
 02 09 00 00 00 02 00 00 00 02 00 00 25 00 00 00 00 00 00 25 00 00 02 00 00 00 02 00 00 00 09 02 02
 02 00 09 00 00 00 02 00 00 02 53 00 00 00 00 00 00 00 00 00 00 53 02 00 00 02 00 00 00 09 00 02 02
 02 00 00 09 00 00 04 00 00 02 02 02 02 02 02 03 03 02 02 02 02 02 02 00 00 04 00 00 09 00 00 02 02
 02 26 00 00 09 00 04 00 00 00 00 00 00 00 00 00 00 00 00 00 00 00 00 00 00 04 00 09 00 00 26 02 02
 02 00 26 00 00 09 04 00 00 00 00 00 00 00 00 00 00 00 00 00 00 00 00 00 00 04 09 00 00 26 00 02 02
 02 40 00 26 00 00 03 03 03 03 02 00 00 00 00 00 00 00 00 00 00 02 03 03 03 04 00 00 26 00 42 02 02
 02 00 00 00 26 00 00 09 00 00 00 02 09 09 09 09 09 09 09 09 02 00 00 00 09 00 00 26 00 00 00 02 02
 02 00 00 00 00 26 00 00 09 00 00 00 02 10 10 10 10 10 10 02 00 00 00 09 00 00 26 00 00 00 00 02 02
 02 00 00 00 00 00 26 00 00 09 00 00 40 02 11 11 11 11 02 00 00 00 09 00 00 26 00 00 00 00 42 02 02
 02 40 00 00 00 00 00 26 00 00 09 00 00 00 02 26 53 02 00 00 00 09 00 00 26 00 00 00 00 00 00 02 02
 02 06 40 00 00 00 40 00 26 00 00 09 00 00 40 02 02 00 00 00 09 00 00 26 00 42 00 00 42 00 06 02 02
 02 02 02 02 02 02 02 02 02 02 02 02 02 02 02 02 02 02 02 02 02 02 02 02 02 02 02 02 02 02 02 02 02
 02 02 02 02 02 02 02 02 02 02 02 02 02 02 02 02 02 02 02 02 02 02 02 02 02 02 02 02 02 02 02 02 02
