Gauntlet (rev 1 - 9)
Maze number: 43
Offset for maze 42: 232067 - 0x038a83
big endian buf: [%!l(uint8=0) %!l(uint8=3) %!l(uint8=138) %!l(uint8=131)]
G:1 Maze real addr: 240262 - 0x03AA86, bank 1, boff: 0x2000
Maze read from: 0x03aa86 - 240262
compresssed: 248
 17 3B 0C 1F 02 30 15 03 68 04 9B 28 80 DF C7 45
 35 45 60 86 C0 19 CD 35 D1 B2 C1 A1 C2 71 2C 52
 35 51 C1 70 28 CE 19 C2 A5 40 A6 EA 65 CA 35 CD
 A4 CD 1C C0 1C C0 1C C0 1C C1 19 DE 28 C4 1A D8
 A3 C5 1A C8 1A C1 A5 42 C1 75 28 60 66 60 69 65
 A3 B4 A0 42 A0 B3 A3 C2 1D C4 A2 C0 A4 28 6A C5
 B3 62 C1 35 C2 2C DA 35 C0 7F C8 BF 1A C1 35 CA
 05 CD 2A C3 35 C2 1B BF C0 19 C8 19 C0 BF C0 B4
 A6 28 C0 54 C0 54 E2 C1 35 C6 35 C4 1D C5 42 C0
 43 A3 B4 A4 B4 A3 C8 35 C7 35 C2 2A C3 1C 61 A6
 C2 4A 6B 67 C7 1E B3 CA B4 C2 1E 64 C1 1E C2 35
 D7 35 C5 43 C1 1D 61 CA B4 49 77 28 C1 B3 6B C2
 18 C1 77 28 6E C1 51 C2 43 CA 1D C8 43 35 2A C0
 71 55 C1 1D CC A4 C2 43 D0 B4 C6 1E C7 1D C4 B8
 67 C3 1D C0 BE 06 C1 51 28 80 5A 35 60 B2 35 60
 C2 1C C0 B3 28 C8 2A 00
  Encoded length: 248 bytes
  Wall pattern: 00, Wall color: 05     Floor pattern: 03, Floor color: 01
  Flags: SHOTS_HURT 
  ╚══> while gauntlet has these elements, these flags probably do not operate
 02 02 02 02 02 02 02 02 02 02 02 02 02 02 02 02 02 02 02 02 02 02 02 02 02 02 02 02 02 02 02 02 02
 02 40 00 00 00 00 00 00 00 00 00 00 00 00 00 00 00 00 00 00 00 00 00 00 00 00 00 00 00 00 00 00 02
 02 00 00 02 00 00 00 00 00 02 03 03 03 03 03 04 53 03 03 03 03 03 03 02 40 40 40 40 40 40 40 40 02
 02 25 00 02 00 00 00 00 00 02 00 00 00 00 00 04 53 04 00 00 00 00 00 02 00 00 00 00 00 00 00 00 02
 02 00 00 02 00 00 02 02 00 02 00 27 00 00 44 04 53 04 00 00 27 00 40 02 00 00 00 00 00 00 00 00 02
 02 00 00 00 00 00 25 00 00 02 02 02 02 02 02 02 03 02 02 02 02 02 02 02 00 00 00 00 00 00 00 00 02
 02 00 00 02 00 00 00 00 00 02 40 00 00 00 00 00 00 00 00 00 00 00 53 02 00 00 00 00 00 00 00 00 02
 02 00 00 00 00 02 02 02 02 02 00 00 00 00 00 00 00 00 00 00 00 00 00 02 28 00 28 00 28 00 28 00 02
 02 25 00 00 00 00 00 00 00 02 00 00 00 02 00 00 00 00 00 00 00 00 00 02 00 00 00 00 00 00 00 00 02
 02 40 00 00 00 00 00 26 00 02 00 00 00 02 00 00 00 00 00 02 00 00 00 02 00 00 00 00 00 00 00 00 02
 02 02 02 02 02 00 00 00 00 02 00 26 00 02 00 00 00 00 00 02 00 26 00 02 02 02 02 02 02 02 03 03 02
 02 00 00 27 00 00 00 00 00 02 40 00 40 02 00 00 00 00 00 02 40 00 40 02 00 00 00 00 00 02 00 00 02
 02 40 00 00 00 00 00 00 40 02 02 02 02 02 02 03 03 03 02 02 02 02 02 02 00 00 00 29 00 02 00 00 02
 02 02 02 02 00 02 02 02 02 02 40 00 00 00 00 00 00 00 00 00 00 00 40 02 00 02 00 00 00 02 00 00 02
 02 40 00 04 53 04 00 00 44 02 00 00 00 00 00 00 00 00 00 00 00 00 00 02 00 02 00 00 00 00 00 00 02
 02 00 00 04 53 04 27 00 00 02 00 00 00 02 00 00 00 00 00 02 00 00 00 02 00 02 00 00 00 00 00 00 02
 02 26 00 04 53 04 00 00 00 02 00 00 00 02 00 00 05 00 00 02 00 00 00 02 00 02 00 00 00 00 00 42 02
 02 00 00 04 53 04 00 00 27 02 00 25 00 02 00 00 00 00 00 02 00 25 00 02 00 02 02 02 02 02 02 02 02
 02 40 00 04 00 04 00 00 00 02 00 00 53 02 00 00 00 00 00 02 53 00 00 02 00 00 29 00 00 00 00 00 02
 02 03 03 03 00 03 03 03 03 02 02 02 02 02 02 02 02 02 02 02 02 02 02 02 00 00 00 00 00 00 00 00 02
 02 53 00 00 00 00 00 00 00 00 53 02 00 00 42 00 00 00 00 28 00 00 40 02 02 02 02 02 02 02 00 00 02
 02 03 03 03 03 03 03 04 03 03 03 02 00 00 00 00 00 00 00 00 00 00 00 02 40 00 00 00 00 02 00 00 02
 02 40 00 00 00 00 00 04 00 00 30 02 00 00 00 00 02 00 00 00 02 00 00 02 00 00 00 30 00 02 00 00 02
 02 40 00 00 30 00 00 04 53 00 00 04 00 00 00 00 02 00 00 00 02 00 00 00 00 00 00 00 00 02 00 00 02
 02 53 00 00 00 00 00 04 03 03 03 04 00 00 29 00 02 40 00 00 02 00 00 00 00 00 00 00 00 02 03 03 02
 02 03 03 03 03 03 03 04 27 00 00 04 00 00 00 00 02 40 00 00 02 00 00 00 00 02 00 00 00 00 00 00 02
 02 40 00 00 04 24 00 04 27 00 00 04 00 00 00 00 02 40 00 00 00 00 00 00 00 02 00 00 00 00 00 00 02
 02 40 00 00 04 00 00 04 03 03 03 04 00 00 00 00 02 00 00 00 00 00 00 29 00 02 00 00 00 00 00 00 02
 02 03 03 03 03 53 42 04 27 00 00 04 00 00 29 00 02 00 00 00 02 00 00 00 00 02 00 00 02 02 02 02 02
 02 00 00 00 03 03 03 04 00 00 00 02 00 00 00 00 02 00 00 00 02 00 00 00 00 02 00 00 00 00 00 00 02
 02 30 00 00 04 00 00 04 00 00 29 02 00 00 00 00 02 00 00 00 02 00 00 00 00 40 00 00 00 00 29 00 02
 02 06 00 00 04 40 40 04 53 00 40 02 53 00 40 00 00 00 28 00 02 40 00 00 00 00 00 00 00 00 00 42 02
 02 02 02 02 02 02 02 02 02 02 02 02 02 02 02 02 02 02 02 02 02 02 02 02 02 02 02 02 02 02 02 02 02
