Gauntlet (rev 1 - 9)
Maze number: 50
Offset for maze 49: 234055 - 0x039247
big endian buf: [%!l(uint8=0) %!l(uint8=3) %!l(uint8=146) %!l(uint8=71)]
G:1 Maze real addr: 242250 - 0x03B24A, bank 1, boff: 0x2000
Maze read from: 0x03b24a - 242250
compresssed: 161
 00 00 00 00 00 40 15 5D 5A 28 AA 2C 80 CD 04 CD
 72 05 64 43 E4 C3 06 41 F6 D9 35 43 D3 7F D2 1A
 4B E0 CD B6 C6 B4 6E C1 70 1A C1 04 ED C0 1E CC
 35 04 C5 35 40 CB AA 41 CA 28 82 55 DF C2 A6 DF
 C1 B3 A3 BB 03 84 BC A6 03 44 C3 0E 88 0B 85 62
 CA 0E 41 C0 0E 83 0B 83 60 C4 BF CF 0E 81 0B 83
 DF 44 45 C5 7F CA B7 AF A2 B6 E0 C8 7F CB 2C C6
 19 4E 44 6E D2 1D CF 1B DF CA 77 19 CB 71 1B D3
 1A D6 B8 CC 1B 4A C4 04 C3 7F D3 1A BA C6 1B CE
 19 C6 04 C9 BE 76 35 B2 C4 BA 35 E2 C1 1B C5 35
 00
  Encoded length: 161 bytes
  Wall pattern: 00, Wall color: 05     Floor pattern: 04, Floor color: 01
  Flags: 
 02 02 02 02 02 02 02 02 02 02 02 02 02 02 02 02 02 02 02 02 02 02 02 02 02 02 02 02 02 02 02 02 02
 02 44 00 00 00 00 00 00 00 00 00 02 00 00 00 00 04 00 00 00 00 00 00 02 00 00 00 00 00 00 00 42 02
 02 00 00 05 00 00 00 00 00 26 00 02 00 00 29 00 02 00 00 00 02 00 00 02 00 06 00 00 29 00 00 00 02
 02 00 00 00 00 00 00 00 00 00 00 02 00 00 00 00 02 00 00 02 02 00 00 02 00 00 00 00 00 00 00 00 02
 02 00 00 00 00 00 00 00 00 00 00 02 00 00 00 53 02 00 00 02 29 00 00 02 00 00 00 00 00 00 00 00 02
 02 00 00 00 00 00 00 00 00 42 00 02 00 00 00 00 02 00 00 02 00 00 00 02 00 00 00 00 00 00 40 00 02
 02 00 00 00 00 00 00 00 00 00 00 02 00 26 00 00 02 00 00 02 00 00 00 02 00 00 29 00 02 00 40 00 02
 02 00 00 00 00 00 00 00 00 00 00 02 00 00 00 00 02 00 00 02 00 00 00 02 00 00 00 00 00 00 40 00 02
 02 00 00 26 00 00 42 00 26 00 00 04 00 00 00 00 02 00 00 00 00 00 00 02 00 00 02 00 30 00 40 00 02
 02 00 00 00 00 00 00 00 00 00 53 04 00 00 00 00 02 00 53 00 29 00 00 02 00 00 00 00 00 00 40 00 02
 02 02 02 02 02 02 02 02 02 02 02 02 00 00 29 00 02 00 00 00 00 00 00 02 00 00 40 40 40 40 40 00 02
 02 00 00 00 00 00 00 00 00 00 00 02 00 00 00 00 02 00 00 00 00 00 00 02 00 00 00 00 00 00 00 00 02
 02 00 02 02 02 02 02 02 02 00 00 02 00 00 00 00 02 00 00 00 00 00 00 02 00 00 00 00 00 00 00 00 02
 02 00 00 00 00 00 00 00 02 00 00 02 02 02 02 02 02 03 03 03 03 03 03 02 02 02 02 02 02 02 02 03 02
 02 00 00 00 00 29 00 00 02 00 14 14 14 14 14 14 14 14 14 14 11 11 11 11 11 11 11 00 02 00 26 00 02
 02 00 00 00 00 00 00 00 02 00 14 00 00 29 00 14 14 14 14 14 11 11 11 11 11 00 26 00 02 00 00 00 02
 02 00 00 00 00 00 00 00 02 00 00 00 00 00 00 00 00 14 14 14 11 11 11 11 11 00 00 00 02 00 00 00 02
 02 00 00 00 00 00 00 00 02 00 00 00 00 00 00 00 00 00 00 00 00 00 00 00 00 00 00 00 02 00 29 00 02
 02 00 00 00 00 29 00 00 02 00 00 00 42 00 00 00 00 00 00 00 00 00 00 00 00 00 00 00 02 00 00 00 02
 02 00 00 00 00 00 00 00 02 02 02 02 02 02 02 02 02 02 02 02 02 02 02 02 02 02 02 02 02 00 02 00 02
 02 00 00 00 00 00 00 00 42 00 02 00 00 00 00 00 00 00 00 00 00 02 00 00 00 00 00 00 00 00 00 00 02
 02 00 00 00 00 44 00 00 00 00 02 00 00 25 00 00 02 00 00 00 00 02 00 00 00 00 00 00 00 29 00 00 02
 02 00 00 29 00 00 00 00 00 00 02 00 00 00 00 00 02 00 00 26 00 02 00 00 00 00 00 00 00 00 00 00 02
 02 00 00 00 00 00 00 29 00 00 02 00 00 00 00 00 02 00 00 00 00 02 00 00 27 00 00 00 00 00 00 00 02
 02 00 00 00 00 00 00 00 00 00 02 00 00 00 00 00 02 00 00 00 00 02 00 00 00 00 00 00 00 00 00 00 02
 02 00 00 00 42 00 00 00 00 00 02 00 00 25 00 00 02 00 00 00 00 02 00 00 00 00 42 00 00 27 00 00 02
 02 00 00 00 00 00 00 00 00 00 02 00 00 00 00 00 02 00 26 00 00 02 00 00 00 00 00 00 00 00 00 00 02
 02 00 00 00 00 00 00 00 00 00 02 00 00 00 00 00 02 00 00 00 00 02 00 00 27 00 00 00 00 00 00 00 02
 02 00 00 00 29 00 00 00 00 00 04 00 00 00 00 42 02 00 00 00 00 02 00 00 00 00 00 00 00 00 00 00 02
 02 00 00 00 00 00 00 00 00 00 02 00 00 00 00 00 02 00 00 00 26 02 00 00 00 00 00 00 00 27 00 00 02
 02 00 00 00 00 00 00 00 00 00 02 00 00 25 00 00 02 00 00 00 00 04 00 00 00 00 00 00 00 00 00 00 02
 02 42 00 00 00 00 00 00 00 53 02 00 00 00 00 00 02 53 00 00 00 02 00 00 27 00 00 00 00 00 00 53 02
 02 02 02 02 02 02 02 02 02 02 02 02 02 02 02 02 02 02 02 02 02 02 02 02 02 02 02 02 02 02 02 02 02
