Gauntlet (rev 1 - 9)
Maze number: 35
Offset for maze 34: 236738 - 0x039cc2
big endian buf: [%!l(uint8=0) %!l(uint8=3) %!l(uint8=156) %!l(uint8=194)]
G:1 Maze real addr: 253125 - 0x03DCC5, bank 2, boff: 0x4000
Maze read from: 0x03dcc5 - 253125
compresssed: 395
 0E 23 02 01 88 34 19 78 5A 5E 5D 19 40 28 A0 1A
 C1 28 A0 C2 3A A0 28 52 38 06 A0 1A 60 A0 28 C0
 06 A0 E1 E0 40 E0 38 A0 38 A0 E0 E4 2A A1 41 2A
 A0 42 A0 51 E1 70 81 E0 E0 E2 E0 E4 2A E4 E2 E0
 E2 60 40 E0 42 42 E0 50 E0 2C E0 E0 70 E0 40 E4
 E4 28 A0 E2 E0 1B E2 E4 E4 E0 50 E2 C1 1C E1 E3
 40 E2 E0 E2 E2 E2 E0 C1 28 A0 40 E1 E2 40 E2 40
 44 E0 42 E0 50 C0 A1 71 E1 E4 61 80 E2 72 E0 E5
 71 A0 E0 C0 19 40 E0 E4 40 E2 E0 42 E1 40 E2 E0
 C0 1C E0 E2 C0 1C E0 E0 50 E0 E0 E3 E4 E4 E0 E4
 2B E3 50 41 E0 61 38 E0 C3 28 A0 E4 E0 E2 40 E1
 61 A0 E0 E2 E2 E0 E2 C2 39 40 C2 A1 E4 63 A0 40
 42 E0 1A E3 E5 28 E1 E0 E4 C1 05 E1 06 E3 E0 C0
 1B E0 E1 40 60 E0 1A 80 E0 40 E2 E0 C1 1B A0 E2
 E0 60 E1 44 E0 E2 40 E2 E0 E4 43 E0 61 E1 E4 C3
 1C A0 61 41 E0 E1 E2 E2 E0 C0 1C E0 E0 42 E0 E2
 42 A0 62 E0 E0 42 E0 E2 E0 42 E0 E5 E4 E4 62 E0
 62 E0 62 E0 E1 E2 40 70 E0 40 E2 E0 E2 E0 E2 43
 E0 E2 E0 60 E0 40 E2 E0 42 E0 61 E2 E4 E4 C2 1B
 E0 61 E1 28 E4 E0 70 40 28 A0 E2 40 E2 E0 E2 E0
 E3 E2 E0 42 E0 E2 E0 E2 2B A0 C1 28 A0 41 62 E0
 E4 E4 06 C0 1B E1 61 C1 A1 E4 28 A0 E2 40 50 E0
 06 A0 E2 40 64 38 C0 A1 38 61 A0 1A A0 E2 E0 60
 E0 C0 39 E2 E0 E0 C0 28 A0 3A 38 C3 28 A0 2B 1A
 80 C1 39 E4 28 61 E0 2C 38 C0 00
  Encoded length: 395 bytes
  Wall pattern: 04, Wall color: 09     Floor pattern: 03, Floor color: 01
  Flags: PLAYER_OFFSCREEN 
  ╚══> while gauntlet has these elements, these flags probably do not operate
 02 02 02 02 02 02 02 02 02 02 02 02 02 02 02 02 02 02 02 02 02 02 02 02 02 02 02 02 02 02 02 02
 25 00 56 40 02 26 00 00 40 02 00 00 00 58 02 40 00 00 00 30 56 06 02 26 00 26 02 40 00 06 02 00
 00 02 00 02 00 56 00 02 56 02 56 02 00 02 00 00 00 00 00 02 42 02 02 00 00 56 42 02 00 00 00 56
 02 00 00 30 00 00 02 00 29 29 29 00 02 00 02 00 00 00 02 00 02 00 00 00 00 00 02 42 00 00 00 00
 00 02 00 00 00 02 00 02 00 00 00 02 00 26 00 56 00 02 00 00 00 56 00 00 00 56 00 02 00 30 00 02
 44 00 02 00 02 00 29 00 02 00 56 00 00 00 00 00 02 00 00 00 00 00 02 40 02 00 00 00 02 00 02 27
 00 00 00 02 00 00 00 00 00 02 00 00 00 00 00 02 00 02 00 30 00 00 00 02 00 00 28 00 00 02 00 00
 00 00 02 00 56 00 00 00 02 00 02 00 00 00 02 00 00 00 02 00 00 00 02 00 02 00 00 40 02 00 56 00
 00 02 00 00 00 02 00 56 00 00 00 02 00 56 00 00 00 00 00 56 00 02 00 00 00 56 00 02 00 30 00 02
 02 00 00 29 00 00 02 00 00 00 00 00 02 00 00 26 26 00 00 00 02 00 00 00 29 00 02 00 00 00 00 00
 00 02 00 00 29 02 00 02 00 25 00 56 00 02 00 00 00 00 00 02 00 56 00 00 00 02 00 02 00 00 00 56
 00 00 02 00 56 00 00 00 02 00 02 00 28 00 02 00 00 00 02 00 28 00 02 00 02 00 30 00 02 00 02 00
 00 00 00 02 00 00 00 00 00 02 00 00 00 00 00 02 00 02 00 00 00 00 00 02 43 00 00 00 00 02 00 30
 00 00 56 00 02 00 00 26 56 00 02 00 00 00 00 40 02 00 00 00 00 00 02 00 02 00 00 00 02 00 56 00
 00 02 00 00 26 02 00 02 00 00 00 02 00 00 00 02 00 02 00 00 00 02 00 00 00 57 00 56 00 00 00 02
 02 00 00 00 00 00 02 00 00 00 00 26 02 00 56 00 00 00 56 00 02 26 00 00 00 00 02 00 00 00 00 00
 00 02 40 00 00 02 00 02 00 00 00 00 00 02 00 00 05 00 00 02 06 00 00 00 00 02 00 02 00 27 00 02
 00 00 02 00 56 00 26 00 02 26 26 00 02 00 56 00 00 00 02 00 02 00 00 27 02 00 00 00 02 00 02 00
 26 00 00 02 00 00 00 00 00 56 00 02 00 00 00 02 00 56 00 00 00 02 00 02 00 00 00 00 00 02 00 00
 00 00 56 00 02 00 00 26 00 00 02 00 00 00 00 00 02 00 00 00 00 28 02 00 00 26 00 00 56 00 02 00
 00 02 00 00 00 02 00 00 00 02 00 02 00 28 00 02 00 02 00 00 00 56 00 02 00 00 00 02 00 00 00 56
 02 00 00 00 26 00 02 00 02 00 00 00 56 00 02 00 00 00 02 00 02 00 00 00 56 00 02 00 00 00 00 00
 00 02 00 00 00 00 00 02 00 00 00 00 00 02 00 00 00 26 00 02 00 00 00 26 00 02 00 00 00 26 00 02
 00 00 02 00 00 00 02 00 56 00 29 00 02 00 56 00 00 00 02 00 02 00 00 00 02 00 02 00 00 00 02 00
 00 00 00 56 00 02 00 00 00 02 00 02 00 26 00 02 00 56 00 00 00 02 00 02 00 00 00 56 00 02 00 00
 26 00 00 00 02 00 00 00 00 00 02 00 00 00 00 00 02 00 00 00 27 00 02 00 00 26 00 00 02 40 00 00
 00 00 00 02 00 02 00 29 00 56 40 02 00 00 00 02 00 56 00 00 00 02 00 02 00 00 00 02 00 02 00 00
 00 00 02 00 00 00 02 00 02 00 00 00 56 00 02 00 00 00 02 00 02 00 00 00 02 43 02 00 00 40 02 00
 00 56 00 00 00 26 00 02 00 00 00 00 00 02 00 00 00 00 00 02 06 00 27 00 00 02 00 00 26 00 00 02
 02 00 00 00 00 00 02 40 02 00 00 00 02 00 56 00 30 00 02 06 02 00 00 00 02 00 56 00 00 00 00 00
 26 56 00 02 02 56 00 00 26 02 26 02 00 00 00 02 00 02 00 26 00 02 00 57 00 00 00 02 00 02 00 02
 00 40 02 58 56 00 00 00 00 40 02 43 26 26 00 00 57 00 00 00 00 00 02 40 00 00 26 00 02 44 56 00
 02 02 02 02 02 02 02 02 02 02 02 02 02 02 02 02 02 02 02 02 02 02 02 02 02 02 02 02 02 02 02 02
