Gauntlet (rev 1 - 9)
Maze number: 10
Offset for maze 9: 231326 - 0x03879e
big endian buf: [%!l(uint8=0) %!l(uint8=3) %!l(uint8=135) %!l(uint8=158)]
G:1 Maze real addr: 231329 - 0x0387A1, bank 0, boff: 0x0000
Maze read from: 0x0387a1 - 231329
compresssed: 379
 08 14 07 1B 00 20 45 5B 75 17 8B 64 40 A0 1B 81
 64 C1 21 80 C1 13 A0 2B 1B 80 A0 1E 81 C1 21 A0
 46 80 A7 21 E0 35 C8 A6 41 A0 E7 21 C1 A4 72 21
 C7 03 A0 C1 A1 E0 E1 C3 17 C1 0E 7C 04 A0 2B E1
 1B A0 C8 0E 72 A0 E2 C4 04 18 A1 C2 1E 60 C1 B3
 52 0E 82 7C 04 C0 05 C6 B2 C1 A3 0E 78 0B 80 C0
 06 04 C8 04 03 04 C9 A2 C1 03 A3 B2 C7 04 18 04
 C3 03 A0 C8 2A C0 B9 C5 03 C1 B4 C0 03 81 C8 21
 6B C1 B5 11 80 A0 EB C1 28 AA E1 11 80 A0 C3 58
 4B 80 04 C0 2A C0 12 81 E2 11 80 A2 B8 11 43 C0
 28 C3 BB C4 B2 A1 B7 35 E2 60 C1 28 11 BB 17 51
 0B 81 C2 13 69 A0 C8 28 C2 BF 71 35 BB A0 28 A8
 1A C0 A9 28 C0 17 C0 72 28 80 A0 C2 B3 C2 1A 1B
 A0 E6 C6 0B BF E1 C4 04 C4 2A A0 E1 C7 B3 41 E3
 C2 A2 C4 28 AA 2A C1 73 28 80 C0 27 81 44 A0 C0
 11 80 A0 C0 04 C1 04 18 40 A0 C1 B2 C2 A1 B5 C4
 B5 C0 B2 A0 C0 11 A0 C2 04 60 04 03 E1 C1 04 CE
 11 A0 C0 A4 43 E2 35 B5 A5 B4 A6 45 A1 E1 C1 A1
 E1 43 E2 C1 28 62 A0 E0 40 A0 C1 2A C5 28 42 A0
 1B E4 E2 E0 1B E0 C7 A5 03 A8 E0 E1 2C A0 11 A0
 E8 C0 13 E5 E3 E1 2D A0 E0 43 C1 B2 E0 E0 C0 B2
 C1 20 61 E2 E2 E7 E6 20 A1 1E A5 E2 C0 A6 C4 A1
 E0 E0 C0 B2 A0 C3 0C 80 E4 C4 BB C1 BE 20 A0 2A
 CA 0C 81 18 A0 E5 1E C0 04 C1 00
  Encoded length: 379 bytes
  Wall pattern: 00, Wall color: 05     Floor pattern: 02, Floor color: 04
  Flags: 
 02 02 02 02 02 02 02 02 02 02 02 02 02 02 02 02 02 02 02 02 02 02 02 02 02 02 02 02 02 02 02 02 02
 02 00 00 00 00 53 00 27 02 27 27 02 00 00 00 00 00 53 00 00 33 33 00 00 19 02 43 27 27 02 30 30 02
 02 00 00 33 02 00 00 00 00 00 00 02 27 27 02 02 02 02 02 02 02 02 33 00 02 53 00 00 00 00 00 00 02
 02 00 02 02 02 02 02 02 02 02 00 02 27 02 00 00 00 00 00 00 00 00 02 33 00 02 02 02 02 02 02 11 02
 02 00 02 33 00 00 00 00 02 00 00 02 03 02 00 00 02 02 00 02 00 00 02 00 00 02 23 23 23 02 14 11 02
 02 00 02 00 00 02 00 00 02 00 00 02 00 04 02 43 00 00 02 27 02 00 00 02 00 02 23 02 23 02 14 11 02
 02 00 02 02 00 02 00 02 02 00 00 02 00 04 24 02 02 00 00 02 30 02 53 02 00 02 23 02 23 02 14 11 02
 02 00 02 00 00 02 00 00 02 00 00 02 00 04 02 05 00 02 00 02 00 02 00 02 00 00 02 02 23 02 14 11 02
 02 00 02 00 00 02 00 00 02 11 11 02 06 04 02 00 00 02 00 02 00 02 00 04 03 04 00 02 23 02 00 00 02
 02 00 02 00 02 02 02 00 02 03 02 02 02 02 02 00 00 02 00 02 00 02 00 04 24 04 00 02 23 02 03 02 02
 02 00 02 00 00 02 00 00 02 42 00 02 00 00 00 00 00 02 03 02 00 02 00 03 03 03 00 02 23 02 00 00 02
 02 00 02 33 00 02 00 00 02 00 00 00 00 00 00 00 53 02 00 02 17 17 02 00 00 00 00 02 23 02 00 00 02
 02 00 02 02 00 02 40 02 02 02 02 02 02 02 02 02 02 02 00 00 02 17 17 02 00 00 00 02 23 02 00 00 02
 02 00 02 00 00 02 00 00 02 27 27 04 00 42 02 18 18 02 00 00 00 02 17 17 02 02 02 02 17 02 00 23 02
 02 27 02 40 00 02 00 00 02 00 00 02 00 00 02 02 02 02 53 00 00 00 02 00 53 00 00 40 17 02 23 23 02
 02 11 02 00 00 02 19 00 00 00 00 02 00 00 00 00 00 53 02 00 00 00 00 00 00 00 00 00 40 00 02 00 02
 02 11 02 00 53 02 02 40 02 02 02 02 02 02 02 02 02 26 00 02 02 02 02 02 02 02 02 02 02 40 02 23 02
 02 11 02 00 00 40 40 02 02 00 00 02 00 00 02 26 27 02 00 00 00 00 00 00 00 02 00 00 00 00 02 00 02
 02 11 02 00 02 02 00 00 02 00 00 04 00 00 02 00 00 42 02 00 00 02 00 00 00 00 00 00 00 00 02 00 02
 02 27 02 00 02 00 02 00 02 00 02 02 02 00 02 00 02 00 40 02 02 02 02 02 02 02 02 02 02 02 42 00 02
 02 11 02 00 02 00 40 40 02 39 39 02 00 00 02 00 02 27 02 00 17 17 02 00 04 00 00 04 24 02 27 02 02
 02 00 02 00 02 00 02 02 02 00 00 02 00 00 02 00 02 02 00 17 02 00 00 00 04 00 53 04 03 02 00 02 02
 02 00 04 00 02 00 00 00 00 00 00 02 00 00 00 00 00 00 17 02 00 02 02 02 02 02 00 00 00 02 27 00 02
 02 00 02 53 02 02 02 02 02 02 02 02 02 02 02 02 02 02 02 00 00 00 00 00 00 27 02 02 00 02 02 00 02
 02 02 02 00 00 02 00 00 00 00 27 00 00 00 02 00 00 40 00 00 00 53 02 00 02 00 27 02 00 02 42 00 02
 02 00 00 00 00 40 00 00 00 27 02 27 00 00 00 00 00 02 00 00 00 02 00 02 27 00 02 00 00 02 00 00 02
 02 00 02 02 02 02 02 02 02 03 02 02 02 02 02 02 02 02 02 00 02 00 00 02 44 02 17 02 00 02 00 00 02
 02 00 02 00 00 02 00 19 02 00 00 00 00 00 02 00 00 00 00 02 00 00 02 45 02 00 02 00 00 02 00 27 02
 02 00 02 00 02 00 02 00 02 00 02 32 00 00 53 00 00 00 02 00 00 00 02 00 00 00 00 00 00 02 00 02 02
 02 00 00 00 00 00 00 02 32 02 02 30 02 02 02 02 02 02 00 00 00 02 00 02 02 02 02 02 02 02 00 00 02
 02 00 00 02 02 00 02 00 02 00 02 02 00 00 00 00 12 12 00 00 00 00 00 02 00 00 00 00 00 02 00 00 02
 02 32 02 42 00 00 00 00 00 00 00 00 00 00 00 12 12 12 24 02 00 00 00 00 00 00 02 30 00 04 00 00 02
 02 02 02 02 02 02 02 02 02 02 02 02 02 02 02 02 02 02 02 02 02 02 02 02 02 02 02 02 02 02 02 02 02
