Gauntlet (rev 1 - 9)
Maze number: 99
Offset for maze 98: 234024 - 0x039228
big endian buf: [%!l(uint8=0) %!l(uint8=3) %!l(uint8=146) %!l(uint8=40)]
G:1 Maze real addr: 258603 - 0x03F22B, bank 3, boff: 0x6000
Maze read from: 0x03f22b - 258603
compresssed: 202
 0A 30 09 17 08 33 DB 0E A8 39 64 CA 18 2B 2D 2E
 28 18 04 38 C0 3A C0 35 7A 74 C4 2C 2A C0 04 38
 73 73 CD 03 85 38 CC A5 C4 38 87 C1 A9 E8 B4 39
 86 54 C1 35 CC 3B C3 3B DB 03 80 B2 AB B6 C9 A4
 B4 C1 04 CF 1E A5 C7 04 DE AF A1 CD 60 60 67 60
 6F C0 60 61 1E C2 21 C0 60 60 66 A1 C5 60 60 67
 60 28 18 C4 A1 C8 28 18 63 1B C2 60 60 6E 60 60
 67 60 28 18 C1 1B CC 60 61 27 72 C0 60 60 65 05
 C7 60 60 67 60 6F C0 28 18 67 60 60 66 A6 B9 A5
 38 AA C2 B6 A1 DF DF D8 BD C5 AF A6 C1 21 A5 C2
 0C 81 6F CB 0C 81 6E B2 C8 AF A3 71 A8 C1 0D 82
 6F CA 0D 82 6B B2 CB AF A0 C1 27 AB C0 44 66 35
 06 D0 41 18 41 67 06 B2 CE 00
  Encoded length: 202 bytes
  Wall pattern: 03, Wall color: 11     Floor pattern: 03, Floor color: 13
  Flags: 
 02 02 02 02 02 02 02 02 02 02 02 02 02 02 02 02 02 02 02 02 02 02 02 02 02 02 02 02 02 02 02 02
 00 00 00 00 00 00 00 00 00 00 02 24 43 45 46 40 24 04 56 57 58 02 53 00 00 00 00 00 00 00 00 00
 00 00 36 00 00 00 00 00 36 00 02 00 00 00 44 42 00 04 56 57 00 02 00 36 00 00 00 00 36 00 00 00
 00 00 00 00 00 00 00 00 00 00 02 03 03 03 03 03 03 03 56 57 00 02 00 00 00 00 00 00 00 00 00 00
 02 02 02 02 02 02 00 00 00 00 02 56 56 56 56 56 56 56 56 57 00 02 02 02 02 02 02 02 02 02 02 02
 00 00 00 00 00 02 00 00 02 02 02 57 57 57 57 57 57 57 57 57 00 02 53 00 00 00 00 00 00 00 00 00
 00 00 00 00 59 02 00 00 02 59 00 00 00 00 00 00 00 00 00 00 00 02 00 00 00 00 00 00 00 00 00 00
 00 00 00 00 00 02 03 03 02 02 02 02 02 02 02 02 02 02 02 02 02 02 00 00 00 00 00 00 00 00 00 00
 02 02 02 02 02 02 00 00 04 00 00 00 00 00 00 00 00 00 00 00 00 00 00 00 00 30 02 02 02 02 02 02
 00 00 00 00 00 00 00 00 04 00 00 00 00 00 00 00 00 00 00 00 00 00 00 00 00 02 00 00 00 00 00 00
 00 00 00 00 00 00 00 02 02 02 02 02 02 02 02 02 02 02 02 02 02 02 02 02 02 02 00 00 00 00 00 00
 00 00 00 00 00 00 00 02 40 00 40 00 40 00 00 00 00 00 00 00 00 40 00 40 00 02 00 00 00 00 00 00
 00 00 00 00 00 00 00 02 00 40 00 40 00 00 30 00 00 00 33 00 40 00 40 00 40 02 00 00 00 00 00 00
 02 02 00 00 00 00 00 02 40 00 40 00 40 00 00 00 00 00 00 00 00 40 00 40 24 02 00 00 00 02 02 02
 00 00 00 00 00 00 00 02 00 40 24 40 00 00 00 00 27 00 00 00 40 00 40 00 40 02 00 00 00 02 00 00
 00 00 00 00 00 00 00 02 40 00 40 00 40 00 00 00 00 00 00 00 00 40 00 40 24 02 00 27 00 02 00 00
 00 00 00 00 00 00 00 02 00 40 00 40 00 00 39 00 00 00 36 00 40 00 40 00 40 02 00 00 00 02 00 05
 00 00 00 00 00 00 00 02 40 00 40 00 40 00 00 00 00 00 00 00 00 40 00 40 00 02 00 00 00 02 00 00
 00 00 00 00 00 00 00 02 00 40 24 40 00 00 00 00 00 00 00 00 40 00 40 00 40 02 00 00 00 02 00 00
 02 02 02 02 02 02 02 02 02 02 02 02 02 02 56 02 02 02 02 02 02 02 02 02 02 02 00 00 00 02 02 02
 00 00 00 00 00 00 00 00 00 00 00 00 00 00 00 00 00 00 00 00 00 00 00 00 00 02 00 00 00 00 00 00
 00 00 00 00 00 00 00 00 00 00 00 00 00 00 00 00 00 00 00 00 00 00 00 00 00 02 00 00 00 00 00 00
 00 00 00 00 00 00 00 00 00 00 00 00 00 00 00 00 00 00 00 00 00 00 00 00 00 02 00 00 00 00 00 00
 02 02 02 02 02 02 02 02 02 02 02 02 02 02 02 02 02 02 02 02 02 02 02 00 00 33 02 02 02 02 02 02
 00 00 00 12 12 12 40 00 00 00 00 00 00 00 00 00 00 00 00 00 00 00 02 00 00 00 00 00 00 00 00 00
 00 00 00 12 12 12 40 00 00 00 00 00 00 00 00 00 00 00 00 00 00 00 02 00 00 00 00 00 00 00 00 00
 02 02 02 02 02 02 02 02 02 02 02 02 02 02 02 02 02 02 02 02 00 00 36 02 02 02 02 02 02 02 02 02
 00 00 13 13 13 13 40 00 00 00 00 00 00 00 00 00 00 00 00 02 00 00 00 00 00 00 00 00 00 00 00 00
 00 00 13 13 13 13 40 00 00 00 00 00 00 00 00 00 00 00 00 02 00 00 00 00 00 00 00 00 00 00 00 00
 02 02 02 02 02 02 02 02 02 02 02 02 02 02 02 02 02 00 00 39 02 02 02 02 02 02 02 02 02 02 02 02
 00 14 14 14 14 14 40 00 00 00 00 00 00 00 53 06 02 00 00 00 00 00 00 00 00 00 00 00 00 00 00 00
 00 14 14 24 14 14 40 00 00 00 00 00 00 00 00 06 02 00 00 00 00 00 00 00 00 00 00 00 00 00 00 00
 02 02 02 02 02 02 02 02 02 02 02 02 02 02 02 02 02 02 02 02 02 02 02 02 02 02 02 02 02 02 02 02
