Gauntlet (rev 1 - 9)
Maze number: 30
Offset for maze 29: 229376 - 0x038000
big endian buf: [%!l(uint8=0) %!l(uint8=3) %!l(uint8=128) %!l(uint8=0)]
G:1 Maze real addr: 237571 - 0x03A003, bank 1, boff: 0x2000
Maze read from: 0x03a003 - 237571
compresssed: 396
 07 0D 07 1A 00 84 97 11 0B 17 68 42 C4 21 C0 35
 70 CD 04 C2 26 C0 21 40 AF A3 C2 A1 28 C3 41 C4
 1E 72 C2 1D C0 0E 80 C1 1D A0 03 A0 2A C0 A1 C4
 AD 2B 18 0E C1 1D A0 E0 C2 1A C9 27 72 C0 04 35
 2C A5 C2 A2 60 70 61 AE 28 C2 04 42 C1 35 62 35
 C0 1A EA C7 41 20 C1 A2 B3 C1 60 E6 35 A0 E2 70
 35 C0 1C 43 E0 18 C4 03 E5 26 A0 26 A9 E2 44 C1
 60 E6 18 A0 71 C4 1C E2 42 20 35 C2 60 E4 C5 A5
 E2 C0 43 A0 C2 60 C5 A2 21 C0 1B ED C3 1A A1 C4
 42 A5 1B 76 A0 28 73 E1 C3 41 21 B5 CB B2 A0 E1
 C2 2A C1 13 A0 C2 41 A0 40 2B A5 E3 E2 28 C0 03
 BF A0 BA A6 21 40 A0 C3 05 77 A0 C1 B7 28 C0 18
 28 74 06 42 A1 C2 35 C2 03 B2 E1 73 C0 2A 75 81
 C2 A4 B7 0C C0 0E 80 E0 C3 A2 C7 1A C6 0C 81 1C
 BC 0E 80 A0 74 2A C2 1A C5 B3 A9 0E 80 A0 C5 1B
 81 C6 1A A0 1E 0E 81 65 1C A0 22 A2 C3 1B 81 C5
 1D A0 0E 81 03 86 0E A1 70 C4 1B 81 C4 20 A0 C3
 04 1B 84 04 35 0E E0 28 C4 62 22 C2 26 A0 C4 03
 86 A1 E1 2C C3 62 C2 A1 C9 26 E4 E1 C3 62 C1 A1
 27 AE C0 26 A0 C3 57 63 70 A2 27 C0 24 2A C0 21
 2A C0 1E 2A C0 1B 2A 70 A0 E1 C2 18 63 E0 28 C3
 18 14 C0 18 41 18 0E C0 18 60 70 80 A0 E1 C0 B9
 A0 BA 62 70 A0 52 52 51 14 81 43 0E 80 62 70 A0
 1B A0 E1 65 E2 28 A0 B4 A0 28 B4 A0 28 B4 A0 28
 B4 A0 28 B4 C2 1B A0 C6 BE 1B DD 00
  Encoded length: 396 bytes
  Wall pattern: 04, Wall color: 07     Floor pattern: 08, Floor color: 09
  Flags: 
 02 02 02 02 02 02 02 02 02 02 02 02 02 02 02 02 02 02 02 02 02 02 02 02 02 02 02 02 02 02 02 02 02
 02 17 17 00 00 00 00 00 33 00 53 00 40 00 00 00 00 00 00 00 00 00 00 00 00 00 00 04 00 00 00 38 02
 02 33 17 02 02 02 02 02 02 02 02 02 02 02 02 02 02 02 02 02 02 02 02 00 00 00 02 02 40 00 00 00 02
 02 17 17 00 00 00 00 00 30 00 00 00 40 00 00 00 29 00 14 14 00 00 29 02 03 02 42 00 02 02 00 00 02
 02 00 00 02 02 02 02 02 02 02 02 02 02 02 02 02 02 43 24 14 00 00 29 02 00 02 00 00 00 26 02 00 02
 02 00 00 00 00 00 00 00 39 00 00 00 40 00 04 53 44 02 02 02 02 02 02 00 00 00 02 02 02 11 02 40 02
 02 11 02 02 02 02 02 02 02 02 02 02 02 02 02 02 02 40 00 00 00 04 17 17 17 00 00 53 11 11 02 53 02
 02 26 02 00 00 00 00 00 00 00 00 00 00 02 00 00 00 00 00 00 00 02 17 17 32 00 00 02 02 02 02 00 02
 02 11 02 00 00 00 00 00 00 02 53 02 00 00 00 02 00 40 53 00 28 02 17 17 17 00 02 24 00 00 00 00 02
 02 03 02 00 00 00 00 00 02 38 02 38 02 02 02 02 02 02 02 02 02 02 00 00 00 02 17 17 17 17 02 00 02
 02 11 02 00 00 00 00 00 00 02 24 02 02 00 40 00 00 00 00 00 28 02 00 00 02 17 17 17 32 53 02 00 02
 02 11 02 00 00 00 00 02 00 00 00 00 02 00 02 02 02 02 02 02 00 02 00 02 00 17 17 17 17 02 02 00 02
 02 11 02 00 00 00 00 00 02 02 02 33 02 27 00 00 00 00 00 02 00 02 00 00 00 02 00 00 02 00 02 00 02
 02 26 02 02 00 00 00 00 00 17 17 17 02 02 02 02 02 02 27 02 00 02 00 00 00 02 40 02 40 00 02 00 02
 02 40 02 00 02 00 00 00 00 17 17 33 02 00 00 00 00 00 00 02 00 02 00 00 00 02 02 00 00 02 02 00 02
 02 42 02 00 19 02 00 00 00 17 17 02 17 43 02 02 02 02 02 02 00 02 00 02 02 00 00 00 02 40 02 03 02
 02 02 02 02 02 02 02 02 02 02 33 17 02 00 00 00 00 05 00 02 00 02 00 02 00 00 40 02 00 00 02 40 02
 02 24 40 00 00 00 00 00 40 06 02 17 17 02 02 00 00 00 53 02 00 02 03 02 00 00 02 00 00 00 00 40 02
 02 42 00 00 00 00 00 00 40 40 02 00 00 00 02 02 02 02 02 02 12 02 14 14 00 02 00 00 00 02 02 02 02
 02 00 00 00 00 00 00 00 00 26 02 00 00 00 00 00 00 12 12 12 28 02 14 14 02 00 00 02 23 02 40 42 02
 02 00 00 26 00 00 00 00 00 00 02 02 02 02 02 02 02 02 02 02 02 14 14 02 00 00 00 02 23 02 27 27 02
 02 00 00 00 00 00 00 00 26 02 30 14 14 14 11 11 11 11 11 11 28 02 34 02 02 02 00 02 23 02 27 27 02
 02 00 00 00 00 00 00 29 02 14 14 14 03 03 03 03 03 03 03 03 14 02 02 00 40 00 00 02 23 02 27 27 02
 02 00 00 00 00 00 32 02 00 00 00 00 04 27 27 27 27 27 27 04 53 14 00 02 40 00 00 02 23 02 11 11 02
 02 34 00 00 00 38 02 00 00 00 00 00 03 03 03 03 03 03 03 03 02 02 00 00 02 44 00 02 23 02 11 11 02
 02 00 00 00 02 02 00 00 00 00 00 00 00 00 00 00 38 00 00 00 00 00 02 00 00 02 00 02 23 02 11 11 02
 02 00 00 02 02 39 02 02 02 02 02 02 02 02 02 02 02 02 02 02 02 00 38 02 00 00 00 02 23 02 11 11 02
 02 00 40 02 23 23 39 02 36 42 02 33 42 02 30 42 02 27 42 02 40 02 00 00 02 00 00 02 24 02 11 11 02
 02 00 02 40 23 23 23 02 24 20 02 24 17 02 24 14 02 24 11 02 40 40 02 00 00 02 00 02 02 02 11 11 02
 02 00 40 02 23 23 23 02 20 20 02 17 17 02 14 14 02 11 11 02 40 02 27 02 00 00 02 11 11 11 11 11 02
 02 00 00 00 02 40 02 02 02 40 02 02 40 02 02 40 02 02 40 02 00 00 00 27 02 00 00 00 00 00 00 00 02
 02 27 00 00 00 00 00 00 00 00 00 00 00 00 00 00 00 00 00 00 00 00 00 00 00 00 00 00 00 00 00 00 02
 02 02 02 02 02 02 02 02 02 02 02 02 02 02 02 02 02 02 02 02 02 02 02 02 02 02 02 02 02 02 02 02 02
