Gauntlet (rev 1 - 9)
Maze number: 101
Offset for maze 100: 233185 - 0x038ee1
big endian buf: [%!l(uint8=0) %!l(uint8=3) %!l(uint8=142) %!l(uint8=225)]
G:1 Maze real addr: 249572 - 0x03CEE4, bank 2, boff: 0x4000
Maze read from: 0x03cee4 - 249572
compresssed: 164
 00 00 00 00 00 60 A7 68 50 60 5F 10 82 EA 1F A0
 68 40 C0 05 DA 10 48 E8 1F A0 28 67 C8 AF A4 4A
 D1 28 DF DF CE A1 1F AA D1 20 A2 06 04 75 D3 B2
 A0 B2 03 04 C6 B2 D2 28 E3 E1 52 F4 C1 21 71 C1
 B2 D5 20 C7 2B F5 57 D5 1F C1 B2 C5 B3 C9 BF 10
 82 C8 35 C1 B3 52 C5 BF C6 BF 5B C1 B2 64 C1 0F
 82 D2 20 D5 B3 C1 B2 C5 B2 C2 BF D6 B2 D6 2B C8
 2B D4 A3 41 A3 B3 D3 2B 20 A0 DB BE CF B4 10 81
 7A CB 1E 81 50 ED B2 AD B2 A0 D3 10 CD 0F 82 C0
 2B 41 67 4B C7 BB AF A6 BC 63 C9 0F D2 BE 10 C9
 0F D1 28 00
  Encoded length: 164 bytes
  Wall pattern: 00, Wall color: 07     Floor pattern: 06, Floor color: 10
  Flags: 
 02 02 02 02 02 02 02 02 02 02 02 02 02 02 02 02 02 02 02 02 02 02 02 02 02 02 02 02 02 02 02 02 02
 02 16 16 16 00 00 00 00 00 00 00 00 00 00 00 02 31 02 00 00 00 00 00 00 00 00 00 16 02 40 00 05 02
 02 00 00 00 02 00 00 00 00 00 00 00 00 00 00 00 00 00 00 00 00 00 00 00 00 00 00 16 02 00 00 00 02
 02 00 00 00 02 40 00 00 00 00 00 00 00 00 00 02 31 02 40 00 00 00 00 00 00 00 00 16 02 00 00 00 02
 02 00 00 00 02 02 02 02 02 02 02 02 02 02 02 02 02 02 02 02 02 02 02 02 02 02 00 00 02 00 00 00 02
 02 00 00 00 02 40 00 00 00 00 00 00 00 00 00 00 00 00 00 00 00 00 00 00 40 02 00 00 02 00 00 00 02
 02 00 00 00 02 00 00 00 00 00 00 00 00 00 00 00 00 00 00 00 00 00 00 00 00 02 00 00 02 00 00 00 02
 02 00 00 00 02 00 00 00 00 00 00 00 00 00 00 00 00 00 00 00 00 00 00 00 00 02 00 00 02 00 00 00 02
 02 00 00 00 02 00 00 00 02 02 31 02 02 02 02 02 02 02 02 02 02 02 00 00 00 02 00 00 02 00 00 00 02
 02 00 00 00 02 00 00 00 32 02 02 02 06 04 00 00 00 00 00 00 31 02 00 00 00 02 00 00 02 00 00 00 02
 02 00 00 00 02 00 00 00 02 02 02 02 03 04 00 00 00 00 00 00 02 02 00 00 00 02 00 00 02 00 00 00 02
 02 00 00 00 02 00 00 00 02 40 00 00 00 00 02 00 00 02 00 00 02 32 00 00 00 02 00 00 02 00 00 00 02
 02 00 00 00 02 00 00 00 02 00 00 02 00 00 33 00 00 31 00 00 02 02 00 00 00 02 00 00 02 00 00 00 02
 02 00 00 00 02 00 00 00 02 00 00 32 00 00 02 00 00 02 00 00 43 02 00 00 00 02 00 00 02 00 00 00 02
 02 00 00 00 02 00 00 00 02 00 00 02 00 00 02 00 00 02 00 00 32 02 00 00 00 02 00 00 02 00 00 00 02
 02 00 00 00 02 00 00 00 02 00 00 31 00 00 02 00 00 02 00 00 02 02 00 00 00 02 00 00 02 00 00 00 02
 02 16 16 16 02 00 00 00 02 00 00 02 00 00 53 00 00 02 00 00 02 32 00 00 00 02 00 00 02 00 00 00 02
 02 00 00 00 02 00 00 00 02 00 00 02 00 00 02 00 00 32 00 00 02 02 00 00 00 02 16 00 02 15 15 15 02
 02 00 00 00 02 00 00 00 02 00 00 02 00 00 02 00 00 02 00 00 32 02 00 00 00 02 00 00 02 00 00 00 02
 02 00 00 00 02 00 00 00 02 00 00 02 00 00 02 00 00 02 00 00 02 02 00 00 00 02 00 00 02 00 00 00 02
 02 00 00 00 02 00 00 00 02 00 00 00 00 00 00 00 00 02 00 00 02 00 00 00 00 02 00 00 02 00 00 00 02
 02 00 00 00 02 00 00 00 02 43 00 00 00 00 00 00 00 00 00 43 02 00 00 00 00 02 00 00 02 00 00 00 02
 02 00 00 00 02 00 00 00 02 02 02 02 02 00 00 40 02 02 02 02 02 00 00 00 00 02 00 00 02 00 00 00 02
 02 00 00 00 02 00 00 00 02 43 32 02 00 00 00 00 00 00 00 00 00 00 00 00 00 02 00 00 02 00 00 00 02
 02 00 00 00 02 00 00 00 02 02 00 00 00 00 00 00 00 00 00 00 00 00 00 00 02 02 16 16 02 00 00 00 02
 02 00 00 00 02 00 00 00 31 02 00 00 00 00 00 00 00 00 00 00 00 30 30 30 02 32 00 00 02 00 00 00 02
 02 00 00 00 02 00 00 00 02 02 02 02 02 02 02 02 02 02 02 02 02 02 02 02 02 02 00 00 02 00 00 00 02
 02 00 00 00 02 00 00 00 00 00 00 00 00 00 16 00 00 00 00 00 00 00 00 00 00 00 00 00 02 15 15 15 02
 02 00 43 00 02 40 00 00 00 00 00 00 00 00 16 00 00 00 00 00 00 00 00 00 00 00 00 40 02 00 00 00 02
 02 00 00 00 02 02 02 02 02 02 02 02 02 02 02 02 02 02 02 02 02 02 02 02 02 02 02 02 02 00 00 00 02
 02 16 00 00 00 00 00 00 00 00 00 00 15 00 00 00 00 00 00 00 00 00 00 00 00 00 00 00 00 00 00 00 02
 02 16 00 00 00 00 00 00 00 00 00 00 15 00 00 00 00 00 00 00 00 00 00 00 00 00 00 00 00 00 00 40 02
 02 02 02 02 02 02 02 02 02 02 02 02 02 02 02 02 02 02 02 02 02 02 02 02 02 02 02 02 02 02 02 02 02
