Gauntlet (rev 1 - 9)
Maze number: 57
Offset for maze 56: 234219 - 0x0392eb
big endian buf: [%!l(uint8=0) %!l(uint8=3) %!l(uint8=146) %!l(uint8=235)]
G:1 Maze real addr: 242414 - 0x03B2EE, bank 1, boff: 0x2000
Maze read from: 0x03b2ee - 242414
compresssed: 154
 00 00 00 00 00 40 07 A8 A7 04 9E 27 80 C7 42 27
 2A C9 43 64 6C 42 68 41 03 97 D7 26 C4 4F 2A 26
 D5 AF A4 C5 44 4F C0 40 26 C8 6F D5 77 7F C4 AB
 CB 48 25 DA 7F C2 2A C0 6F C0 35 C4 74 26 D0 A3
 D3 74 25 C9 0B 81 C6 BF 6B 06 C2 05 C1 11 0B 81
 C7 2A D2 11 0B 81 C5 6F B4 A2 B8 11 0B 81 C2 5F
 CB 25 C5 11 84 0B 81 D6 0B 86 C0 26 D5 0B 86 BF
 2A C4 43 5F C6 B8 AB C9 6D 26 D3 7F CF BF 41 26
 CD 28 56 62 45 AF A4 D4 7F C1 42 2A 7F 67 56 03
 96 CD 6E 63 BE 64 4C 68 28 00
  Encoded length: 154 bytes
  Wall pattern: 00, Wall color: 07     Floor pattern: 04, Floor color: 00
  Flags: 
 02 02 02 02 02 02 02 02 02 02 02 02 02 02 02 02 02 02 02 02 02 02 02 02 02 02 02 02 02 02 02 02 02
 02 39 00 00 00 00 00 00 00 00 40 00 00 00 39 42 00 00 00 00 00 00 00 00 00 00 40 00 00 00 00 39 02
 02 00 00 00 00 39 00 00 00 00 00 00 00 00 00 00 00 00 00 40 00 00 00 39 00 00 00 00 00 00 00 00 02
 02 40 00 00 03 03 03 03 03 03 03 03 03 03 03 03 03 03 03 03 03 03 03 03 03 03 03 03 04 00 00 00 02
 02 00 00 00 00 00 00 00 00 00 00 00 00 00 00 00 00 00 00 00 00 38 00 00 00 00 00 40 04 00 00 00 02
 02 00 00 00 00 00 00 00 00 00 00 00 42 38 00 00 00 00 00 00 00 00 00 00 00 00 00 00 04 00 00 00 02
 02 00 00 00 02 02 02 02 02 02 02 02 02 02 02 02 02 02 02 02 02 02 02 02 02 00 00 00 04 00 00 40 02
 02 00 00 00 04 40 00 00 00 00 00 00 00 00 00 00 00 00 00 00 00 00 00 40 02 38 00 00 04 00 00 00 02
 02 00 00 39 04 00 00 00 00 00 00 00 00 00 00 00 00 00 00 00 00 00 00 00 02 00 00 00 04 00 00 00 02
 02 00 00 00 04 00 00 00 00 00 30 00 00 00 00 00 00 00 00 30 00 00 00 00 02 00 00 00 04 00 00 00 02
 02 00 00 00 04 00 00 00 02 02 02 02 02 02 02 02 02 02 02 02 02 00 00 00 02 00 00 00 04 00 00 00 02
 02 40 00 00 04 00 00 00 02 00 00 37 00 00 00 00 00 00 00 00 02 00 00 00 02 00 00 00 04 00 00 00 02
 02 00 00 00 04 00 00 30 02 00 00 00 00 00 00 00 00 00 00 00 02 00 00 00 02 00 00 42 04 39 00 00 02
 02 00 00 00 04 00 00 00 02 00 00 00 00 00 00 53 00 00 00 00 02 30 00 00 02 00 00 38 04 00 00 00 02
 02 00 00 00 04 00 00 00 02 00 00 00 02 02 02 02 02 00 00 00 02 00 00 00 02 00 00 00 04 00 00 00 02
 02 00 00 00 04 30 00 00 02 00 00 37 02 00 00 00 02 00 00 00 02 00 11 11 02 00 00 00 04 00 00 00 02
 02 39 00 00 04 00 00 00 02 00 00 00 02 00 06 00 02 00 05 00 02 17 11 11 02 00 00 00 04 00 00 00 02
 02 42 00 00 04 00 00 00 02 00 00 00 02 00 00 00 02 00 00 00 02 17 11 11 02 00 00 00 04 00 00 39 02
 02 00 00 00 04 00 00 00 02 00 00 00 02 00 00 00 02 02 02 02 02 17 11 11 02 00 00 00 04 00 00 00 02
 02 00 00 00 04 00 00 00 02 37 00 00 02 00 00 00 17 17 17 17 17 17 11 11 02 00 00 00 04 00 00 00 02
 02 00 00 00 04 00 00 00 02 00 00 00 02 00 00 00 11 11 11 11 11 11 11 11 02 38 00 00 04 00 00 00 02
 02 00 00 00 04 00 00 00 02 00 00 00 02 00 00 00 11 11 11 11 11 11 11 11 02 42 00 00 04 00 00 40 02
 02 00 00 00 04 00 00 00 02 00 00 00 02 02 02 02 02 02 02 02 02 02 02 02 02 00 00 00 04 00 00 00 02
 02 00 00 39 04 00 00 00 02 00 00 00 00 00 00 00 00 00 38 00 00 00 00 00 00 00 00 00 04 00 00 00 02
 02 00 00 00 04 00 00 30 02 00 00 00 00 00 00 00 00 00 00 00 00 00 00 00 00 00 00 00 04 00 00 00 02
 02 00 00 00 04 00 00 00 02 40 00 00 38 00 00 00 00 00 00 00 00 00 00 00 00 00 00 40 04 39 00 00 02
 02 40 00 00 04 00 00 00 02 02 02 02 02 02 02 02 02 02 02 02 02 02 02 02 02 02 02 02 02 00 00 00 02
 02 00 00 00 04 00 00 00 00 00 00 00 00 00 00 00 00 00 30 00 00 00 00 00 00 00 00 00 00 00 00 00 02
 02 00 00 00 04 40 00 00 00 42 30 00 00 00 00 00 00 00 00 00 00 00 00 00 00 00 00 39 00 00 00 00 02
 02 00 00 00 04 03 03 03 03 03 03 03 03 03 03 03 03 03 03 03 03 03 03 03 03 03 03 03 03 00 00 00 02
 02 00 00 00 00 00 00 00 00 00 00 39 00 00 00 00 00 00 00 00 00 00 00 00 00 00 00 39 00 00 00 00 02
 02 39 00 00 00 00 00 40 00 00 00 00 00 00 00 00 00 00 00 00 00 39 00 00 00 00 00 00 00 00 00 40 02
 02 02 02 02 02 02 02 02 02 02 02 02 02 02 02 02 02 02 02 02 02 02 02 02 02 02 02 02 02 02 02 02 02
