Gauntlet (rev 1 - 9)
Maze number: 33
Offset for maze 32: 236161 - 0x039a81
big endian buf: [%!l(uint8=0) %!l(uint8=3) %!l(uint8=154) %!l(uint8=129)]
G:1 Maze real addr: 252548 - 0x03DA84, bank 2, boff: 0x4000
Maze read from: 0x03da84 - 252548
compresssed: 406
 03 24 00 00 8C 84 4A 03 78 68 7B C8 0E 80 11 17
 80 C4 17 80 11 0E 80 C7 05 C7 0E 80 11 14 17 C4
 17 14 11 0E 80 7C C2 0E 80 11 17 80 71 C1 17 80
 11 0E 80 72 C3 AF 38 AE 1A 73 C9 2C 79 D2 38 14
 38 D5 19 C6 2A C6 19 C6 A5 38 A8 38 A8 38 A4 6C
 71 61 F7 62 E2 7A C5 1A E2 25 A0 E0 E0 E0 25 38
 C2 1A C5 AA E2 C0 1F E0 C2 A9 3B 39 C1 18 1B 18
 1B 18 C0 1C 38 60 60 E0 E0 60 1C C0 18 1B 18 1B
 18 C1 39 80 C2 45 E1 50 E0 50 E0 C2 45 CA B3 60
 E0 E0 60 60 60 C0 B3 E7 C2 43 C0 19 A0 C1 19 A0
 C0 19 E0 C0 1C E0 19 C1 43 C1 1F A0 51 C0 35 E1
 60 60 E0 60 E0 60 E0 C1 35 50 E1 1A C2 42 60 C1
 1C A0 50 E0 50 E0 C0 1C 60 44 C6 1C E2 60 E0 60
 60 60 60 E0 C2 1C C5 A1 43 2A 19 A0 C0 1F E0 C0
 1F E0 C0 1F E0 19 2A 43 A1 E0 C0 2A 52 E1 38 80
 E0 E0 60 E0 E0 38 A0 51 C2 2A C4 42 60 80 22 E0
 50 E0 50 E0 C0 22 38 80 44 C5 2B 18 E2 38 80 60
 60 60 E0 60 80 A0 C2 18 2B C6 42 50 19 A0 C0 25
 E0 C0 25 E0 C0 25 E0 19 28 44 C1 27 C3 18 62 19
 A0 E0 19 A0 E0 19 A0 E0 19 A0 C2 18 E4 C1 06 81
 A1 C0 2A 60 50 60 C0 2C 60 50 C0 A1 06 82 C0 A1
 35 C0 BF A2 BB AF A0 BB A2 BF C0 35 B2 E2 22 A0
 35 C2 20 C3 3A 39 1B 80 39 20 C2 2C A0 22 A0 E5
 E0 38 E7 60 80 39 38 64 A0 E0 E3 E0 66 39 38 80
 35 A0 C5 35 E2 E0 C2 1A C2 1D C4 39 1B 80 39 3A
 C7 1D C3 1A C0 00
  Encoded length: 406 bytes
  Wall pattern: 04, Wall color: 10     Floor pattern: 08, Floor color: 04
  Flags: PLAYER_OFFSCREEN 
  ╚══> while gauntlet has these elements, these flags probably do not operate
 02 02 02 02 02 02 02 02 02 02 02 02 02 02 02 02 02 02 02 02 02 02 02 02 02 02 02 02 02 02 02 02
 00 00 00 00 00 00 00 00 00 14 14 17 23 23 00 00 00 00 00 23 23 17 14 14 00 00 00 00 00 00 00 00
 05 00 00 00 00 00 00 00 00 14 14 17 20 23 00 00 00 00 00 23 20 17 14 14 00 00 00 00 00 00 00 00
 00 00 00 00 00 59 00 00 00 14 14 17 23 23 00 00 59 00 00 23 23 17 14 14 00 00 00 59 00 00 00 00
 02 02 02 02 02 02 02 02 02 02 02 02 02 02 02 02 56 02 02 02 02 02 02 02 02 02 02 02 02 02 02 02
 26 00 00 00 00 59 00 00 00 00 00 00 00 00 00 00 44 00 00 00 00 00 00 00 00 00 00 59 00 00 00 00
 00 00 00 00 00 00 00 00 00 00 00 00 00 00 00 56 20 56 00 00 00 00 00 00 00 00 00 00 00 00 00 00
 00 00 00 00 00 00 00 00 25 00 00 00 00 00 00 00 42 00 00 00 00 00 00 00 25 00 00 00 00 00 00 00
 02 02 02 02 02 02 56 02 02 02 02 02 02 02 02 02 56 02 02 02 02 02 02 02 02 02 56 02 02 02 02 02
 00 00 00 00 00 00 00 00 00 00 00 00 00 56 00 00 59 00 00 56 00 00 00 00 00 00 00 00 00 00 00 00
 00 00 00 00 00 00 00 00 00 00 00 00 02 00 00 00 56 00 00 00 02 00 00 00 00 00 00 00 00 00 00 00
 59 00 00 00 00 00 00 26 00 00 00 02 37 02 00 02 00 02 00 02 37 56 00 00 00 26 00 00 00 00 00 00
 02 02 02 02 02 02 02 02 02 02 02 00 00 00 02 00 31 00 02 00 00 00 02 02 02 02 02 02 02 02 02 02
 59 57 00 02 24 27 24 27 24 02 28 56 00 56 00 56 00 02 00 02 00 56 28 02 24 27 24 27 24 02 00 57
 57 00 00 02 03 03 03 03 03 02 00 00 02 00 40 00 02 00 40 00 02 00 00 02 03 03 03 03 03 02 00 00
 00 00 00 02 00 00 00 00 00 02 00 56 00 02 00 02 00 56 00 56 00 56 00 02 00 00 00 00 00 02 00 00
 02 00 00 02 03 03 03 02 00 25 02 00 00 25 02 00 25 00 02 00 28 00 02 25 00 02 03 03 03 02 00 00
 31 02 00 02 40 00 53 02 00 02 00 56 00 56 00 02 00 56 00 02 00 56 00 02 00 02 53 00 40 02 00 02
 26 00 00 02 03 03 03 02 56 00 00 28 02 00 40 00 02 00 40 00 02 00 28 00 56 02 03 03 03 02 00 00
 00 00 00 02 00 28 00 02 00 02 00 56 00 02 00 56 00 56 00 56 00 56 00 02 00 02 00 28 00 02 00 00
 00 00 02 02 03 03 03 02 42 25 02 00 31 00 02 00 31 00 02 00 31 00 02 25 42 02 03 03 03 02 02 00
 02 00 42 02 00 00 40 02 00 02 56 56 00 02 00 02 00 56 00 02 00 02 56 02 00 02 40 00 00 02 42 00
 00 00 00 02 03 03 03 02 56 56 34 00 02 00 40 00 02 00 40 00 02 00 34 56 56 02 03 03 03 02 00 00
 00 00 00 02 43 24 00 02 00 02 56 56 00 56 00 56 00 56 00 02 00 56 56 02 00 02 00 24 43 02 00 00
 00 00 00 02 03 03 03 02 40 25 02 00 37 00 02 00 37 00 02 00 37 00 02 25 40 02 03 03 03 02 00 00
 39 00 00 02 00 24 00 02 00 56 25 02 00 02 25 02 00 02 25 02 00 02 25 02 00 02 00 24 00 02 00 00
 02 02 00 02 06 06 06 02 02 00 42 00 56 00 40 00 56 00 44 00 56 00 40 00 02 02 06 06 06 02 00 02
 02 53 00 02 02 02 02 02 02 02 02 02 02 02 02 02 02 02 02 02 02 02 02 02 02 02 02 02 02 02 00 53
 02 00 00 00 02 34 02 53 00 00 00 32 00 00 00 00 58 57 27 27 57 32 00 00 00 44 02 34 02 00 00 00
 00 00 00 02 00 02 56 00 00 00 00 00 00 00 00 02 00 56 56 57 56 00 00 00 00 00 56 02 00 02 00 00
 00 00 02 00 02 00 00 00 00 00 00 00 56 57 56 56 53 02 00 00 00 00 00 00 53 00 00 00 02 00 02 00
 00 00 26 00 00 00 29 00 00 00 00 00 57 27 27 57 58 00 00 00 00 00 00 00 00 29 00 00 00 00 26 00
