Gauntlet (rev 1 - 9)
Maze number: 82
Offset for maze 81: 230584 - 0x0384b8
big endian buf: [%!l(uint8=0) %!l(uint8=3) %!l(uint8=132) %!l(uint8=184)]
G:1 Maze real addr: 246971 - 0x03C4BB, bank 2, boff: 0x4000
Maze read from: 0x03c4bb - 246971
compresssed: 210
 00 00 00 00 00 54 30 68 D9 A0 A7 A1 19 80 40 4A
 50 28 51 51 51 51 19 A0 19 80 E8 EE C2 19 A0 19
 80 E8 EC C4 19 A0 19 80 E8 48 E0 C0 74 19 A0 19
 80 E8 E8 C8 19 60 E9 E6 40 E9 40 44 E2 C1 18 E1
 C0 7B A0 44 E4 E2 C4 2A 48 A0 EA 28 A0 D0 28 A0
 2C 48 A0 C0 7F E1 E8 F5 E6 40 D4 2A A0 C1 18 E1
 C0 78 18 CC 2A A0 E2 CE 05 ED CA 18 C0 06 BF EE
 2A 7F ED DA 2A A0 E2 CB 18 CB 2A A0 C1 18 E1 C0
 7F E5 E6 40 F3 E8 D2 28 A0 40 47 A0 C0 7E 28 A0
 EA 2C A0 EF EA E2 CC 19 60 E9 C1 18 E1 C0 78 19
 A0 19 80 E8 E6 40 C6 19 A0 19 80 E8 E8 C6 19 A0
 19 80 E8 EA C0 72 19 A0 19 80 E8 EC C2 19 A0 19
 80 E8 EE C0 BE A0 19 80 4C 20 28 80 51 50 28 51
 50 00
  Encoded length: 210 bytes
  Wall pattern: 04, Wall color: 00     Floor pattern: 05, Floor color: 03
  Flags: 
 02 02 02 02 02 02 02 02 02 02 02 02 02 02 02 02 02 02 02 02 02 02 02 02 02 02 02 02 02 02 02 02 02
 02 02 25 25 00 40 00 00 00 00 00 00 00 00 00 00 00 40 32 00 40 32 00 00 32 00 00 32 00 00 32 00 02
 02 25 02 25 25 00 00 00 00 00 00 00 00 00 02 00 00 00 00 00 00 00 00 00 00 00 00 00 00 00 02 00 02
 02 00 25 02 25 25 00 00 00 00 00 00 00 00 00 02 00 00 00 00 00 00 00 00 00 00 00 00 00 02 00 00 02
 02 00 00 25 02 25 25 00 00 00 00 00 00 00 00 00 02 00 00 00 00 00 00 00 00 00 40 00 02 00 39 00 02
 02 00 00 00 25 02 25 25 00 00 00 00 00 00 00 00 00 02 00 00 00 00 00 00 00 00 00 02 00 00 00 00 02
 02 00 00 00 00 25 02 25 00 00 00 00 00 00 00 00 00 00 02 00 00 00 00 00 00 00 02 00 40 00 00 00 02
 02 00 00 00 00 00 00 02 00 40 00 00 00 00 00 40 00 00 00 02 00 00 24 00 00 02 00 39 00 00 00 00 02
 02 00 00 00 00 00 00 00 02 00 00 00 00 00 40 00 00 00 00 00 02 00 00 00 02 00 00 00 00 00 42 00 02
 02 00 00 00 00 00 00 00 40 02 00 00 00 00 00 00 00 00 00 00 00 02 40 02 00 00 00 00 00 00 00 00 02
 02 00 00 00 00 00 00 00 00 40 02 44 00 00 00 00 00 00 00 00 00 40 02 00 39 00 00 00 00 00 00 00 02
 02 00 00 00 00 00 00 00 00 00 00 02 00 00 00 00 00 00 00 00 00 02 00 00 00 00 00 00 00 00 00 00 02
 02 00 00 00 00 00 00 00 00 00 00 00 02 00 00 00 00 00 00 00 02 00 40 00 00 00 00 00 00 00 00 00 02
 02 00 00 00 00 00 00 00 00 00 00 00 42 02 00 00 24 00 00 02 00 39 00 00 00 00 00 00 00 00 00 24 02
 02 00 00 00 00 00 00 00 00 00 00 00 00 42 02 00 00 00 02 00 00 00 00 00 00 00 00 00 00 00 00 00 02
 02 00 05 00 00 00 00 00 00 00 00 00 00 00 00 00 00 02 00 00 00 00 00 00 00 00 00 00 00 24 00 06 02
 02 00 00 00 00 00 00 00 00 00 00 00 00 00 00 00 02 42 39 00 00 00 00 00 00 00 00 00 00 00 00 00 02
 02 00 00 00 00 00 00 00 00 00 00 00 00 00 00 00 00 02 00 00 00 00 00 00 00 00 00 00 00 00 00 00 02
 02 00 00 00 00 00 00 00 00 00 00 00 00 42 02 00 00 00 02 00 00 00 00 00 00 00 00 00 00 00 00 24 02
 02 00 00 00 00 00 00 00 00 00 00 00 42 02 00 00 24 00 00 02 00 39 00 00 00 00 00 00 00 00 00 00 02
 02 00 00 00 00 00 00 00 00 00 00 00 02 00 00 00 00 00 00 00 02 00 40 00 00 00 00 00 00 00 00 00 02
 02 00 00 00 00 00 00 00 00 00 00 02 00 00 00 00 00 00 00 00 00 02 00 00 00 00 00 00 00 00 00 00 02
 02 00 00 00 00 00 00 00 00 40 02 00 40 00 00 00 00 00 00 00 00 40 02 00 39 00 00 00 00 00 00 00 02
 02 00 00 00 00 00 00 00 40 02 00 00 00 00 00 00 00 00 00 00 00 02 44 02 00 00 00 00 00 00 00 00 02
 02 00 00 00 00 00 00 00 02 00 00 00 00 00 00 00 00 00 00 00 02 00 00 00 02 00 00 00 00 00 00 00 02
 02 00 00 00 00 00 25 02 25 00 00 00 00 00 00 00 00 00 00 02 00 00 24 00 00 02 00 39 00 00 00 00 02
 02 00 00 00 00 25 02 25 25 00 00 00 00 00 00 00 00 00 02 00 00 00 00 00 00 00 02 00 40 00 00 00 02
 02 00 00 00 25 02 25 25 00 00 00 00 00 00 00 00 00 02 00 00 00 00 00 00 00 00 00 02 00 00 00 00 02
 02 00 00 25 02 25 25 00 00 00 00 00 00 00 00 00 02 00 00 00 00 00 00 00 00 00 00 00 02 00 39 00 02
 02 00 25 02 25 25 00 00 00 00 00 00 00 00 00 02 00 00 00 00 00 00 00 00 00 00 00 00 00 02 00 00 02
 02 25 02 25 25 00 00 00 00 00 00 00 00 00 02 00 00 00 00 00 00 00 00 00 00 00 00 00 00 00 02 00 02
 02 02 25 25 00 00 00 00 00 00 00 00 00 00 00 00 00 40 32 40 40 32 00 00 32 00 40 32 00 00 32 00 02
 02 02 02 02 02 02 02 02 02 02 02 02 02 02 02 02 02 02 02 02 02 02 02 02 02 02 02 02 02 02 02 02 02
