Gauntlet (rev 1 - 9)
Maze number: 12
Offset for maze 11: 232133 - 0x038ac5
big endian buf: [%!l(uint8=0) %!l(uint8=3) %!l(uint8=138) %!l(uint8=197)]
G:1 Maze real addr: 232136 - 0x038AC8, bank 0, boff: 0x0000
Maze read from: 0x038ac8 - 232136
compresssed: 223
 17 3B 0C 1F 00 80 19 68 4B 39 6A 38 8A A0 35 A0
 4F 70 A8 C1 38 10 81 C3 A7 64 1B 81 0B 70 40 E2
 21 10 73 C0 15 26 15 C0 3B 65 80 60 80 E6 10 80
 C2 B2 C2 15 4E E5 43 64 81 4A E6 68 1B C9 A6 C2
 A6 B2 A5 03 81 46 C0 21 10 E5 77 CD 10 80 E6 F3
 CD 17 C2 3B CB 13 AD 26 17 CD B2 A0 CB 17 26 D2
 10 13 C9 17 C4 BB CC 21 10 DC BD A1 C1 A4 46 C4
 BF CE 05 C7 17 26 15 C7 BF DC 28 D6 A4 C2 1A C2
 A8 03 82 C9 35 C9 1B 43 4D CC 18 41 CC 10 21 10
 4E C2 39 C5 3B 73 C7 39 82 42 C2 1B C5 A5 B5 C8
 3B 81 39 83 52 39 D7 39 35 70 4C D0 28 CB 0E 27
 0E 4A 43 C8 BF 48 81 C0 3A 81 2B C0 39 EB C9 1B
 C1 3A 39 81 C0 1B EB D1 1B C6 BF 61 83 C1 3B C2
 BE 06 C1 BD C2 35 5B 1B 53 68 1B 81 0B C5 00
  Encoded length: 223 bytes
  Wall pattern: 00, Wall color: 09     Floor pattern: 08, Floor color: 01
  Flags: 
 02 02 02 02 02 02 02 02 02 02 02 02 02 02 02 02 02 02 02 02 02 02 02 02 02 02 02 02 02 02 02 02 02
 02 56 56 56 56 56 56 56 56 56 56 56 02 53 02 00 00 00 00 00 00 00 00 00 00 00 00 00 00 00 00 40 02
 02 42 02 02 02 02 02 02 02 02 02 00 00 56 16 16 16 00 00 00 02 02 02 02 02 02 02 02 02 00 00 00 02
 02 00 11 27 02 27 11 00 42 02 40 00 00 00 02 33 16 00 00 00 02 42 00 21 38 21 00 59 02 00 00 00 02
 02 00 11 11 02 11 11 00 00 02 00 00 00 00 02 16 16 00 00 00 02 00 00 00 21 00 00 00 02 00 00 00 02
 02 00 00 00 02 00 00 00 40 02 00 00 00 00 00 02 00 00 00 00 40 00 00 02 00 00 11 11 02 00 00 00 02
 02 00 00 00 02 00 00 00 40 02 00 00 00 00 00 00 02 00 00 00 00 00 00 02 00 00 11 27 02 00 00 00 02
 02 00 00 00 02 00 02 02 02 02 02 02 02 00 00 00 02 02 02 02 02 02 02 02 02 02 02 02 02 02 03 03 02
 02 00 00 00 02 00 00 00 40 02 33 16 00 00 00 00 00 00 02 00 00 00 00 00 00 00 00 42 02 00 00 00 02
 02 00 00 00 02 00 00 00 00 02 16 16 00 00 00 00 00 00 00 02 00 00 00 00 00 00 00 00 02 00 00 00 02
 02 00 00 00 02 00 00 02 02 02 00 00 00 00 00 00 00 00 00 00 00 00 00 23 00 00 00 59 02 00 00 00 02
 02 00 00 00 02 00 00 02 19 02 02 02 02 02 02 02 02 02 02 02 02 02 02 38 23 00 00 00 02 00 00 00 02
 02 00 00 00 02 00 00 02 02 02 00 00 00 00 00 00 00 00 00 00 00 23 38 02 00 00 00 00 02 00 00 00 02
 02 00 00 00 02 00 00 00 00 02 16 19 00 00 00 00 00 00 00 00 00 00 23 02 00 00 00 00 02 00 00 00 02
 02 00 00 00 02 00 00 00 00 02 33 16 00 00 00 00 00 00 00 00 00 00 00 02 00 00 00 00 00 00 00 00 02
 02 00 00 00 02 00 00 00 00 02 02 02 00 00 02 02 02 02 02 00 00 00 00 02 00 00 40 00 00 00 00 00 02
 02 00 00 00 02 00 00 00 00 00 00 00 00 00 00 00 05 00 02 00 00 00 00 02 00 23 38 21 00 00 00 00 02
 02 00 00 00 02 00 00 00 00 00 00 00 00 00 00 00 00 00 02 00 00 00 00 02 00 00 00 00 00 00 00 00 02
 02 00 40 00 02 00 00 00 00 00 00 00 00 00 00 00 00 00 02 00 00 00 00 02 00 00 02 02 02 02 02 00 02
 02 00 26 00 02 00 02 02 02 02 02 02 02 02 02 03 03 03 02 00 00 00 00 02 00 00 00 00 00 53 02 00 02
 02 00 00 00 02 00 00 00 27 57 00 00 00 40 00 00 00 00 02 00 00 00 00 02 00 00 00 00 40 00 02 00 02
 02 00 00 00 02 00 00 00 00 57 24 00 00 40 00 00 00 00 02 00 00 00 00 02 00 00 00 16 33 16 02 00 02
 02 00 00 00 02 00 00 00 00 57 00 00 00 40 00 00 57 57 02 00 00 00 00 02 59 00 00 00 00 42 02 00 02
 02 00 00 00 02 00 57 57 57 57 00 00 00 40 00 00 57 27 02 00 00 00 00 02 02 02 02 02 02 02 02 00 02
 02 00 00 00 02 00 00 00 59 57 59 57 57 57 57 57 57 57 02 00 00 00 00 02 00 00 00 00 00 00 00 00 02
 02 00 00 00 02 00 00 00 00 57 57 53 00 42 00 00 00 00 02 00 00 00 00 02 00 00 00 40 00 00 00 00 02
 02 00 00 00 02 00 00 00 00 57 00 00 00 40 00 00 00 00 02 00 00 00 00 02 00 00 14 39 14 00 00 00 02
 02 00 00 00 02 00 00 00 40 57 00 00 00 40 00 00 00 00 02 00 00 00 00 02 00 00 00 00 00 00 00 00 02
 02 40 40 40 02 58 58 58 43 57 57 57 00 00 00 00 00 00 02 00 00 00 00 02 00 00 00 00 00 00 00 00 02
 02 00 27 00 02 58 57 57 57 57 27 57 00 00 00 00 00 00 02 00 00 00 00 02 00 00 00 00 00 00 00 00 02
 02 00 00 00 02 00 00 00 00 57 27 57 00 00 00 00 00 00 02 00 00 11 11 11 11 11 00 00 59 00 00 00 02
 02 06 00 00 02 00 00 00 53 57 27 57 00 00 00 00 00 00 00 00 00 11 27 27 27 11 00 00 00 00 00 00 02
 02 02 02 02 02 02 02 02 02 02 02 02 02 02 02 02 02 02 02 02 02 02 02 02 02 02 02 02 02 02 02 02 02
