Gauntlet (rev 1 - 9)
Maze number: 113
Offset for maze 112: 235626 - 0x03986a
big endian buf: [%!l(uint8=0) %!l(uint8=3) %!l(uint8=152) %!l(uint8=106)]
G:1 Maze real addr: 252013 - 0x03D86D, bank 2, boff: 0x4000
Maze read from: 0x03d86d - 252013
compresssed: 162
 15 35 00 02 80 33 00 59 66 A1 68 A1 19 80 CE 2B
 4C A0 19 80 49 81 AC 42 A0 19 28 E4 19 83 A0 60
 4E A0 19 80 E4 19 40 A0 65 4B A0 E6 19 A0 6A C4
 50 50 19 A0 70 E4 06 5F E5 2C E5 66 EF E6 61 D3
 28 A0 C6 AF 77 A0 FF FF C8 18 D4 2A A0 DE 2A AF
 C3 05 DC BF D6 18 DF D3 2A AF CD 2A A0 FD C8 18
 F3 DC 28 A0 DC 28 A0 C6 AF E6 2C E5 61 CC 51 50
 19 A0 70 E4 66 4C A0 E6 06 5F 42 A0 E6 19 A0 6A
 46 A0 19 28 E4 19 40 A0 65 49 A0 19 80 E4 19 83
 A0 60 4C A0 19 80 49 81 AC C0 BE A0 19 80 CD 2B
 CC 00
  Encoded length: 162 bytes
  Wall pattern: 03, Wall color: 00     Floor pattern: 03, Floor color: 00
  Flags: PLAYER_OFFSCREEN 
  ╚══> while gauntlet has these elements, these flags probably do not operate
 02 02 02 02 02 02 02 02 02 02 02 02 02 02 02 02 02 02 02 02 02 02 02 02 02 02 02 02 02 02 02 02 02
 02 02 25 25 00 00 00 00 00 00 00 00 00 00 00 00 00 00 00 43 00 00 00 00 00 00 00 00 00 00 00 00 02
 02 25 02 25 25 00 00 00 00 00 00 00 00 00 00 25 25 25 02 02 02 02 02 02 02 02 02 02 02 02 02 00 02
 02 00 25 02 25 40 00 00 00 00 00 02 25 25 25 25 25 02 00 38 00 00 00 00 00 00 00 00 00 00 00 00 02
 02 00 00 25 02 25 25 00 00 00 00 00 02 25 00 25 02 00 00 00 00 00 00 38 00 00 00 00 00 00 00 00 02
 02 00 00 00 25 02 00 00 00 00 00 00 00 02 25 02 00 00 00 00 00 00 00 00 00 00 00 38 00 00 00 00 02
 02 33 00 33 00 25 02 00 40 00 00 00 00 00 02 06 33 00 00 00 00 00 00 00 00 00 00 00 00 00 00 00 02
 02 00 00 00 00 00 00 02 44 00 00 00 00 00 00 02 00 00 00 00 00 00 00 38 00 00 00 00 00 00 00 00 02
 02 00 00 00 00 00 00 00 02 00 00 00 00 00 00 00 02 00 00 38 00 00 00 00 00 00 00 00 00 00 00 00 02
 02 00 00 00 00 00 00 00 40 02 00 00 00 00 00 00 00 02 02 02 02 02 02 02 02 02 02 02 02 02 02 02 02
 02 00 00 00 00 00 00 00 00 40 02 00 00 00 00 00 00 00 00 00 00 00 00 00 00 00 00 00 00 00 00 00 02
 02 00 00 00 00 00 00 00 00 00 00 02 00 00 00 00 00 00 00 00 00 00 00 00 00 00 00 00 00 00 00 00 02
 02 00 00 00 00 00 00 00 00 00 00 00 02 00 00 00 00 00 00 00 00 00 24 00 00 00 00 00 00 00 00 00 02
 02 00 00 00 00 00 00 00 00 00 00 00 42 02 00 00 00 00 00 00 00 00 00 00 00 00 00 00 00 00 00 00 02
 02 00 00 00 00 00 00 00 00 00 00 00 00 42 02 02 02 02 02 02 02 02 02 02 02 02 02 02 02 02 00 00 02
 02 00 05 00 00 00 00 00 00 00 00 00 00 00 00 00 00 00 00 00 00 00 00 00 00 00 00 00 00 00 00 00 02
 02 00 00 00 00 00 00 00 00 00 00 00 00 00 00 00 00 00 00 00 00 00 00 00 24 00 00 00 00 00 00 00 02
 02 00 00 00 00 00 00 00 00 00 00 00 00 00 00 00 00 00 00 00 00 00 00 00 00 00 00 00 00 00 00 00 02
 02 00 00 00 00 00 00 00 00 00 00 00 00 42 02 02 02 02 02 02 02 02 02 02 02 02 02 02 02 02 00 00 02
 02 00 00 00 00 00 00 00 00 00 00 00 42 02 00 00 00 00 00 00 00 00 00 00 00 00 00 00 00 00 00 00 02
 02 00 00 00 00 00 00 00 00 00 00 00 02 00 00 00 00 00 00 00 00 00 24 00 00 00 00 00 00 00 00 00 02
 02 00 00 00 00 00 00 00 00 00 00 02 00 00 00 00 00 00 00 00 00 00 00 00 00 00 00 00 00 00 00 00 02
 02 00 00 00 00 00 00 00 00 40 02 00 00 00 00 00 00 00 00 00 00 00 00 00 00 00 00 00 00 00 00 00 02
 02 00 00 00 00 00 00 00 40 02 00 00 00 00 00 00 00 02 02 02 02 02 02 02 02 02 02 02 02 02 02 02 02
 02 00 00 00 00 00 00 00 02 44 00 00 00 00 00 00 02 00 00 38 00 00 00 00 00 00 00 00 00 00 00 00 02
 02 33 00 00 33 00 25 02 00 40 00 00 00 00 00 02 00 00 00 00 00 00 00 38 00 00 00 00 00 00 00 00 02
 02 00 00 00 00 25 02 00 00 00 00 00 00 00 02 06 33 00 00 00 00 00 00 00 00 00 00 00 00 00 00 00 02
 02 00 00 00 25 02 00 00 00 00 00 00 00 02 25 02 00 00 00 00 00 00 00 00 00 00 00 38 00 00 00 00 02
 02 00 00 25 02 25 40 00 00 00 00 00 02 25 00 25 02 00 00 00 00 00 00 38 00 00 00 00 00 00 00 00 02
 02 00 25 02 25 25 00 00 00 00 00 02 25 25 25 25 25 02 00 38 00 00 00 00 00 00 00 00 00 00 00 00 02
 02 25 02 25 25 00 00 00 00 00 00 00 00 00 00 25 25 25 02 02 02 02 02 02 02 02 02 02 02 02 02 00 02
 02 02 25 25 00 00 00 00 00 00 00 00 00 00 00 00 00 00 43 00 00 00 00 00 00 00 00 00 00 00 00 00 02
 02 02 02 02 02 02 02 02 02 02 02 02 02 02 02 02 02 02 02 02 02 02 02 02 02 02 02 02 02 02 02 02 02
