Gauntlet (rev 1 - 9)
Maze number: 81
Offset for maze 80: 230273 - 0x038381
big endian buf: [%!l(uint8=0) %!l(uint8=3) %!l(uint8=131) %!l(uint8=129)]
G:1 Maze real addr: 246660 - 0x03C384, bank 2, boff: 0x4000
Maze read from: 0x03c384 - 246660
compresssed: 308
 08 1F 00 00 88 53 76 B8 DB 68 7B C3 1D 54 D0 19
 D4 3B C8 19 C5 1D C9 05 C1 B2 A7 C6 B2 1D F5 E5
 38 A3 2A 72 CE A5 C4 B4 A3 46 3B D6 1E B6 A9 EA
 28 C6 1E C8 2A 60 C8 A7 28 A0 1E C9 B2 6A 60 60
 12 A1 3B A2 E8 E0 1B 60 A0 28 A0 28 C0 40 40 60
 E1 C2 A2 38 A1 C3 40 42 40 38 A0 E0 E0 E0 E8 1A
 C0 A1 E0 E0 E0 E0 E0 E1 C0 40 40 B4 A0 C8 1A E1
 E0 C0 40 A0 E0 E0 40 A0 E0 C0 41 A2 C6 1A E1 E0
 28 A0 C0 40 41 A0 14 A0 E0 C0 1B A0 18 81 A5 E2
 E0 E0 1B A0 E0 C0 A1 E0 E0 52 39 81 C4 1A A0 E0
 C0 40 40 40 40 A0 C0 1B 60 A0 C0 1B 3B C8 B2 A0
 C0 40 40 60 A0 E0 E0 1B A0 40 41 A2 E9 E0 C0 A2
 C0 40 40 41 A0 C0 40 3B EC E0 C1 1B A0 E0 E0 C0
 A1 12 A0 C7 A5 E8 E0 E0 C4 B3 55 E4 CD A3 C2 B6
 C9 A2 C0 A9 C4 21 A0 ED EE C3 B3 3A 80 A2 CF A4
 C0 A1 3B A0 28 C3 2A A2 C4 1E A6 C0 1E 59 A2 C2
 A5 2A C8 A2 52 E1 C3 1E C4 2C 58 A0 71 A0 39 81
 70 C3 1E C5 06 B2 06 C5 A1 E3 18 81 B3 C0 AB C0
 A6 C6 A2 E0 CA 06 A0 06 C9 1E E0 70 C3 1E C8 2A
 A0 2A C5 00
  Encoded length: 308 bytes
  Wall pattern: 03, Wall color: 06     Floor pattern: 05, Floor color: 07
  Flags: PLAYER_OFFSCREEN 
  ╚══> while gauntlet has these elements, these flags probably do not operate
 02 02 02 02 02 02 02 02 02 02 02 02 02 02 02 02 02 02 02 02 02 02 02 02 02 02 02 02 02 02 02 02
 00 00 00 00 29 00 00 00 00 00 40 02 00 00 00 00 00 02 00 00 00 00 00 00 00 00 00 00 25 00 00 00
 00 02 00 00 00 02 00 00 00 00 00 02 00 00 00 00 00 02 59 00 00 00 00 00 00 00 00 00 25 00 00 00
 00 02 00 29 00 02 00 00 00 00 00 02 00 00 05 00 00 02 02 02 02 02 02 02 02 02 00 00 00 00 00 00
 00 02 29 00 00 02 00 00 00 00 00 02 00 00 00 00 00 00 00 00 00 00 00 00 00 02 00 00 00 00 00 00
 02 56 02 02 02 02 42 00 00 00 59 02 00 00 00 00 00 00 00 00 00 00 00 00 00 00 02 02 02 02 02 02
 00 00 00 00 00 02 02 02 02 02 56 02 00 00 00 00 00 00 59 00 00 00 00 00 00 00 00 00 00 00 00 00
 00 00 00 00 00 00 00 00 00 00 30 02 02 02 02 02 02 02 02 02 02 02 00 00 00 00 00 00 00 00 00 00
 00 02 40 00 00 00 00 00 00 00 30 00 00 00 00 00 00 00 00 00 42 02 27 00 00 00 00 00 00 00 00 00
 02 02 02 02 02 02 02 02 40 02 30 00 00 00 00 00 00 00 00 00 00 02 02 02 02 02 02 02 02 02 02 02
 02 27 02 27 02 27 18 02 02 59 02 02 02 00 00 00 00 00 00 00 00 00 02 00 02 27 02 27 02 40 02 40
 00 56 00 56 00 02 27 02 00 02 00 00 00 02 02 02 56 02 02 00 00 00 00 56 00 56 00 00 00 56 00 56
 02 00 02 00 02 00 02 02 00 00 00 00 00 00 00 00 02 26 00 02 02 00 02 00 02 00 02 00 02 00 02 00
 00 02 00 56 00 56 00 02 02 00 00 00 00 00 00 00 00 00 26 00 00 02 00 02 00 56 00 02 00 02 00 02
 56 00 02 00 02 00 56 00 00 02 02 02 00 00 00 00 00 00 00 26 00 00 02 00 02 40 02 00 56 00 56 00
 00 02 20 02 00 02 00 27 02 24 24 24 02 02 02 02 02 02 00 00 00 02 00 02 00 02 27 02 00 02 00 02
 02 00 02 00 02 00 00 02 40 57 57 57 00 00 00 00 02 26 02 00 02 00 56 00 56 00 56 00 56 00 02 00
 27 02 27 02 00 27 59 02 00 00 00 00 00 00 00 00 02 02 00 56 00 56 00 02 27 02 00 02 00 02 27 02
 56 00 56 00 02 02 02 02 00 00 00 00 00 00 00 00 00 00 02 00 02 00 02 02 02 00 56 00 56 00 56 00
 00 02 00 56 02 59 00 02 00 00 00 00 00 00 00 00 00 00 00 02 00 02 00 00 27 02 00 02 00 02 00 02
 02 18 02 00 02 00 00 02 00 00 00 02 02 02 02 02 02 00 00 00 00 00 00 00 00 00 02 00 02 00 02 00
 00 00 00 00 02 00 00 02 00 00 02 40 00 00 00 00 00 02 00 00 00 00 00 00 00 00 00 00 00 00 00 00
 02 02 02 02 00 00 00 02 00 00 02 00 00 00 00 00 00 00 02 02 02 00 02 02 02 02 02 02 02 02 02 02
 00 00 00 00 00 33 02 00 00 00 02 00 00 00 00 00 00 00 00 00 00 02 00 00 00 00 00 00 00 00 00 00
 00 00 00 00 00 02 00 00 00 00 02 58 58 02 02 02 00 00 00 00 00 00 00 00 00 00 00 00 00 00 00 00
 02 02 02 02 02 00 02 02 59 02 40 00 00 00 00 42 02 02 02 00 00 00 00 00 30 02 02 02 02 02 02 02
 00 30 00 00 00 00 00 00 00 00 02 00 40 02 02 02 00 00 00 02 02 02 02 02 02 42 00 00 00 00 00 00
 00 00 00 02 02 02 00 00 00 40 02 00 02 00 00 00 00 30 00 00 00 00 00 44 02 00 00 00 00 00 00 00
 00 40 02 00 00 59 02 57 57 57 02 59 00 00 00 00 30 00 00 00 00 00 00 06 02 06 00 00 00 00 00 00
 02 02 00 00 00 00 02 24 24 24 02 00 02 02 02 02 02 02 02 02 02 02 02 02 00 02 02 02 02 02 02 02
 00 00 00 00 00 00 00 02 02 02 00 02 00 00 00 00 00 00 00 00 00 00 00 06 02 06 00 00 00 00 00 00
 00 00 00 00 30 00 02 00 59 00 00 00 00 30 00 00 00 00 00 00 00 00 00 42 02 42 00 00 00 00 00 00
 02 02 02 02 02 02 02 02 02 02 02 02 02 02 02 02 02 02 02 02 02 02 02 02 02 02 02 02 02 02 02 02
