Gauntlet (rev 1 - 9)
Maze number: 16
Offset for maze 15: 233277 - 0x038f3d
big endian buf: [%!l(uint8=0) %!l(uint8=3) %!l(uint8=143) %!l(uint8=61)]
G:1 Maze real addr: 233280 - 0x038F40, bank 0, boff: 0x0000
Maze read from: 0x038f40 - 233280
compresssed: 386
 18 1B 07 1A 09 20 44 03 4E 04 49 41 75 C3 19 76
 C8 40 24 04 E0 73 80 C1 19 77 80 E5 2B 04 41 E1
 C0 19 70 81 C3 42 19 71 80 C2 19 E0 E0 40 2B A0
 E2 C0 19 70 81 C2 04 06 04 72 80 E3 60 C0 A1 61
 80 E0 C0 19 70 80 C2 42 19 72 C0 19 E0 60 82 60
 60 E2 72 EC 60 80 61 62 81 E1 71 E3 C1 19 C1 19
 E0 61 60 80 60 61 60 E2 C2 12 28 A0 E0 28 C0 12
 E1 C8 A2 2B E4 C1 28 A0 E2 28 E1 E7 E1 63 60 E0
 E0 E4 28 A0 0E 80 61 E3 C1 2B 63 82 28 A0 35 C4
 35 A0 28 12 60 81 C3 2B E1 B3 62 80 12 28 A0 C1
 41 C0 42 E0 28 0E 60 83 B3 A0 C2 18 62 80 28 A0
 C2 24 04 C0 04 24 04 E1 28 0E 12 C3 18 C2 2C 82
 B2 0E 28 A0 C2 52 41 C0 42 E2 28 60 B2 2C 82 18
 83 B4 0E 12 A0 C6 05 E6 0E 80 C0 B4 C6 B6 0E 80
 C0 28 A0 C2 42 C0 42 E2 28 12 61 B6 C4 B3 0E C3
 28 A0 C0 35 04 24 51 C0 04 24 04 35 E0 28 0E 80
 60 60 B3 C0 B2 B2 B3 0E C4 12 28 A1 42 C0 42 A1
 28 12 60 63 B3 E9 28 C8 28 A0 60 80 60 EE C0 46
 E0 0E 60 F0 C2 28 0F A0 0F 28 E2 0E 80 61 EC E0
 C1 0F A0 0F A0 0F E1 E0 0E 62 EA E4 0F 24 0F A0
 E4 0E 80 EB E2 C1 0F A0 0F A0 0F E1 E2 EB C6 28
 0F A0 0F 28 E6 61 E6 C6 55 44 55 E6 E3 E2 E5 C2
 15 80 E3 E5 C2 2B A0 E0 C9 15 82 EA E0 41 CA 15
 84 EA 40 24 04 C9 15 86 CA 04 41 C8 15 88 C8 2B
 40 00
  Encoded length: 386 bytes
  Wall pattern: 00, Wall color: 04     Floor pattern: 02, Floor color: 04
  Flags: SHOTS_STUN 
  ╚══> while gauntlet has these elements, these flags probably do not operate
 02 02 02 02 02 02 02 02 02 02 02 02 02 02 02 02 02 02 02 02 02 02 02 02 02 02 02 02 02 02 02 02
 03 03 00 00 00 00 00 00 09 00 00 00 00 25 00 00 00 00 00 00 00 09 00 00 00 00 00 00 00 00 00 03
 36 04 00 02 00 00 00 00 09 09 00 00 25 00 00 00 00 00 00 00 00 09 09 00 00 00 00 00 00 02 43 04
 03 03 00 00 02 00 25 00 09 09 09 00 00 00 00 03 03 03 25 00 00 09 09 00 00 00 25 00 02 00 02 03
 43 02 00 00 00 02 00 25 00 09 09 09 00 00 00 04 06 04 00 00 00 09 09 00 00 00 00 02 00 14 00 02
 02 00 00 14 14 00 02 00 25 00 09 09 00 00 00 03 03 03 25 00 00 00 09 00 25 00 02 00 14 14 14 14
 00 14 00 14 00 00 00 02 00 00 00 09 00 00 00 00 00 00 00 00 00 00 00 00 00 02 00 14 14 00 00 14
 00 00 00 14 14 14 00 00 02 00 00 09 00 00 00 00 02 00 00 25 00 00 25 00 02 00 00 14 00 14 14 00
 14 00 00 14 00 14 00 00 00 02 00 00 00 18 40 02 00 02 40 00 18 00 00 02 00 00 00 00 00 00 00 00
 00 02 02 02 43 00 00 00 00 00 02 00 00 40 02 00 00 00 02 40 00 00 02 00 00 00 00 00 00 00 02 02
 00 00 02 02 02 00 00 14 00 14 00 02 00 02 00 00 00 00 00 02 40 02 14 14 00 00 14 00 00 02 02 02
 00 00 43 02 02 02 00 14 14 14 14 40 02 53 00 00 00 00 00 53 02 40 18 00 14 14 14 00 02 02 02 43
 00 00 02 02 02 02 02 14 14 18 40 02 00 04 03 03 00 03 03 03 00 02 40 14 00 14 14 02 02 02 02 02
 00 00 00 24 02 02 02 14 14 40 02 00 00 04 36 04 00 04 36 04 00 00 02 40 14 18 00 02 02 02 24 00
 00 00 44 02 02 02 02 14 40 02 00 00 00 04 03 03 00 03 03 03 00 00 00 02 40 00 14 02 02 02 02 44
 24 24 02 02 02 02 14 18 02 00 00 00 00 00 00 00 05 00 00 00 00 00 00 00 02 14 14 00 02 02 02 02
 02 02 02 02 02 14 14 00 40 02 00 00 00 03 03 04 00 03 03 03 00 00 00 02 40 18 00 00 14 02 02 02
 02 02 02 02 14 00 00 00 00 40 02 00 53 04 36 04 00 04 36 04 53 00 02 40 14 14 00 14 00 14 02 02
 02 02 02 14 00 00 00 00 00 18 40 02 02 03 03 03 00 03 03 03 02 02 40 18 00 14 00 00 00 00 14 02
 00 00 00 00 00 00 00 00 00 00 02 40 00 00 00 00 00 00 00 00 00 40 02 00 14 14 00 14 00 00 00 00
 00 00 00 00 00 00 00 00 00 00 00 02 00 03 03 03 03 03 03 03 00 02 14 00 14 00 00 00 00 00 00 00
 00 00 00 00 00 00 00 00 00 00 02 00 00 04 40 15 02 15 40 04 00 00 02 14 14 00 00 14 00 00 00 00
 00 00 00 00 00 00 00 00 00 02 00 02 00 04 15 02 15 02 15 04 00 02 00 02 14 00 00 00 14 00 00 00
 00 00 00 00 00 00 00 00 02 00 00 00 00 04 02 15 36 15 02 04 00 00 00 00 02 14 14 00 00 00 00 00
 00 00 00 00 00 00 00 02 00 00 00 02 00 04 15 02 15 02 15 04 00 02 00 00 00 02 00 00 00 00 00 00
 00 00 00 00 00 00 02 00 00 00 00 00 00 04 40 15 02 15 40 04 00 00 00 00 00 00 02 00 00 14 00 00
 00 00 00 00 00 02 00 00 00 00 00 00 00 04 03 03 03 03 03 04 00 00 00 00 00 00 00 02 00 00 00 00
 02 00 00 00 02 00 00 00 00 00 00 02 00 00 00 21 21 00 00 00 00 02 00 00 00 00 00 00 02 00 00 00
 43 02 00 02 00 00 00 00 00 00 00 00 00 00 21 21 21 21 00 00 00 00 00 00 00 00 00 00 00 02 00 02
 03 03 00 00 00 00 00 00 00 00 00 00 00 21 21 21 21 21 21 00 00 00 00 00 00 00 00 00 00 00 02 03
 36 04 00 00 00 00 00 00 00 00 00 00 21 21 21 21 21 21 21 21 00 00 00 00 00 00 00 00 00 00 00 04
 03 03 00 00 00 00 00 00 00 00 00 21 21 21 21 21 21 21 21 21 21 00 00 00 00 00 00 00 00 00 43 03
 02 02 02 02 02 02 02 02 02 02 02 02 02 02 02 02 02 02 02 02 02 02 02 02 02 02 02 02 02 02 02 02
