Gauntlet (rev 1 - 9)
Maze number: 66
Offset for maze 65: 236128 - 0x039a60
big endian buf: [%!l(uint8=0) %!l(uint8=3) %!l(uint8=154) %!l(uint8=96)]
G:1 Maze real addr: 244323 - 0x03BA63, bank 1, boff: 0x2000
Maze read from: 0x03ba63 - 244323
compresssed: 234
 02 32 00 00 80 11 40 59 A8 5A 6A DF 47 A0 64 05
 C5 28 A0 19 58 A4 19 A4 C2 A5 19 A3 19 45 42 A0
 19 C1 2C A4 19 42 A0 19 41 F2 19 06 19 76 6F 42
 AA C1 61 63 1A A4 1B D9 19 42 A1 63 A2 19 F6 55
 A1 19 42 B5 C3 65 A2 2A C2 B3 45 A4 1A 4C A3 19
 C3 65 19 C8 B4 19 80 45 A0 19 41 A0 19 7D 19 A1
 1A 45 A3 19 A3 19 C7 BA 19 41 80 A4 C2 2C 46 A1
 56 A0 C1 6F C7 BF 42 75 42 B2 19 C1 A3 1A 42 B5
 69 A2 19 A2 19 1B 44 A4 19 48 42 A0 19 40 A0 19
 49 C3 63 B5 19 C0 61 61 19 A0 19 70 D1 19 A3 1A
 43 A9 4B 41 A2 D3 63 19 C0 6B 19 A0 19 42 B4 D1
 B2 C1 A3 19 A4 19 CA A6 19 C1 61 1A A0 19 61 19
 C8 B4 19 1A 19 C2 06 40 A0 1A 6F 42 A8 19 AA D2
 19 40 D0 BC 19 D6 19 B4 2A C3 1B A9 C4 A9 1B CF
 28 1A 50 6C BE CD 28 B4 6D 00
  Encoded length: 234 bytes
  Wall pattern: 01, Wall color: 00     Floor pattern: 01, Floor color: 04
  Flags: PLAYER_OFFSCREEN 
  ╚══> while gauntlet has these elements, these flags probably do not operate
 02 02 02 02 02 02 02 02 02 02 02 02 02 02 02 02 02 02 02 02 02 02 02 02 02 02 02 02 02 02 02 02 02
 02 00 00 00 00 00 00 00 00 00 00 00 00 00 00 00 00 00 00 00 00 00 00 00 00 00 00 00 00 00 00 00 02
 02 00 00 00 00 00 00 00 25 02 40 00 00 00 00 00 05 00 00 00 00 00 00 40 02 25 00 00 00 00 00 00 02
 02 00 00 26 02 02 02 02 02 25 02 02 02 02 02 00 00 00 02 02 02 02 02 02 25 02 02 02 02 25 00 00 02
 02 00 00 02 25 00 00 00 25 02 25 00 00 44 02 02 02 02 02 25 00 00 00 25 02 25 00 00 25 02 00 00 02
 02 00 00 02 00 00 00 00 00 00 00 00 00 00 00 00 02 25 06 25 00 00 00 00 00 00 00 42 40 02 00 00 02
 02 00 00 02 00 00 00 00 00 00 00 00 00 00 00 00 25 02 02 02 02 02 02 02 02 02 02 02 00 02 40 00 02
 02 40 00 02 00 00 26 02 02 02 02 02 27 00 00 00 02 00 00 00 00 00 00 00 00 00 00 00 00 02 00 00 02
 02 00 00 02 00 00 02 25 00 00 00 25 02 02 40 00 02 00 00 02 02 02 25 00 00 00 00 00 00 02 00 00 02
 02 00 00 02 00 00 02 00 00 00 00 00 00 00 02 00 02 00 00 00 00 26 02 02 25 00 00 00 25 02 00 00 02
 02 00 40 02 00 00 02 00 00 02 02 02 42 00 00 00 02 00 00 00 00 00 00 25 02 02 02 02 02 26 00 00 02
 02 00 00 02 00 00 02 00 00 00 00 25 02 02 02 02 25 00 00 00 00 40 00 00 00 00 00 00 25 02 00 00 02
 02 00 00 02 00 00 02 25 25 00 00 00 00 00 00 25 02 25 00 00 25 02 25 00 00 00 00 00 00 02 00 00 02
 02 00 00 02 00 42 25 02 02 26 00 00 00 00 00 00 25 02 02 02 02 25 02 02 02 02 25 00 00 02 00 00 02
 02 00 00 02 25 00 02 25 25 02 02 02 02 02 00 00 02 44 00 00 00 00 00 00 00 25 02 02 00 02 00 00 02
 02 00 00 26 02 00 02 40 00 00 00 00 00 00 00 00 02 00 00 00 00 00 00 00 00 00 00 00 00 02 00 00 02
 02 00 00 02 25 00 02 00 00 00 00 42 00 00 00 25 02 25 00 00 02 02 02 02 26 00 00 00 25 02 40 00 02
 02 00 00 02 00 00 02 00 00 02 02 02 25 02 02 02 25 27 00 00 00 00 00 25 02 02 02 02 02 25 00 00 02
 02 00 00 02 00 00 02 25 00 00 00 25 02 25 00 25 02 25 00 00 00 00 00 00 00 00 00 00 25 02 00 00 02
 02 40 00 02 00 00 02 25 00 40 00 00 40 00 00 25 02 25 00 42 00 00 00 00 00 00 00 00 00 02 00 00 02
 02 00 00 02 00 00 25 02 02 02 02 26 00 00 00 00 25 02 02 02 02 02 02 02 02 02 02 00 00 02 00 00 02
 02 00 00 02 00 00 02 25 00 00 25 02 02 02 00 00 02 00 00 00 00 00 00 00 00 00 00 00 00 02 00 00 02
 02 00 40 02 00 00 02 25 00 40 00 00 00 00 00 00 02 00 00 00 00 00 25 02 25 00 00 00 25 02 00 00 02
 02 00 00 02 00 00 02 00 00 00 00 00 00 00 00 00 02 00 00 02 02 02 02 25 02 02 02 02 02 25 00 00 02
 02 00 00 02 00 00 02 00 00 02 02 02 02 02 02 02 25 00 00 40 00 00 26 02 25 40 00 00 25 02 00 00 02
 02 00 00 02 00 00 02 25 26 25 00 00 00 06 00 25 02 26 40 00 00 00 00 00 00 00 00 00 00 02 00 00 02
 02 00 00 02 00 00 25 02 02 02 02 02 02 02 02 02 25 02 02 02 02 02 02 02 02 02 02 02 00 02 00 00 02
 02 00 00 02 00 00 00 00 00 00 00 00 00 00 00 25 02 25 00 00 00 00 00 00 00 00 00 00 00 02 00 00 02
 02 00 00 02 25 00 00 00 00 00 00 00 00 00 00 00 02 00 00 00 00 00 00 00 00 00 00 00 25 02 42 00 02
 02 00 00 27 02 02 02 02 02 02 02 02 02 02 00 00 02 00 00 02 02 02 02 02 02 02 02 02 02 27 00 00 02
 02 00 00 00 00 00 00 00 00 00 00 00 00 00 40 26 02 26 40 00 00 00 00 00 00 00 00 00 00 00 00 00 02
 02 00 00 00 00 00 00 00 00 00 00 00 00 00 00 40 02 40 00 00 00 00 00 00 00 00 00 00 00 00 00 00 02
 02 02 02 02 02 02 02 02 02 02 02 02 02 02 02 02 02 02 02 02 02 02 02 02 02 02 02 02 02 02 02 02 02
