Gauntlet (rev 1 - 9)
Maze number: 49
Offset for maze 48: 233820 - 0x03915c
big endian buf: [%!l(uint8=0) %!l(uint8=3) %!l(uint8=145) %!l(uint8=92)]
G:1 Maze real addr: 242015 - 0x03B15F, bank 1, boff: 0x2000
Maze read from: 0x03b15f - 242015
compresssed: 232
 00 00 00 00 00 21 28 0B 5E 04 68 2A 80 35 71 C4
 43 E0 7C 35 62 70 80 73 42 64 71 70 C1 1D 70 80
 C0 2A 66 C0 40 28 41 C0 51 CF A3 03 80 AF A5 63
 CC 2C C0 2A D3 1B CA 1B 46 1B C0 51 C1 1C 6C C0
 35 4A CD A7 41 A5 41 72 81 C7 2C 35 C3 2A B5 C5
 35 42 C3 1C 69 6A C1 41 D4 51 C7 41 71 80 CD A1
 03 81 A2 C3 41 C1 1C D4 35 C3 B5 41 6A C4 B2 C6
 B2 C2 41 C3 1B D8 41 C0 2B C3 BF C3 03 80 A2 03
 81 C2 05 C3 03 80 A5 03 A2 C7 2A C1 52 C6 52 C1
 2A C2 35 C2 06 C5 1B DC BF C7 35 CB 1B D0 B2 A1
 03 81 A1 B2 CC BF DF 66 C4 51 64 C4 BF CA BF 2C
 35 C3 2A C5 35 2C E3 19 C5 B4 C2 AF B8 E2 D1 35
 B2 C7 1B C9 51 C0 1B D4 51 E6 67 C1 51 60 E8 35
 C3 B6 AF AA BC C3 2B 75 60 78 61 7B 72 73 75 C8
 BE 61 71 60 75 61 6B 00
  Encoded length: 232 bytes
  Wall pattern: 01, Wall color: 08     Floor pattern: 02, Floor color: 02
  Flags: 
 02 02 02 02 02 02 02 02 02 02 02 02 02 02 02 02 02 02 02 02 02 02 02 02 02 02 02 02 02 02 02 02 02
 02 42 53 00 00 40 00 00 00 00 00 11 11 11 11 00 02 00 00 00 00 00 00 00 00 00 00 00 00 00 40 53 02
 02 00 00 30 00 40 40 00 00 00 00 40 11 11 11 00 04 00 00 00 30 00 00 40 00 40 00 00 29 00 40 40 02
 02 42 00 00 00 00 00 00 00 30 00 11 40 11 11 00 04 00 00 00 00 00 00 00 00 00 00 00 00 00 00 00 02
 02 02 02 02 02 03 03 02 02 02 02 02 02 02 02 02 02 02 02 02 02 02 02 02 02 02 02 02 02 00 00 00 02
 02 30 00 00 02 00 00 00 00 00 00 00 00 00 00 44 02 42 00 00 00 00 00 00 00 00 00 00 04 00 00 00 02
 02 00 02 00 02 00 27 00 00 00 00 00 00 00 00 00 02 00 27 11 11 11 11 11 11 11 27 00 04 00 00 28 02
 02 00 02 00 02 00 00 00 00 00 00 00 00 30 00 53 02 11 11 11 11 11 11 11 11 11 11 00 02 00 00 00 02
 02 00 02 00 02 00 00 00 02 02 02 02 02 02 02 02 02 11 11 02 02 02 02 02 02 11 11 00 02 00 40 40 02
 02 00 02 00 02 00 00 00 02 44 53 00 00 00 00 42 02 00 00 00 00 00 00 53 02 11 11 00 02 00 00 28 02
 02 00 02 00 02 00 00 00 02 00 30 00 00 00 00 00 04 00 00 00 00 00 30 00 02 11 11 00 02 00 00 00 02
 02 00 02 00 02 00 00 00 02 00 00 00 00 00 00 00 04 00 00 00 00 00 00 00 02 11 11 00 02 40 40 00 02
 02 00 02 00 02 00 00 00 02 00 00 00 02 02 02 03 03 03 02 02 02 00 00 00 02 11 11 00 02 28 00 00 02
 02 00 02 00 02 00 00 00 02 00 00 00 02 00 00 00 00 00 00 53 02 00 00 00 02 11 11 00 02 00 00 00 02
 02 00 02 00 02 00 30 00 02 00 00 00 02 00 00 00 00 00 00 00 02 00 00 00 11 11 00 00 02 00 27 00 02
 02 00 02 00 02 00 00 00 02 00 00 00 04 00 00 00 00 00 00 00 04 00 00 00 11 11 00 43 02 00 00 00 02
 02 00 02 00 02 03 03 02 02 02 03 03 04 00 00 00 05 00 00 00 04 03 03 02 02 02 02 02 02 03 02 02 02
 02 00 02 00 02 00 00 00 02 42 00 00 04 00 00 00 00 00 00 00 04 00 00 42 02 00 00 53 02 00 02 06 02
 02 00 02 00 02 00 27 00 02 00 00 00 02 00 00 00 00 00 00 00 02 00 00 00 02 00 00 00 02 00 02 00 02
 02 00 02 00 02 00 00 00 02 00 00 00 02 53 00 00 00 00 00 00 02 00 00 00 02 00 27 00 02 00 02 00 02
 02 00 02 00 02 00 00 00 02 00 00 00 02 02 02 03 03 03 02 02 02 00 00 00 02 00 00 00 02 00 02 00 02
 02 00 02 00 02 00 00 00 02 00 00 00 00 00 00 00 04 00 00 00 00 00 00 00 02 00 00 00 02 00 02 00 02
 02 00 02 00 02 00 00 00 02 00 30 00 00 00 00 00 04 00 00 00 00 00 30 00 02 00 00 00 02 00 02 00 02
 02 00 02 00 02 00 00 00 02 44 53 00 00 00 00 42 02 00 00 00 00 00 53 44 02 00 00 00 02 25 02 00 02
 02 00 02 00 02 00 00 00 02 02 02 02 02 02 02 02 02 02 02 02 02 02 02 02 02 00 00 00 02 00 02 00 02
 02 00 02 00 04 00 00 00 00 00 00 00 00 00 00 53 02 00 00 00 00 00 00 00 00 27 00 00 04 00 02 00 02
 02 00 02 00 04 00 27 00 00 00 00 00 00 00 00 00 04 00 00 00 00 00 00 00 00 00 00 00 04 00 02 00 02
 02 00 02 00 02 00 00 00 00 00 00 00 00 30 00 00 04 00 30 00 00 00 00 00 00 00 00 00 02 53 02 00 02
 02 00 02 02 02 02 02 02 02 02 02 02 02 02 02 02 02 02 02 02 02 02 02 02 02 02 02 02 02 02 02 00 02
 02 00 00 43 00 00 00 00 00 00 40 00 30 00 00 00 00 00 00 00 00 00 40 00 00 30 00 00 00 00 00 00 02
 02 00 00 00 00 00 40 00 00 00 40 00 00 00 00 40 00 00 00 00 00 00 40 00 00 00 00 00 00 00 00 00 02
 02 00 00 30 00 00 40 00 30 00 00 00 00 00 00 40 00 00 30 00 00 00 00 00 00 00 00 00 00 00 00 30 02
 02 02 02 02 02 02 02 02 02 02 02 02 02 02 02 02 02 02 02 02 02 02 02 02 02 02 02 02 02 02 02 02 02
