Gauntlet (rev 1 - 9)
Maze number: 28
Offset for maze 27: 236847 - 0x039d2f
big endian buf: [%!l(uint8=0) %!l(uint8=3) %!l(uint8=157) %!l(uint8=47)]
G:1 Maze real addr: 236850 - 0x039D32, bank 0, boff: 0x0000
Maze read from: 0x039d32 - 236850
compresssed: 265
 0A 34 07 1A 00 02 9C 0C 68 0B 5B 45 C4 2C 0B 82
 62 0B 81 C4 0B 81 28 C2 AF AB 28 C4 44 28 1C 40
 64 0B 63 63 60 C4 44 A8 D1 1C 42 1C 7B EF 7E CE
 1C 60 E8 EE C2 A3 77 A0 67 80 54 C5 B2 1C B2 28
 45 73 A0 CF 1C A0 1C C0 B6 44 72 A0 D4 04 44 E2
 6E E5 44 C2 2B 51 52 52 52 52 52 C2 2B C4 AA 0B
 54 C2 A1 03 81 A6 C3 44 C8 0F BA C0 0F 67 C4 41
 06 41 E8 0F A0 CB BF 61 43 E7 0F 23 0F A0 CC BF
 AC 12 A0 0F A0 C9 BF 63 60 66 A0 22 80 12 DB 35
 2A 22 A0 D0 28 E9 35 A0 12 C0 0F 80 F9 12 80 C0
 0F 80 DA 2A 1E C0 20 6E CC 2A C0 0F A0 C5 52 C1
 B5 C3 A3 EB 20 A0 74 C1 04 C3 0A 82 CD 20 A0 E6
 C3 0A 84 C8 B8 C0 20 A0 C4 51 A4 C1 0A 80 19 0A
 81 E7 0F A0 76 80 56 04 C2 BA 0A 84 E6 0F 24 0F
 A0 C5 0B 60 A0 52 C2 2A 0A 82 60 62 61 A0 0F A0
 74 0B 1B 58 28 04 28 63 A2 B4 A7 E0 C0 AA 28 BE
 05 D5 0B C0 0B 81 60 80 00
  Encoded length: 265 bytes
  Wall pattern: 02, Wall color: 12     Floor pattern: 00, Floor color: 09
  Flags: 
 02 02 02 02 02 02 02 02 02 02 02 02 02 02 02 02 02 02 02 02 02 02 02 02 02 02 02 02 02 02 02 02 02
 02 12 12 12 12 12 00 00 00 00 00 44 11 11 11 11 00 00 00 40 11 11 11 00 00 00 00 00 11 11 11 40 02
 02 00 02 02 02 02 02 02 02 02 02 02 02 02 02 02 02 02 02 02 02 02 02 02 02 02 02 02 02 02 02 40 02
 02 00 02 00 00 12 12 12 12 12 40 28 12 00 00 00 00 00 40 11 00 00 00 00 40 00 00 00 00 40 02 40 02
 02 00 02 00 00 12 12 12 12 12 02 02 02 02 02 02 02 02 02 00 00 00 00 00 00 00 00 00 00 00 02 11 02
 02 00 02 00 00 28 12 12 12 28 02 00 00 00 00 00 00 00 02 00 00 00 27 00 00 00 00 00 00 00 02 11 02
 02 00 02 00 00 00 00 02 00 00 02 00 00 00 00 00 00 00 02 00 00 00 00 27 00 00 00 00 00 00 02 11 02
 02 00 02 00 00 00 02 28 02 40 02 00 00 00 00 00 00 00 02 02 00 00 00 00 00 00 00 00 00 00 02 11 02
 02 00 02 02 00 00 02 02 02 02 02 00 00 00 00 00 00 00 02 27 02 00 00 00 00 00 00 00 00 40 02 11 02
 02 00 02 00 00 00 02 28 02 40 02 12 12 12 12 11 00 00 02 00 27 02 00 00 00 00 00 00 00 00 02 00 02
 02 00 02 00 00 00 28 02 28 00 02 12 12 12 12 11 00 00 02 27 02 11 11 11 11 11 00 00 00 00 02 00 02
 02 00 02 00 00 00 00 00 00 00 04 12 12 12 12 11 00 00 02 02 11 11 11 11 11 11 00 00 00 00 02 00 02
 02 00 02 40 00 00 00 00 00 00 02 12 12 12 12 11 00 00 02 43 11 11 11 11 11 11 00 00 00 43 02 00 02
 02 00 02 02 02 02 02 02 02 02 02 02 02 02 11 11 00 00 02 02 02 03 03 03 02 02 02 02 02 02 02 00 02
 02 00 02 12 12 12 12 12 00 00 00 00 00 00 00 00 00 15 02 00 15 00 00 00 00 00 00 00 00 40 02 00 02
 02 00 02 12 12 06 12 12 00 00 00 00 00 00 00 00 00 02 15 02 00 00 00 00 00 00 00 00 00 00 02 00 02
 02 00 02 40 12 12 12 12 00 00 00 00 00 00 00 00 02 15 35 15 02 00 00 00 00 00 00 00 00 00 02 00 02
 02 00 02 02 02 02 02 02 02 02 02 02 02 02 02 02 18 02 15 02 00 00 00 00 00 00 00 00 00 00 02 00 02
 02 00 02 40 00 40 00 00 00 00 00 00 00 40 02 34 34 18 02 00 00 00 00 00 00 00 00 00 00 00 02 00 02
 02 00 02 00 00 00 00 00 00 00 00 00 00 00 53 42 34 02 02 00 00 00 00 00 00 00 00 00 00 00 02 00 02
 02 00 02 40 00 00 00 00 00 00 00 00 00 00 02 53 02 18 02 15 15 00 00 00 00 00 00 00 00 00 02 00 02
 02 00 02 00 00 00 00 00 00 00 00 00 00 00 00 02 18 18 02 15 15 00 00 00 00 00 00 11 11 11 02 00 02
 02 00 02 00 00 00 00 00 00 00 00 00 00 00 00 00 42 30 02 32 00 00 00 00 00 00 00 11 11 11 02 00 02
 02 00 02 40 00 00 00 00 00 00 00 00 00 00 00 00 00 42 02 15 02 00 00 00 00 00 00 11 11 11 02 00 02
 02 00 02 02 02 02 02 00 00 00 00 00 00 00 00 00 00 00 02 02 32 02 00 00 00 00 00 27 11 11 04 00 02
 02 00 02 10 10 10 10 00 00 00 00 00 00 00 00 00 00 00 02 00 00 32 02 00 00 00 00 11 11 11 02 00 02
 02 00 02 10 10 10 10 10 02 00 00 00 00 00 00 00 00 00 02 00 32 02 00 00 00 00 00 11 11 11 02 11 02
 02 00 02 10 10 25 10 10 02 00 00 00 00 00 00 00 00 02 15 02 00 00 00 00 00 00 00 27 11 11 04 11 02
 02 00 02 10 10 10 10 10 02 00 00 00 00 00 00 00 02 15 36 15 02 00 00 00 00 00 00 11 11 40 02 11 02
 02 00 00 42 10 10 10 10 02 40 00 00 00 40 00 00 40 02 15 02 00 00 00 00 00 27 11 27 11 40 04 40 02
 02 00 00 00 40 02 02 02 02 02 02 02 02 02 02 02 02 00 02 00 02 02 02 02 02 02 02 02 02 02 02 40 02
 02 05 00 00 00 00 00 00 00 00 00 00 00 00 00 00 00 00 00 00 00 00 00 00 11 00 11 11 11 00 40 40 02
 02 02 02 02 02 02 02 02 02 02 02 02 02 02 02 02 02 02 02 02 02 02 02 02 02 02 02 02 02 02 02 02 02
