Gauntlet (rev 1 - 9)
Maze number: 8
Offset for maze 7: 230869 - 0x0385d5
big endian buf: [%!l(uint8=0) %!l(uint8=3) %!l(uint8=133) %!l(uint8=213)]
G:1 Maze real addr: 230872 - 0x0385D8, bank 0, boff: 0x0000
Maze read from: 0x0385d8 - 230872
compresssed: 187
 07 37 00 00 08 00 98 D1 5D 04 68 76 A0 06 7B A0
 2A 3A 81 C6 18 E4 21 CC A4 CC 43 CD A1 1D A1 1D
 C1 53 C7 48 E6 C1 A2 CE 2A E1 11 7A A3 CE 41 C4
 14 C7 A8 E7 11 F5 C7 A2 F4 C9 A2 D2 A2 26 66 80
 A6 2A CD A5 C8 1C A6 60 EC 7A C2 A6 C9 A5 CF 44
 C8 1F A1 D2 42 C8 A5 C3 05 CA 42 40 C8 11 A0 F1
 E0 11 C8 11 AD C6 41 63 F0 C7 A5 D1 A1 6A A8 28
 62 80 C4 A3 D0 A5 C2 14 C3 11 A0 72 D0 1F A2 C5
 11 AB CB 20 A0 CA 14 C5 A1 E0 C8 20 A4 EE 3B A5
 C7 26 A9 C2 1A C0 39 81 E3 D0 19 1A A2 CA 3B A3
 CE 2A A4 C4 B2 A1 28 C1 A5 CD 2C A2 C8 2A A0 35
 C3 1A CA 18 C0 3B A0 C4 1A C2 00
  Encoded length: 187 bytes
  Wall pattern: 00, Wall color: 08     Floor pattern: 00, Floor color: 09
  Flags: 
 02 02 02 02 02 02 02 02 02 02 02 02 02 02 02 02 02 02 02 02 02 02 02 02 02 02 02 02 02 02 02 02
 00 00 00 00 00 04 00 40 02 06 00 00 00 00 00 00 00 00 00 00 00 00 40 02 42 58 58 58 00 00 00 00
 00 00 00 24 00 04 00 00 00 02 33 00 00 00 00 00 00 00 00 00 00 00 00 00 02 02 02 02 02 00 00 00
 00 00 00 00 00 04 00 00 00 00 02 02 02 02 17 00 00 00 00 00 00 00 00 00 00 00 00 00 00 02 02 29
 02 02 29 00 00 04 00 00 00 00 00 00 00 00 02 02 02 02 02 02 02 02 02 17 00 00 00 00 00 00 00 02
 00 00 02 02 02 00 00 00 00 00 00 00 00 00 00 00 00 00 00 00 42 00 00 02 17 00 00 00 00 00 00 00
 00 00 00 00 40 02 02 02 02 00 00 00 00 00 00 00 00 00 00 00 00 00 00 00 02 02 17 00 00 00 00 00
 20 00 00 00 00 00 00 00 00 02 02 02 02 02 02 02 02 02 00 00 00 00 00 00 00 00 02 17 00 00 00 00
 00 00 00 00 00 00 00 00 00 00 00 00 00 00 00 00 00 00 02 00 00 00 00 00 00 00 00 02 02 02 00 00
 00 00 00 00 00 00 00 00 00 00 00 00 00 00 00 00 00 00 00 02 00 00 00 00 00 00 00 00 00 00 02 02
 02 00 00 00 00 00 00 00 00 00 00 00 00 00 00 00 00 00 00 00 02 02 02 38 00 00 00 00 00 00 00 29
 29 02 02 02 02 02 02 02 42 00 00 00 00 00 00 00 00 00 00 00 00 00 00 02 02 02 02 02 02 00 00 00
 00 00 00 00 00 00 28 02 02 02 02 02 02 02 00 29 00 00 00 00 00 00 00 00 00 00 00 00 00 02 00 00
 00 00 00 00 00 00 00 00 00 40 00 00 00 02 02 02 02 02 02 02 00 00 00 00 00 00 00 00 00 00 02 02
 02 02 02 02 00 00 00 00 00 00 00 00 00 00 00 00 00 00 00 00 02 02 02 02 02 17 00 00 00 00 00 00
 00 00 00 31 02 02 00 00 00 00 00 00 00 00 00 00 00 00 00 00 00 00 00 00 00 02 02 02 17 00 00 00
 00 00 00 00 00 00 02 02 02 02 02 02 00 00 00 00 05 00 00 00 00 00 00 00 00 00 00 00 02 02 02 17
 02 17 00 00 00 00 00 00 00 00 00 17 02 00 00 00 00 00 00 00 00 00 00 00 00 00 00 00 00 00 00 02
 00 02 17 00 00 00 00 00 00 00 00 00 17 02 02 02 02 02 02 02 02 02 02 02 02 02 02 00 00 00 00 00
 00 00 02 02 17 00 00 00 00 29 00 00 00 00 00 00 00 00 00 00 00 00 00 00 00 00 00 02 00 00 00 00
 00 00 00 00 02 02 02 02 02 02 00 00 00 00 00 00 00 00 00 00 00 00 00 00 00 00 00 00 02 02 00 00
 00 00 00 00 00 00 00 00 00 29 02 02 02 02 02 02 02 02 02 40 00 00 00 29 29 00 00 00 00 00 02 02
 02 02 00 00 00 00 00 00 00 00 00 00 00 00 00 00 00 00 00 02 02 02 02 02 02 00 00 00 20 00 00 00
 00 17 02 00 00 00 40 00 00 00 00 00 00 00 00 00 00 00 00 00 00 00 00 00 31 02 02 02 00 00 00 00
 00 00 17 02 02 02 02 02 02 02 02 02 02 02 02 00 00 00 00 00 00 00 00 00 00 00 00 32 02 00 00 00
 00 00 00 00 00 00 00 00 20 00 00 00 00 00 00 02 02 00 02 00 00 00 00 00 00 00 00 00 32 02 02 02
 02 02 00 00 00 00 00 00 00 00 00 00 00 00 00 00 00 02 59 02 02 02 02 02 02 00 00 00 00 00 00 00
 00 38 02 02 02 02 02 02 02 02 02 02 00 00 00 26 00 57 57 57 00 00 00 00 02 02 00 00 00 00 00 00
 00 00 00 00 00 00 00 00 00 00 25 26 02 02 02 00 00 00 00 00 00 00 00 00 00 02 59 02 02 02 02 00
 00 00 00 00 00 00 00 00 00 00 00 00 00 00 42 02 02 02 02 02 00 00 00 00 00 02 02 02 40 00 00 02
 02 02 02 02 02 00 00 00 00 00 00 00 00 00 00 00 00 00 00 44 02 02 02 00 00 00 00 00 00 00 00 00
 42 02 53 00 00 00 00 26 00 00 00 00 00 00 00 00 00 00 00 24 00 59 02 00 00 00 00 00 26 00 00 00
 02 02 02 02 02 02 02 02 02 02 02 02 02 02 02 02 02 02 02 02 02 02 02 02 02 02 02 02 02 02 02 02
