Gauntlet (rev 1 - 9)
Maze number: 48
Offset for maze 47: 233405 - 0x038fbd
big endian buf: [%!l(uint8=0) %!l(uint8=3) %!l(uint8=143) %!l(uint8=189)]
G:1 Maze real addr: 241600 - 0x03AFC0, bank 1, boff: 0x2000
Maze read from: 0x03afc0 - 241600
compresssed: 412
 0D 2F 00 02 81 30 18 C3 68 04 75 35 80 63 E0 C2
 A1 60 E4 E2 28 73 C2 03 A0 E0 C0 19 E0 C3 A1 C0
 A1 C0 20 2A A0 E2 03 80 A0 C2 51 1B E1 E0 C0 A1
 E0 03 A0 C0 1A E0 03 A0 E2 E0 2C 25 A0 E2 E0 C2
 04 E7 E2 E0 03 EB C0 A2 E0 03 A0 E0 E0 03 C5 51
 A0 C0 A1 C0 A1 28 A1 F0 E0 E0 1F 63 C0 2A E4 E0
 E0 E0 E0 E0 C0 52 C0 04 E0 C2 2A A0 E0 E1 E0 03
 C9 04 E2 E0 C2 A1 C9 B2 E0 E4 E0 E0 E4 C5 51 C1
 1A A1 C5 05 C5 04 19 A0 E0 25 A0 E0 E0 E1 E7 E4
 E0 E0 C2 04 C4 25 E4 E0 03 C9 04 E2 E0 E0 28 A0
 C0 41 A0 C5 B2 E0 E0 E0 E0 E0 E0 C0 04 E2 C4 18
 C3 A1 EE E0 C2 A1 E2 E5 E0 03 C2 03 A0 E0 E0 E4
 C7 BF A0 E0 E2 C2 51 E4 03 A0 C0 51 E0 E0 1F 80
 58 E7 C2 52 E0 E0 03 51 E4 E2 C3 52 E2 1A A1 E0
 03 80 C5 1B A0 E0 E2 C4 A1 C2 04 E4 E0 E0 E1 03
 A0 E2 03 83 53 62 E1 E2 E2 03 A1 E0 61 C3 18 2A
 E0 28 E2 C3 52 E0 C1 1D 61 A0 E2 03 52 A0 C0 51
 03 A0 E2 E3 C0 A1 C3 03 80 A0 E2 E9 C1 B2 A0 C4
 1E 2A A0 C0 B2 E3 E2 E0 03 85 A0 E5 E0 E0 C2 A1
 C2 51 63 E5 C0 A1 E8 E0 E1 E0 C0 51 03 80 A0 03
 80 A0 E0 C2 04 C5 A1 E0 C1 1C A0 C0 04 1D C9 04
 E0 E0 C0 A1 28 52 E6 04 C0 03 81 A0 E0 C0 52 C0
 A1 E0 E0 72 A3 C0 A1 E3 C5 04 E0 C1 18 C4 03 82
 C3 1C A0 C0 53 A0 E2 E0 C0 A1 C2 51 E0 03 A0 C7
 03 A0 2A E1 E1 E0 E4 C0 A1 61 A0 C4 BE 35 51 28
 E1 E2 1E C2 51 E0 E5 71 53 C1 06 00
  Encoded length: 412 bytes
  Wall pattern: 00, Wall color: 08     Floor pattern: 03, Floor color: 01
  Flags: SHOTS_STUN PLAYER_OFFSCREEN 
  ╚══> while gauntlet has these elements, these flags probably do not operate
 02 02 02 02 02 02 02 02 02 02 02 02 02 02 02 02 02 02 02 02 02 02 02 02 02 02 02 02 02 02 02 02 02
 02 53 00 00 00 00 40 00 02 00 00 00 02 02 00 40 00 00 00 00 00 02 00 00 00 02 40 00 00 00 00 53 02
 02 00 04 03 02 00 02 00 25 00 02 00 00 00 00 02 02 00 02 02 00 32 42 02 00 00 00 02 03 03 02 00 02
 02 00 04 27 00 00 02 00 02 00 02 02 00 02 03 02 00 26 00 02 03 02 00 00 00 02 00 02 44 37 02 00 02
 02 00 02 00 02 00 00 00 04 00 00 00 00 00 00 00 00 02 00 00 00 02 00 02 03 04 00 00 00 00 00 00 02
 02 00 00 00 00 02 00 02 02 02 00 02 03 02 00 02 00 02 03 04 00 00 00 00 00 04 02 00 02 02 00 02 02
 02 40 02 02 00 00 00 00 00 00 00 00 00 00 00 00 00 00 00 04 00 02 00 02 00 02 31 00 00 00 00 40 02
 02 42 00 00 00 02 00 02 00 02 00 02 00 02 00 02 00 02 00 04 00 04 00 02 00 00 00 42 02 00 02 00 02
 02 02 00 02 03 02 00 00 00 00 00 00 00 00 00 04 00 00 00 02 00 02 00 00 00 02 02 00 04 00 04 00 02
 02 00 00 00 00 02 00 02 00 00 00 00 00 02 00 02 00 02 00 00 00 00 00 02 00 00 00 00 04 00 04 00 02
 02 26 02 02 00 00 00 00 00 00 05 00 00 00 00 00 00 04 25 02 00 02 37 02 00 02 00 02 04 00 02 00 02
 02 00 00 00 00 02 00 02 00 00 00 00 00 02 00 02 00 02 00 00 00 04 00 00 00 00 00 37 04 00 00 00 02
 02 02 00 02 03 02 00 00 00 00 00 00 00 00 00 04 00 00 00 02 00 02 00 02 40 02 00 02 04 03 02 00 02
 02 00 00 00 00 02 00 02 00 02 00 02 00 02 00 02 00 02 00 04 00 00 00 02 00 00 00 00 04 24 00 00 02
 02 00 02 02 00 00 00 00 00 00 00 00 00 00 00 00 00 00 00 02 00 02 00 00 00 02 02 00 04 00 02 00 02
 02 00 00 00 00 02 00 02 03 04 00 04 03 02 00 02 00 02 00 00 00 04 00 02 00 00 00 00 04 00 04 00 02
 02 02 00 02 00 00 00 02 00 04 00 04 00 00 00 04 00 02 03 02 00 04 00 02 00 02 31 04 04 00 04 00 02
 02 00 00 00 00 02 00 00 00 04 00 02 00 02 03 04 00 00 00 00 00 02 00 00 00 02 00 04 00 00 04 00 02
 02 00 02 26 02 02 00 02 03 03 00 00 00 00 00 00 27 02 00 02 00 00 00 02 00 00 00 04 00 02 02 00 02
 02 00 04 00 04 00 00 00 02 00 02 00 02 00 00 02 03 02 00 04 00 02 03 03 03 03 03 04 00 00 00 40 02
 02 00 02 00 04 00 02 00 00 00 02 03 02 02 00 02 00 00 40 04 00 00 04 24 42 00 02 40 00 02 00 02 02
 02 00 00 00 04 00 02 00 02 29 00 00 40 02 00 00 00 02 03 04 02 00 04 03 02 00 00 00 02 02 00 00 02
 02 02 00 02 02 00 00 00 02 03 03 02 00 00 00 02 00 00 00 00 00 00 00 00 00 00 02 00 00 02 02 00 02
 02 00 00 00 30 42 02 00 02 00 00 00 00 02 00 04 00 02 00 02 03 03 03 03 03 03 03 02 00 00 00 00 02
 02 00 02 00 02 00 02 00 00 00 02 02 00 00 00 04 00 04 00 00 40 00 00 00 00 00 00 02 00 02 02 00 02
 02 00 04 00 00 00 00 00 02 00 02 00 00 02 00 02 00 04 03 03 04 03 03 02 00 02 00 00 00 04 00 00 02
 02 00 04 00 02 02 00 02 04 00 28 02 00 04 29 00 00 00 00 00 04 00 00 00 00 04 00 02 00 02 00 02 02
 02 40 04 00 00 00 00 00 04 00 02 04 00 03 03 03 02 00 02 00 04 00 02 02 00 02 00 02 00 00 00 53 02
 02 02 02 02 00 02 02 00 04 00 00 02 00 00 00 00 00 00 04 00 02 00 04 24 00 00 00 00 04 03 03 03 02
 02 00 00 00 00 28 02 00 04 02 00 00 00 02 00 02 00 02 02 00 00 00 04 00 02 03 02 00 04 00 00 00 02
 02 00 04 03 02 42 00 00 02 00 00 02 00 02 00 04 00 00 00 02 00 02 02 00 00 40 02 00 04 00 00 00 02
 02 53 04 40 00 00 02 00 00 00 02 30 00 00 00 04 00 02 00 00 00 00 00 00 02 00 00 53 04 00 00 06 02
 02 02 02 02 02 02 02 02 02 02 02 02 02 02 02 02 02 02 02 02 02 02 02 02 02 02 02 02 02 02 02 02 02
