Gauntlet (rev 1 - 9)
Maze number: 39
Offset for maze 38: 230896 - 0x0385f0
big endian buf: [%!l(uint8=0) %!l(uint8=3) %!l(uint8=133) %!l(uint8=240)]
G:1 Maze real addr: 239091 - 0x03A5F3, bank 1, boff: 0x2000
Maze read from: 0x03a5f3 - 239091
compresssed: 331
 13 33 07 17 09 02 EC 0B 51 28 60 D8 18 C3 28 E0
 C6 51 C6 2A C1 18 C0 A7 06 A1 C6 19 A9 03 A2 C9
 A7 40 D0 A5 C1 2A C1 2A 40 C0 41 CB A4 C1 28 C1
 AF A6 C2 28 80 51 C0 1B A0 19 A0 E4 19 C4 19 E0
 19 E1 19 C2 51 A4 E0 E2 E2 E2 19 E2 E2 C1 A2 C6
 19 A0 1B E7 C8 A2 C5 AF A7 35 E6 C0 1B C1 1B C0
 1B 28 41 C0 40 C1 42 28 C1 28 2A 28 C0 52 E4 40
 C0 28 43 C3 28 C0 1B AC 03 A3 40 C0 41 C1 28 C1
 28 1B A3 C2 42 C7 1B C1 28 35 C0 1B C0 1B A5 12
 81 C1 44 C0 A3 C3 1B A6 2A C7 A2 41 E0 C0 27 E1
 52 E1 12 81 C9 A3 27 80 A3 C3 A4 CE 28 17 C0 28
 C0 17 C0 28 C0 27 C0 17 CC 12 81 2A C0 27 C5 17
 C2 17 C0 17 C8 2A A6 B3 C4 28 C0 17 C0 27 51 17
 C0 17 52 C3 A5 28 84 C1 53 28 C0 53 C0 53 C0 53
 28 A5 03 A1 C5 A1 17 82 27 C1 27 C2 A3 46 C8 17
 80 A5 17 80 27 C0 28 C2 46 C1 A9 C3 A3 B2 C3 40
 A7 D3 A4 28 81 C4 A5 C5 1C A6 28 81 73 60 C1 35
 C8 A3 28 81 11 74 60 80 60 82 C9 35 62 82 72 74
 11 C5 05 E1 03 A0 B2 63 80 20 11 74 11 81 61 C6
 B4 67 82 71 75 11 C7 04 67 82 74 11 81 C2 56 B6
 35 C3 04 67 20 72 C0 28 87 35 00
  Encoded length: 331 bytes
  Wall pattern: 02, Wall color: 12     Floor pattern: 00, Floor color: 14
  Flags: SHOTS_STUN 
  ╚══> while gauntlet has these elements, these flags probably do not operate
 02 02 02 02 02 02 02 02 02 02 02 02 02 02 02 02 02 02 02 02 02 02 02 02 02 02 02 02 02 02 02 02
 00 00 00 00 00 00 00 00 40 00 00 00 00 00 00 00 00 00 00 00 00 00 00 00 00 24 00 00 00 00 40 00
 02 00 00 00 00 00 00 00 40 00 00 00 00 00 00 00 42 00 00 24 00 02 02 02 02 02 02 02 02 06 02 02
 00 00 00 00 00 00 00 25 02 02 02 02 02 02 02 02 02 02 03 02 02 02 00 00 00 00 00 00 00 00 00 00
 02 02 02 02 02 02 02 02 11 00 00 00 00 00 00 00 00 00 00 00 00 00 00 00 00 00 02 02 02 02 02 02
 00 00 42 00 00 42 11 00 11 11 00 00 00 00 00 00 00 00 00 00 00 00 02 02 02 02 02 00 40 40 00 00
 02 02 02 02 02 02 02 02 02 02 02 02 02 02 02 02 02 02 02 02 02 02 02 00 00 40 40 40 40 00 27 02
 25 02 00 00 00 00 00 02 25 00 00 00 00 00 25 00 02 25 00 00 02 25 00 00 00 40 02 02 02 02 02 00
 02 00 00 00 02 00 00 00 02 00 00 00 02 25 00 00 00 02 00 00 00 02 00 00 02 02 02 00 00 00 00 00
 00 00 25 02 27 00 00 00 00 00 00 00 00 02 00 00 00 00 00 00 00 00 00 02 02 40 00 00 00 00 00 00
 02 02 02 02 02 02 02 02 02 02 02 02 02 02 02 02 02 02 02 02 02 02 02 02 53 40 00 00 00 00 00 00
 02 00 27 00 00 27 00 27 40 11 11 00 11 00 00 11 11 11 40 00 00 40 42 40 00 40 00 00 00 00 00 02
 11 00 40 11 11 11 11 00 00 00 00 40 00 27 02 02 02 02 02 02 02 02 02 02 02 02 02 03 02 02 02 02
 11 00 11 11 00 00 40 00 00 40 27 02 02 02 02 00 00 00 11 11 11 00 00 00 00 00 00 00 40 27 00 00
 40 53 00 27 00 27 02 02 02 02 02 02 18 18 18 00 00 11 11 11 11 11 00 02 02 02 02 00 40 00 00 27
 02 02 02 02 02 02 02 42 00 00 00 00 00 00 00 00 02 02 02 11 11 00 02 00 39 00 00 02 40 00 00 02
 18 18 18 00 00 00 00 00 00 00 00 00 02 02 02 02 02 39 39 02 02 02 02 00 00 00 00 02 02 02 02 02
 00 00 00 00 00 00 00 00 00 00 00 00 02 00 40 40 23 40 40 40 23 40 40 00 39 00 23 40 00 00 00 00
 00 00 00 00 00 00 00 00 18 18 18 42 02 39 40 00 00 40 00 40 23 40 00 40 23 00 23 40 00 00 00 00
 00 00 00 00 42 02 02 02 02 02 02 02 02 00 40 00 00 40 40 40 23 40 39 40 23 00 23 40 00 00 00 00
 02 02 02 02 02 02 40 40 40 40 40 40 00 00 40 40 00 40 00 40 00 40 40 02 02 02 02 02 02 03 02 02
 00 00 00 00 00 00 02 02 23 23 23 23 39 00 00 39 00 00 02 02 02 02 02 11 11 11 11 11 11 11 00 00
 00 00 00 00 00 00 00 23 23 02 02 02 02 02 02 23 23 39 02 40 00 00 00 11 11 11 11 11 11 11 00 00
 02 02 02 02 02 02 02 02 02 02 00 00 00 00 02 02 02 02 02 00 00 00 00 11 02 02 02 02 02 02 02 02
 00 00 00 00 00 00 00 00 00 00 00 00 00 00 00 00 00 00 00 00 02 02 02 02 02 40 40 40 00 00 00 40
 02 02 02 02 02 02 02 00 00 00 00 00 00 28 02 02 02 02 02 02 02 40 40 40 00 00 00 00 32 00 17 40
 02 53 00 00 00 00 02 00 00 00 02 02 02 02 02 40 40 40 17 00 00 00 00 00 32 00 17 17 00 17 17 40
 02 00 00 00 00 00 02 00 00 00 02 53 00 00 00 17 17 17 17 00 00 00 32 00 00 00 00 00 32 17 00 40
 02 00 00 00 05 00 02 02 03 02 02 00 00 00 00 17 17 32 17 00 00 00 00 00 32 17 17 17 00 00 17 40
 02 00 00 00 00 00 02 00 00 00 00 00 00 00 00 17 17 17 17 00 00 32 00 00 00 00 00 00 32 17 00 40
 02 00 00 00 00 00 04 00 00 00 00 00 00 00 00 17 17 17 17 00 00 00 00 00 32 17 17 17 00 00 00 40
 02 53 00 00 00 00 04 00 00 00 00 00 00 00 00 17 32 00 00 00 32 00 40 40 40 40 40 40 40 40 40 53
 02 02 02 02 02 02 02 02 02 02 02 02 02 02 02 02 02 02 02 02 02 02 02 02 02 02 02 02 02 02 02 02
