Gauntlet (rev 1 - 9)
Maze number: 91
Offset for maze 90: 232322 - 0x038b82
big endian buf: [%!l(uint8=0) %!l(uint8=3) %!l(uint8=139) %!l(uint8=130)]
G:1 Maze real addr: 248709 - 0x03CB85, bank 2, boff: 0x4000
Maze read from: 0x03cb85 - 248709
compresssed: 146
 00 00 00 00 00 30 5E 5D 5A 0E 68 35 80 C4 0C 91
 C4 2A 72 E6 44 E4 73 C9 0C 91 76 EB E5 77 DF DF
 C7 B2 60 E0 40 E0 40 E0 40 E0 60 CB 2C DD A2 E8
 FA E6 6F E1 EC 61 DF D4 2A E8 C9 A2 DF D7 BF 44
 E0 C1 2A C3 05 C2 2A 44 DC B2 DF CB A2 C7 2A E8
 DF C5 5D F3 62 6A E1 DF E2 E2 E2 E3 C5 A4 F3 C5
 1E E2 D8 5E C4 04 62 E0 40 E0 40 E0 40 E0 60 CA
 04 DE A4 C1 A2 C0 A2 C0 A2 C1 A1 72 C6 1E FA C3
 03 81 7F C1 2C C1 BE 1E C4 04 06 B3 C1 0E 8D C3
 35 00
  Encoded length: 146 bytes
  Wall pattern: 00, Wall color: 14     Floor pattern: 03, Floor color: 05
  Flags: 
 02 02 02 02 02 02 02 02 02 02 02 02 02 02 02 02 02 02 02 02 02 02 02 02 02 02 02 02 02 02 02 02 02
 02 53 00 00 00 00 00 12 12 12 12 12 12 12 12 12 12 12 12 12 12 12 12 12 12 12 00 00 00 00 00 42 02
 02 00 00 40 00 00 00 00 00 00 00 02 00 00 00 00 00 29 00 00 00 00 00 02 00 00 00 00 40 00 00 00 02
 02 00 00 00 00 00 00 12 12 12 12 12 12 12 12 12 12 12 12 12 12 12 12 12 12 12 00 00 00 00 00 00 02
 02 40 00 00 00 00 00 00 00 00 00 00 00 00 02 00 00 00 00 00 00 02 00 00 00 00 00 00 00 00 40 00 02
 02 00 00 00 00 00 00 02 00 00 00 00 00 00 00 00 00 00 00 00 00 00 00 00 00 00 00 00 00 00 00 00 02
 02 00 00 00 00 00 00 02 00 00 00 00 00 00 00 00 00 00 00 00 00 00 00 00 00 00 00 00 00 00 00 00 02
 02 00 00 00 00 00 00 02 00 26 00 02 00 29 00 02 00 29 00 02 00 29 00 02 00 26 00 00 00 00 00 00 02
 02 14 00 00 00 00 44 00 00 00 00 00 00 00 00 00 00 00 00 00 00 00 00 00 00 00 00 00 00 00 00 00 02
 02 14 00 00 00 02 02 02 00 00 00 00 00 00 00 00 00 02 00 00 00 00 00 00 00 00 00 00 00 00 00 00 02
 02 14 00 00 00 00 00 00 00 00 00 00 00 02 00 00 00 00 00 00 00 02 00 00 00 00 00 00 00 00 00 00 02
 02 14 00 00 00 00 26 00 00 02 00 00 00 00 00 00 00 00 00 00 00 00 00 02 00 00 26 00 00 00 00 14 02
 02 14 00 00 00 00 00 00 00 00 00 00 00 00 00 00 00 00 00 00 00 00 00 00 00 00 00 00 00 00 00 14 02
 02 14 00 00 00 00 00 00 00 00 00 00 00 00 00 00 42 00 00 00 00 00 00 00 00 00 02 00 00 00 00 14 02
 02 14 00 00 00 02 02 02 00 00 00 00 00 00 00 00 00 00 00 00 00 00 00 00 00 00 00 00 00 00 00 14 02
 02 14 00 00 00 00 00 00 00 00 00 00 00 00 00 00 00 00 00 00 00 00 00 00 02 00 00 00 00 00 00 14 02
 02 14 00 00 00 00 29 00 02 00 00 42 00 00 00 00 05 00 00 00 42 00 00 00 02 00 29 00 00 00 00 14 02
 02 14 00 00 00 00 00 00 00 00 00 00 00 00 00 00 00 00 00 00 00 00 00 00 02 00 00 00 00 00 00 14 02
 02 14 00 00 00 00 00 00 00 00 00 00 00 00 00 00 00 00 00 00 00 00 00 00 00 00 00 00 00 00 00 14 02
 02 14 00 00 00 02 02 02 00 00 00 00 00 00 00 00 42 00 00 00 00 00 00 00 00 00 02 00 00 00 00 14 02
 02 14 00 00 00 00 00 00 00 00 00 00 00 00 00 00 00 00 00 00 00 00 00 00 00 00 00 00 00 00 00 14 02
 02 14 00 00 00 00 00 00 00 00 00 00 00 00 00 00 00 00 00 00 00 00 02 00 00 00 26 00 00 00 00 14 02
 02 00 00 00 00 00 26 00 00 02 00 00 00 00 00 00 00 00 00 00 00 00 00 00 00 00 00 00 00 00 00 14 02
 02 00 00 00 00 00 00 00 00 00 00 00 00 02 00 00 00 02 00 00 00 02 00 00 00 00 02 00 00 00 00 14 02
 02 02 02 02 02 02 00 00 00 00 00 00 00 00 00 00 00 00 00 00 00 00 00 00 00 00 02 00 00 00 00 14 02
 02 30 00 00 00 02 00 00 00 00 00 00 00 00 00 00 00 00 00 00 00 00 00 00 00 00 00 00 00 00 00 14 02
 02 00 00 00 00 04 00 00 00 26 00 02 00 29 00 02 00 29 00 02 00 29 00 02 00 26 00 00 00 00 00 00 02
 02 00 00 00 00 04 00 00 00 00 00 00 00 00 00 00 00 00 00 00 00 00 00 00 00 00 00 00 00 00 00 00 02
 02 00 00 00 00 02 02 02 02 02 00 00 02 02 02 00 02 02 02 00 02 02 02 00 00 02 02 00 00 00 40 00 02
 02 00 00 00 00 00 30 00 00 02 00 00 00 00 00 00 00 00 00 00 00 00 00 00 00 00 00 00 00 00 00 00 02
 02 00 02 00 00 00 00 03 03 02 00 00 00 00 00 00 00 00 00 00 00 00 00 00 00 00 40 00 00 44 00 00 02
 02 30 00 00 00 00 00 04 06 02 00 00 14 14 14 14 14 14 14 14 14 14 14 14 14 14 14 00 00 00 00 53 02
 02 02 02 02 02 02 02 02 02 02 02 02 02 02 02 02 02 02 02 02 02 02 02 02 02 02 02 02 02 02 02 02 02
