Gauntlet (rev 1 - 9)
Maze number: 84
Offset for maze 83: 231020 - 0x03866c
big endian buf: [%!l(uint8=0) %!l(uint8=3) %!l(uint8=134) %!l(uint8=108)]
G:1 Maze real addr: 247407 - 0x03C66F, bank 2, boff: 0x4000
Maze read from: 0x03c66f - 247407
compresssed: 210
 00 00 00 00 00 20 70 A8 51 04 AA 21 80 4E 11 35
 67 70 06 C2 AF AB C3 21 4F 66 45 AF A9 B3 C3 21
 4F CF AF A9 C5 21 4F 64 48 AF A7 C7 71 0E 80 28
 81 C0 0E 81 28 82 0E 81 CC AF A5 C9 21 4F CF A8
 C0 AB DD 20 CB A5 CC 20 CD 40 73 AB 28 BF D8 28
 85 C0 BF CA 41 B5 AB BB A0 E1 C3 0E C4 1D 4F C1
 0E A0 0E BD 0E BB 0E B7 C4 28 AE C2 0E 83 D5 11
 C1 1E C0 03 85 C1 56 C0 40 72 A9 C1 28 81 C8 A4
 B8 61 C9 B3 A2 C2 A3 CB A5 C9 70 0B C0 1B A7 B3
 C8 B3 A2 C1 35 C2 0B 81 C1 28 80 1A E8 62 C9 0B
 1B CB B3 C1 2B C2 A2 C7 A1 B4 DB 1B C4 74 A1 B2
 C1 B3 C3 1A C3 21 C2 B6 A5 C3 A2 C4 1A C1 B6 C4
 48 B6 A4 C2 A1 B2 C1 B5 E2 B4 C2 BE 05 EF CA B7
 2A 00
  Encoded length: 210 bytes
  Wall pattern: 00, Wall color: 00     Floor pattern: 02, Floor color: 07
  Flags: 
 02 02 02 02 02 02 02 02 02 02 02 02 02 02 02 02 02 02 02 02 02 02 02 02 02 02 02 02 02 02 02 02 02
 02 33 40 00 00 00 00 00 00 00 00 00 00 00 00 00 00 00 17 53 00 00 00 00 00 00 00 00 17 42 02 06 02
 02 00 02 02 02 02 02 02 02 02 02 02 02 02 02 02 02 02 02 02 02 02 02 02 02 02 02 02 02 02 02 00 02
 02 00 02 33 40 00 00 00 00 00 00 00 00 00 00 00 00 00 00 00 00 00 00 00 00 00 00 00 17 40 02 00 02
 02 00 02 00 02 02 02 02 02 02 02 02 02 02 02 02 02 02 02 02 02 02 02 02 02 02 02 02 02 02 02 00 02
 02 00 02 33 40 00 00 00 00 00 00 00 00 00 00 00 00 00 00 00 00 00 00 00 00 00 00 00 00 00 00 00 02
 02 00 02 00 02 02 02 02 02 02 02 02 02 02 02 02 02 02 02 02 02 02 02 02 02 02 02 02 02 02 02 00 02
 02 00 02 00 02 33 40 00 00 00 00 00 00 00 00 00 00 00 00 00 00 00 00 00 00 00 00 00 17 40 02 00 02
 02 00 02 00 02 00 02 02 02 02 02 02 02 02 02 02 02 02 02 02 02 02 02 02 02 02 02 02 02 02 02 00 02
 02 00 02 00 02 00 02 42 00 00 14 14 40 40 40 00 14 14 14 40 40 40 40 14 14 14 00 00 00 00 02 00 02
 02 00 02 00 02 00 02 02 02 02 02 02 02 02 02 02 02 02 02 02 02 02 02 02 02 02 02 02 02 00 02 00 02
 02 00 02 00 02 00 02 33 40 00 00 00 00 00 00 00 00 00 00 00 00 00 00 00 00 00 00 00 00 00 02 00 02
 02 00 02 00 02 00 02 00 02 02 02 02 02 02 02 02 02 02 00 02 02 02 02 02 02 02 02 02 02 02 02 00 02
 02 00 02 00 02 00 02 00 02 00 00 00 00 00 00 00 00 02 00 00 00 00 00 00 00 00 00 00 00 32 02 00 02
 02 00 02 00 02 00 02 00 02 00 02 02 02 02 02 02 00 02 00 00 00 00 00 00 00 00 00 00 00 32 02 00 02
 02 00 02 00 02 00 02 00 02 00 04 00 40 00 42 02 00 02 00 02 02 02 02 02 02 02 02 02 02 02 02 40 02
 02 00 02 00 02 00 02 00 02 00 04 00 00 00 00 02 00 02 00 00 00 00 00 00 00 00 40 40 40 40 02 40 02
 02 00 02 00 02 00 02 00 02 00 04 00 00 00 40 02 00 02 02 02 02 02 02 02 02 02 02 02 02 02 02 02 02
 02 00 02 00 02 00 02 14 02 00 04 00 00 29 40 02 00 00 00 00 00 00 00 00 00 00 00 00 00 00 00 00 02
 02 14 02 14 02 14 02 14 02 00 04 00 00 00 40 02 02 02 02 02 02 02 02 02 02 02 02 02 02 02 00 00 02
 02 14 14 14 14 14 00 00 00 00 04 00 00 00 00 02 00 00 00 00 00 00 00 00 00 00 00 00 17 02 00 30 02
 02 03 03 03 03 03 03 03 00 00 04 00 40 00 42 02 00 02 02 02 02 02 02 02 02 02 02 02 00 02 40 40 02
 02 00 00 00 00 00 00 00 00 00 02 02 02 02 02 02 00 02 17 00 00 00 00 00 00 00 00 02 00 02 02 02 02
 02 00 00 02 02 02 02 02 00 00 00 00 00 00 00 00 00 02 00 02 02 02 02 02 02 02 00 02 00 00 00 00 02
 02 00 00 02 42 00 11 02 27 02 02 02 02 02 02 02 02 02 00 02 00 00 00 00 00 02 00 02 02 02 02 00 02
 02 53 00 02 00 11 11 02 00 02 40 40 26 00 00 00 00 00 00 02 00 02 02 02 00 02 17 00 00 00 02 00 02
 02 00 00 02 00 11 27 02 00 02 00 00 00 00 00 00 00 00 02 02 00 02 43 02 00 02 02 02 02 00 02 00 02
 02 00 00 02 00 02 02 02 00 02 00 00 00 00 00 00 00 00 02 00 00 02 00 02 00 02 00 00 02 00 02 00 02
 02 00 00 02 27 00 00 00 00 02 42 00 00 00 00 00 02 02 02 00 02 02 00 02 00 02 26 00 02 00 02 33 02
 02 00 00 02 02 02 02 02 02 02 00 00 00 00 02 02 02 00 00 00 02 00 26 02 00 02 00 00 02 00 02 40 02
 02 00 00 00 00 00 00 00 00 02 02 02 02 02 02 00 00 00 02 02 02 00 00 02 00 00 00 02 02 00 02 00 02
 02 05 00 00 00 00 00 00 00 00 00 00 00 00 00 00 00 00 02 00 00 00 00 00 00 00 00 00 00 00 02 42 02
 02 02 02 02 02 02 02 02 02 02 02 02 02 02 02 02 02 02 02 02 02 02 02 02 02 02 02 02 02 02 02 02 02
