Gauntlet (rev 1 - 9)
Maze number: 102
Offset for maze 101: 233352 - 0x038f88
big endian buf: [%!l(uint8=0) %!l(uint8=3) %!l(uint8=143) %!l(uint8=136)]
G:1 Maze real addr: 249739 - 0x03CF8B, bank 2, boff: 0x4000
Maze read from: 0x03cf8b - 249739
compresssed: 203
 00 00 00 00 00 20 33 A8 5A 04 AB C3 35 C1 1B C0
 71 1B A0 C1 1D CD 71 05 E9 D6 B2 C6 44 2A 60 2A
 C2 49 04 E6 1B CD 40 1A A3 03 A0 E6 C2 1D D2 A1
 C5 44 A5 C0 45 1B C3 A1 1B E3 1B D7 A1 E3 C2 1D
 CE 74 1B A1 C2 4D 41 1A C8 A1 C7 2A 60 2A C7 79
 A1 7C 45 1B C7 2B A2 1A D1 A1 28 A1 28 A1 28 A0
 B2 A1 35 C2 5C CD 1D C2 1B C1 1B 61 35 B4 AF A0
 CE AF A0 C0 BF CD B2 2B 80 D1 1D C2 1D C6 B3 A0
 CE 03 8E A1 CF 2A C4 2A C7 A1 DE A1 4C 1A 64 C9
 A1 CC 2A C4 2A CA A1 1A 61 60 61 C5 B4 CE A1 35
 D6 44 1D A1 03 86 D5 35 A1 CE 4E A1 C7 4B 44 1D
 C2 A1 7F C8 1D C3 A1 DD 2B A1 DE A1 C0 BE 72 1A
 C5 70 1A C1 43 1D C0 55 C5 06 00
  Encoded length: 203 bytes
  Wall pattern: 00, Wall color: 03     Floor pattern: 02, Floor color: 03
  Flags: 
 02 02 02 02 02 02 02 02 02 02 02 02 02 02 02 02 02 02 02 02 02 02 02 02 02 02 02 02 02 02 02 02 02
 02 00 00 00 53 02 00 27 00 43 00 00 27 02 00 00 29 00 04 00 00 00 00 00 00 00 00 00 00 00 00 43 02
 02 00 05 00 00 02 00 00 00 00 00 00 00 02 00 00 00 00 04 00 00 00 00 00 00 00 00 00 00 00 00 00 02
 02 00 00 00 00 02 00 00 00 00 00 00 00 40 00 00 00 00 04 42 00 26 42 00 00 00 40 00 00 00 00 00 02
 02 00 00 00 00 04 00 00 00 00 00 00 00 02 27 00 00 00 04 00 00 00 00 00 00 00 00 00 00 40 00 26 02
 02 02 02 02 03 02 00 00 00 00 00 00 00 02 00 00 00 29 04 00 00 00 00 00 00 00 00 00 00 00 00 00 02
 02 00 00 00 00 02 02 00 00 00 00 00 00 40 00 00 00 00 04 02 02 02 02 02 02 00 40 00 00 00 00 00 02
 02 27 00 00 00 00 02 02 27 00 00 00 00 02 27 00 00 00 04 00 00 00 00 00 00 00 00 00 00 00 00 00 02
 02 00 00 00 00 00 00 02 02 00 00 00 00 02 00 00 00 29 04 00 00 00 00 00 00 00 00 00 00 00 00 00 02
 02 43 00 00 00 00 00 27 02 02 00 00 00 40 00 00 00 00 04 00 00 00 00 00 00 00 00 00 40 00 00 26 02
 02 00 00 00 00 00 00 00 00 02 02 00 00 02 00 00 00 00 04 42 00 26 42 00 00 00 00 00 00 00 00 43 02
 02 00 00 00 00 00 00 00 00 00 02 02 43 02 00 00 00 00 04 00 00 00 00 00 00 00 40 00 00 00 00 00 02
 02 27 00 00 00 00 00 00 00 00 43 02 02 02 26 00 00 00 04 00 00 00 00 00 00 00 00 00 00 00 00 00 02
 02 02 02 40 02 02 40 02 02 40 02 02 02 02 53 00 00 00 04 00 00 00 00 00 00 00 00 00 00 00 00 00 02
 02 29 00 00 00 27 00 00 27 00 00 26 53 02 02 02 02 02 02 02 02 02 02 02 02 02 02 02 02 02 02 00 02
 02 00 00 00 00 00 00 00 00 00 00 00 00 00 02 02 02 02 02 02 02 02 02 02 02 02 02 02 02 02 02 00 02
 02 00 00 00 00 00 00 00 00 00 00 00 00 00 00 02 02 43 00 00 00 00 00 00 00 00 00 00 00 00 00 00 02
 02 00 00 00 29 00 00 00 29 00 00 00 00 00 00 00 02 02 00 00 00 00 00 00 00 00 00 00 00 00 00 00 02
 02 03 03 03 03 03 03 03 03 03 03 03 03 03 03 03 03 02 02 00 00 00 00 00 00 00 00 00 00 00 00 00 02
 02 00 00 42 00 00 02 00 00 42 00 00 00 00 00 00 00 00 02 02 00 00 00 00 00 00 00 00 00 00 00 00 02
 02 00 00 00 00 00 02 00 00 00 00 00 00 00 00 00 00 00 00 02 02 40 00 00 00 00 00 00 00 00 00 00 02
 02 00 00 26 00 00 02 00 00 26 00 00 00 00 00 00 00 00 00 00 02 02 00 00 00 00 00 00 00 00 00 00 02
 02 00 00 42 00 00 02 00 00 42 00 00 00 00 00 00 00 00 00 00 00 02 02 26 00 00 26 00 26 00 00 26 02
 02 00 00 00 00 00 02 00 00 00 00 00 00 00 00 00 00 00 00 00 00 00 02 02 53 00 00 00 00 00 00 00 02
 02 00 00 00 00 00 00 00 00 00 00 00 00 00 00 00 40 00 00 00 00 00 29 02 02 03 03 03 03 03 03 03 02
 02 00 00 00 00 00 00 00 00 00 00 00 00 00 00 00 00 00 00 00 00 00 00 53 02 02 00 00 00 00 00 00 02
 02 00 00 00 00 00 00 00 00 40 00 00 00 00 00 00 00 00 00 00 00 00 00 00 04 02 02 00 00 00 00 00 02
 02 00 00 40 00 00 00 00 00 00 00 00 00 00 00 00 40 00 00 00 00 00 29 00 04 00 02 02 43 00 00 00 02
 02 00 00 00 00 00 00 00 00 00 00 00 00 00 00 00 00 00 00 00 00 00 29 00 04 00 00 02 02 00 00 00 02
 02 00 00 00 00 00 00 00 00 00 00 00 00 00 00 00 00 00 00 00 00 00 00 00 04 00 00 43 02 02 00 00 02
 02 00 00 00 00 00 00 00 00 00 00 00 00 00 00 00 00 00 00 00 00 00 00 00 04 00 00 00 00 02 02 00 02
 02 43 00 00 00 26 00 00 00 00 00 00 43 00 26 00 00 40 00 00 00 00 29 00 04 00 00 00 00 00 00 06 02
 02 02 02 02 02 02 02 02 02 02 02 02 02 02 02 02 02 02 02 02 02 02 02 02 02 02 02 02 02 02 02 02 02
