Gauntlet (rev 1 - 9)
Maze number: 4
Offset for maze 3: 230408 - 0x038408
big endian buf: [%!l(uint8=0) %!l(uint8=3) %!l(uint8=132) %!l(uint8=8)]
G:1 Maze real addr: 230411 - 0x03840B, bank 0, boff: 0x0000
Maze read from: 0x03840b - 230411
compresssed: 144
 00 00 00 00 00 03 21 68 5E 5B 5A 7A 28 49 CD 19
 28 59 C3 2A CB AF A6 46 D0 1B 6C C8 2A 57 DF 1B
 C6 2A 28 44 AF A1 28 81 69 DF DA 1E 61 C5 A8 59
 CB 35 C5 2C C0 1C 6F DA 28 81 C2 2A DE 1D D6 1A
 DF BF 60 CC 05 CC A2 DD 08 C2 BF CE B8 C5 BF C1
 BF 1A D3 04 0C DD 04 0C DD 04 0C 52 C2 1C C8 BF
 C3 0C C3 0C C1 04 0C C1 BF 28 45 C9 BD AC 76 79
 CF 1C DE 28 C9 B3 AF A2 B7 4A 1D 47 1D 6E DF C0
 BA AF A8 BA 28 81 CB 19 5C C3 BE 06 62 7F C8 00
  Encoded length: 144 bytes
  Wall pattern: 03, Wall color: 01     Floor pattern: 00, Floor color: 02
  Flags: 
 02 02 02 02 02 02 02 02 02 02 02 02 02 02 02 02 02 02 02 02 02 02 02 02 02 02 02 02 02 02 02 02 02
 02 00 00 00 00 00 00 00 00 00 00 26 40 00 00 00 00 00 00 00 00 00 00 40 00 00 00 00 00 00 00 00 02
 02 00 00 00 00 00 25 40 00 00 00 00 00 00 00 00 00 00 27 00 00 00 00 42 00 00 00 00 00 00 00 00 02
 02 00 00 02 02 02 02 02 02 02 02 02 02 02 02 02 02 02 02 02 02 02 02 02 02 02 02 00 00 02 00 00 02
 02 00 40 02 00 00 00 00 00 00 00 00 00 00 00 00 00 00 00 00 27 00 00 00 00 00 02 00 00 02 00 00 02
 02 00 30 02 00 00 00 00 00 00 00 00 42 00 00 00 00 00 00 00 00 27 00 00 00 00 02 00 00 02 00 00 02
 02 00 00 02 00 00 00 00 00 00 00 00 00 00 00 00 00 00 00 00 00 00 27 00 00 00 02 00 00 02 42 40 02
 02 00 00 02 00 40 02 02 02 02 02 02 02 02 02 02 02 02 02 02 02 02 02 02 40 40 02 00 00 02 00 00 02
 02 00 00 02 00 30 02 00 00 00 00 00 00 00 00 00 00 00 00 00 00 00 00 02 00 00 02 00 00 02 00 00 02
 02 00 00 02 00 00 02 00 00 00 00 00 00 00 00 00 00 00 00 00 00 00 00 02 00 00 02 00 00 02 00 00 02
 02 30 00 02 30 00 02 00 00 00 02 02 02 02 02 02 02 02 02 02 00 00 00 02 00 00 02 00 00 02 27 00 02
 02 00 00 02 00 00 02 00 00 00 02 53 00 00 00 00 00 00 44 02 28 00 00 02 00 00 02 00 00 02 00 00 02
 02 00 00 02 00 30 02 00 00 00 02 00 00 00 00 00 00 00 00 02 00 00 00 02 00 00 02 00 00 02 00 00 02
 02 40 40 02 00 00 02 42 00 00 02 00 00 00 00 00 00 00 00 02 00 00 00 02 00 00 02 00 00 02 00 00 02
 02 00 00 02 00 00 02 29 00 00 02 00 00 00 00 00 00 00 00 02 00 00 00 02 00 00 02 00 00 02 00 26 02
 02 00 00 02 00 00 02 00 00 00 02 00 00 00 00 00 00 00 00 02 00 00 00 02 00 00 02 00 00 02 00 00 02
 02 00 30 02 00 00 02 00 00 00 02 00 00 00 00 00 05 00 00 02 00 00 00 02 00 00 02 00 00 02 02 02 02
 02 00 00 02 00 00 02 00 00 00 02 00 00 00 00 00 00 00 00 02 00 00 00 02 00 00 02 00 00 02 00 08 02
 02 00 00 02 00 00 02 00 00 00 02 00 00 00 00 00 00 00 00 02 00 00 00 02 00 00 02 00 00 02 26 00 02
 02 00 00 02 00 00 02 00 00 00 02 00 00 00 00 00 00 00 00 04 12 00 00 02 00 00 02 00 00 02 00 00 02
 02 00 00 02 00 00 02 00 00 00 02 00 00 00 00 00 00 00 00 04 12 00 00 02 00 00 02 00 00 02 00 00 02
 02 00 00 02 00 00 02 00 00 00 02 00 00 00 00 00 00 00 00 04 12 00 00 02 27 00 02 00 28 02 00 00 02
 02 00 00 02 00 00 02 00 00 00 02 12 00 00 00 00 12 00 00 04 12 00 00 02 40 00 02 00 00 02 00 40 02
 02 00 00 02 00 00 02 00 00 00 02 02 02 02 02 02 02 02 02 02 02 02 02 02 00 00 02 00 00 02 00 26 02
 02 00 00 02 00 00 02 00 00 00 26 00 00 00 00 00 00 00 00 00 00 00 00 00 00 00 02 28 00 02 00 00 02
 02 00 00 02 00 00 02 00 00 00 00 00 00 00 00 00 00 00 00 00 00 00 00 00 00 00 02 40 00 02 00 00 02
 02 00 00 02 00 00 02 02 02 02 02 02 02 02 02 02 02 02 02 02 02 02 02 02 02 02 02 00 00 02 00 00 02
 02 00 00 02 00 00 40 29 00 00 00 00 00 00 00 00 40 29 00 00 00 00 00 00 00 00 00 00 00 02 00 00 02
 02 30 00 02 00 00 00 00 00 00 00 00 00 00 00 00 00 00 00 00 00 00 00 00 00 00 00 00 00 02 00 00 02
 02 00 00 02 02 02 02 02 02 02 02 02 02 02 02 02 02 02 02 02 02 02 02 02 02 02 02 02 02 02 40 40 02
 02 00 00 00 00 00 00 00 00 00 00 00 00 25 00 00 00 00 00 00 00 00 00 00 00 00 00 27 00 00 00 00 02
 02 06 00 00 00 30 00 00 00 00 00 00 00 00 00 00 00 00 00 00 00 00 26 00 00 00 00 00 00 00 00 00 02
 02 02 02 02 02 02 02 02 02 02 02 02 02 02 02 02 02 02 02 02 02 02 02 02 02 02 02 02 02 02 02 02 02
