Gauntlet (rev 1 - 9)
Maze number: 90
Offset for maze 89: 232192 - 0x038b00
big endian buf: [%!l(uint8=0) %!l(uint8=3) %!l(uint8=139) %!l(uint8=0)]
G:1 Maze real addr: 248579 - 0x03CB03, bank 2, boff: 0x4000
Maze read from: 0x03cb03 - 248579
compresssed: 127
 00 00 00 00 00 00 B0 50 5F 06 68 2C 80 66 65 64
 4E D0 10 73 C4 21 D8 21 28 46 D0 10 7F D7 10 41
 C1 A7 C1 A8 40 40 4A 40 40 44 40 40 79 43 4F DF
 64 47 4F 66 DF 45 4F DF CC B8 D1 B8 65 DC 1F BF
 CE 05 DF DF DF 6F 45 4F DF 64 47 4F DF 4D 4F DF
 48 C1 2B 41 40 40 44 40 40 C2 06 82 35 C6 B9 A6
 C2 A7 BA 11 84 C5 2B D1 11 76 21 42 D1 11 77 D5
 11 C2 03 80 BE 65 67 64 C1 53 11 C2 04 2A 00
  Encoded length: 127 bytes
  Wall pattern: 00, Wall color: 00     Floor pattern: 00, Floor color: 11
  Flags: 
 02 02 02 02 02 02 02 02 02 02 02 02 02 02 02 02 02 02 02 02 02 02 02 02 02 02 02 02 02 02 02 02 02
 02 44 00 00 00 00 00 00 00 31 00 00 00 00 00 00 31 00 00 00 00 00 31 00 00 00 00 00 00 00 00 00 02
 02 00 00 00 00 00 16 00 00 00 00 00 00 00 00 00 00 00 00 00 00 00 00 00 16 00 00 00 00 40 00 00 02
 02 00 00 33 00 00 00 00 00 00 00 00 00 00 00 00 00 00 00 00 00 00 00 00 00 00 00 00 00 33 40 00 02
 02 00 00 00 00 00 16 00 00 00 00 00 00 00 00 00 00 00 00 00 00 00 00 00 16 00 00 00 00 00 00 00 02
 02 00 00 00 00 00 00 00 00 40 00 00 00 00 00 00 00 00 00 00 00 00 00 00 00 00 00 00 00 00 00 00 02
 02 00 16 00 00 16 00 02 02 02 02 02 02 02 02 02 00 00 02 02 02 02 02 02 02 02 02 00 16 00 16 00 02
 02 00 00 00 00 00 00 02 00 00 16 00 16 00 16 00 00 00 00 00 16 00 16 00 16 00 02 00 00 00 00 00 02
 02 00 00 40 00 00 00 02 16 00 00 00 00 00 00 00 00 00 00 00 00 00 00 00 00 16 02 00 00 00 00 00 02
 02 00 00 00 00 00 00 02 00 00 00 00 00 00 00 00 00 00 00 00 00 00 00 00 00 00 02 00 00 00 00 31 02
 02 00 00 00 00 00 00 02 16 00 00 00 00 00 00 00 00 00 00 00 00 00 00 00 00 16 02 00 00 00 00 00 02
 02 31 00 00 00 00 00 02 00 00 00 00 00 00 00 00 00 00 00 00 00 00 00 00 00 00 02 00 00 00 00 00 02
 02 00 00 00 00 00 00 02 16 00 00 00 00 00 00 00 00 00 00 00 00 00 00 00 00 16 02 00 00 00 00 00 02
 02 00 00 00 00 00 00 02 00 00 00 00 00 00 00 00 00 00 00 00 00 00 00 00 00 00 02 00 00 00 00 00 02
 02 00 00 00 00 00 00 02 00 00 00 00 00 00 00 00 00 00 00 00 00 00 00 00 00 00 02 00 00 00 00 00 02
 02 31 00 00 00 00 00 00 00 00 00 00 00 00 00 00 00 00 00 00 00 00 00 00 00 00 00 00 00 00 00 31 02
 02 00 00 00 00 00 00 00 00 00 00 00 00 00 00 00 05 00 00 00 00 00 00 00 00 00 00 00 00 00 00 00 02
 02 00 00 00 00 00 00 00 00 00 00 00 00 00 00 00 00 00 00 00 00 00 00 00 00 00 02 00 00 00 00 00 02
 02 00 00 00 00 00 00 02 00 00 00 00 00 00 00 00 00 00 00 00 00 00 00 00 00 00 02 00 00 00 00 00 02
 02 00 00 00 00 00 00 02 00 00 00 00 00 00 00 00 00 00 00 00 00 00 00 00 00 00 02 00 00 00 00 00 02
 02 31 00 00 00 00 00 02 16 00 00 00 00 00 00 00 00 00 00 00 00 00 00 00 00 16 02 00 00 00 00 00 02
 02 00 00 00 00 00 00 02 00 00 00 00 00 00 00 00 00 00 00 00 00 00 00 00 00 00 02 00 00 00 00 31 02
 02 00 00 00 00 00 00 02 16 00 00 00 00 00 00 00 00 00 00 00 00 00 00 00 00 16 02 00 00 00 00 00 02
 02 00 00 00 00 00 00 02 00 00 00 00 00 00 00 00 00 00 00 00 00 00 00 00 00 00 02 00 00 00 00 00 02
 02 00 00 00 00 00 00 02 16 00 00 00 00 00 00 00 00 00 00 00 00 00 00 00 00 16 02 00 00 00 00 00 02
 02 00 00 00 00 00 00 02 00 00 00 00 00 00 00 00 00 00 00 00 00 00 00 00 00 00 02 00 00 00 00 00 02
 02 00 00 16 00 00 43 02 00 16 00 16 00 16 00 00 00 00 00 16 00 16 00 16 00 00 02 06 06 06 06 53 02
 02 00 00 00 00 00 00 02 02 02 02 02 02 02 02 00 00 00 02 02 02 02 02 02 02 02 02 17 17 17 17 17 02
 02 00 00 00 00 00 00 43 00 00 00 00 00 00 00 00 00 00 00 00 00 00 00 00 00 06 17 00 00 00 00 00 02
 02 00 40 33 00 00 00 16 00 00 00 00 00 00 00 00 00 00 00 00 00 00 00 00 00 06 17 00 00 00 00 00 02
 02 00 00 40 00 00 00 00 00 00 00 00 00 00 00 00 00 00 00 00 00 00 00 00 00 06 17 00 00 00 03 03 02
 02 00 00 00 00 00 00 31 00 00 00 00 00 00 00 00 31 00 00 00 00 00 31 00 00 06 17 00 00 00 04 42 02
 02 02 02 02 02 02 02 02 02 02 02 02 02 02 02 02 02 02 02 02 02 02 02 02 02 02 02 02 02 02 02 02 02
