Gauntlet (rev 1 - 9)
Maze number: 26
Offset for maze 25: 236269 - 0x039aed
big endian buf: [%!l(uint8=0) %!l(uint8=3) %!l(uint8=154) %!l(uint8=237)]
G:1 Maze real addr: 236272 - 0x039AF0, bank 0, boff: 0x0000
Maze read from: 0x039af0 - 236272
compresssed: 271
 0A 0A 00 00 00 80 50 0E 5E 68 54 A6 1E C3 40 06
 C0 2A 56 1E A8 14 E1 40 C4 41 50 E9 71 E4 B2 C0
 41 A8 C1 A4 C2 B2 A0 C4 A1 C2 A1 1B 6B A1 C2 A6
 C2 A1 CD 41 A1 C2 A3 B5 40 C1 A1 C2 A3 C2 A4 42
 A1 C2 B5 61 41 A1 C2 A1 42 52 C2 A1 40 C1 A1 61
 E4 C2 A1 C0 42 C7 A1 E2 CA A1 C2 A4 E1 C2 A1 61
 EA C2 A1 51 C2 A1 E2 D0 A1 C7 A1 61 67 40 60 E4
 C4 BB A0 E2 CA 42 65 C1 A1 C1 A1 C1 2A D0 2A E4
 E3 C1 1B D0 1E 54 D1 BF C5 42 C4 05 51 C7 1B 60
 C0 BF C6 42 C1 B3 A0 E3 B3 6C 40 C9 A1 50 A1 CD
 42 C4 B7 A0 C2 A3 E2 B7 D2 A1 C7 A1 CF BB A0 C2
 A1 1E 53 A1 42 A0 BB 69 C1 A1 C2 A7 42 A1 41 1E
 C6 BF A0 C1 40 A1 CA 40 A1 42 A0 BF 63 C0 40 A1
 42 A1 68 A1 C1 40 A1 61 44 C0 A1 40 C1 AB C2 A1
 E6 C2 A1 C8 1B 2A C4 A1 C2 A6 C2 A1 1E CC A1 C2
 A5 E0 C2 40 AF E3 74 C2 41 D4 14 A8 1E 64 28 62
 64 A6 BE B6 A1 B3 B2 AF A3 B2 B3 A1 B6 BE 00
  Encoded length: 271 bytes
  Wall pattern: 00, Wall color: 00     Floor pattern: 08, Floor color: 05
  Flags: 
 02 02 02 02 02 02 02 02 02 02 02 02 02 02 02 02 02 02 02 02 02 02 02 02 02 02 02 02 02 02 02 02 02
 02 02 02 02 02 02 02 30 00 00 00 00 14 06 00 42 02 00 00 00 00 00 00 40 30 02 02 02 02 02 02 02 02
 02 02 20 00 02 02 14 00 00 00 00 00 14 14 00 40 02 00 00 00 00 00 00 00 00 00 02 02 00 20 02 02 02
 02 02 00 02 02 00 14 14 02 02 02 02 02 02 02 02 02 00 00 02 02 02 02 02 00 00 00 02 02 00 02 02 02
 02 02 02 02 00 00 00 02 02 27 00 00 00 00 00 00 02 00 00 00 00 00 30 02 02 00 00 00 02 02 02 02 02
 02 02 02 00 00 00 02 02 00 00 00 00 00 00 00 00 02 00 00 00 00 00 14 14 02 02 00 00 00 02 02 02 02
 02 02 14 00 00 02 02 00 00 00 02 02 02 02 00 00 02 02 02 02 02 02 14 14 14 02 02 00 00 00 02 02 02
 02 30 14 14 02 02 00 00 00 02 02 14 14 14 00 00 02 40 00 00 00 02 02 14 00 00 02 02 00 00 30 02 02
 02 00 00 02 02 00 00 00 02 02 00 14 14 14 00 00 02 00 00 00 00 00 02 02 00 00 00 02 02 00 00 02 02
 02 00 00 02 00 00 00 02 02 00 00 00 02 02 02 02 02 00 00 02 00 00 00 02 02 00 00 30 02 00 00 02 02
 02 00 00 02 00 00 02 02 00 00 00 02 02 00 00 40 02 00 00 02 02 00 00 00 02 02 00 00 02 00 00 02 02
 02 00 00 02 00 00 02 00 00 00 02 02 00 00 00 00 02 00 00 00 02 02 00 00 30 02 00 00 02 00 00 02 02
 02 30 14 02 30 00 02 00 00 02 02 00 00 00 00 00 02 02 00 00 00 02 02 00 00 02 00 00 02 00 00 02 02
 02 14 14 02 00 00 02 00 00 02 30 00 00 02 02 00 00 02 02 00 00 42 02 00 00 02 00 00 02 00 00 02 02
 02 00 00 02 00 00 02 42 00 02 00 00 02 02 00 00 00 00 02 02 00 27 02 00 00 02 00 00 02 00 00 02 02
 02 00 00 02 00 00 02 30 00 02 00 00 02 40 00 00 00 00 00 02 00 00 02 00 00 02 00 00 02 00 00 02 02
 02 00 00 02 00 00 02 14 14 02 00 00 02 00 00 05 00 00 40 02 00 00 02 00 00 02 00 27 02 30 00 02 02
 02 00 00 02 00 00 02 14 14 02 00 00 02 02 00 00 00 00 02 02 00 00 02 00 00 02 00 00 02 00 00 02 02
 02 30 14 02 00 00 02 00 00 02 00 00 00 02 02 00 40 02 02 00 00 00 02 00 00 02 00 00 02 00 00 02 02
 02 14 14 02 00 00 02 00 00 02 02 00 00 00 02 02 02 02 00 00 00 02 02 00 00 02 00 00 02 00 00 02 02
 02 00 00 02 00 00 02 00 00 00 02 02 00 00 00 00 00 00 00 00 02 02 00 00 00 02 00 00 02 00 00 02 02
 02 00 00 02 00 00 02 02 00 00 00 02 02 30 00 00 00 00 40 02 02 14 14 14 02 02 00 00 02 00 00 02 02
 02 00 00 02 30 00 00 02 02 00 00 00 02 02 02 02 02 02 02 02 14 14 14 02 02 14 14 30 02 00 00 02 02
 02 00 00 02 02 00 00 14 02 02 00 00 00 00 00 00 00 00 00 00 00 14 02 02 14 14 14 02 02 00 00 02 02
 02 30 00 14 02 02 14 14 14 02 02 00 00 00 00 00 00 00 00 00 30 02 02 00 00 14 02 02 00 00 30 02 02
 02 02 14 14 00 02 02 14 00 00 02 02 02 02 02 02 02 02 02 02 02 02 00 00 00 02 02 00 00 00 02 02 02
 02 02 02 00 00 00 02 02 00 00 00 00 00 00 00 00 00 27 42 00 00 00 00 00 02 02 00 00 00 02 02 02 02
 02 02 02 02 00 00 00 02 02 30 00 00 00 00 00 00 00 00 00 00 00 00 00 02 02 00 00 00 02 02 02 02 02
 02 02 00 02 02 00 00 14 02 02 02 02 02 02 02 02 02 02 02 02 02 02 02 02 00 00 00 02 02 00 02 02 02
 02 02 20 00 02 02 14 14 00 00 00 00 00 00 00 00 00 00 00 00 00 00 00 00 00 00 02 02 00 20 02 02 02
 02 02 02 02 02 02 02 30 00 00 00 00 00 30 40 00 00 00 30 00 00 00 00 00 30 02 02 02 02 02 02 02 02
 02 02 02 02 02 02 02 02 02 02 02 02 02 02 02 02 02 02 02 02 02 02 02 02 02 02 02 02 02 02 02 02 02
 02 02 02 02 02 02 02 02 02 02 02 02 02 02 02 02 02 02 02 02 02 02 02 02 02 02 02 02 02 02 02 02 02
