Gauntlet (rev 1 - 9)
Maze number: 34
Offset for maze 33: 236570 - 0x039c1a
big endian buf: [%!l(uint8=0) %!l(uint8=3) %!l(uint8=156) %!l(uint8=26)]
G:1 Maze real addr: 252957 - 0x03DC1D, bank 2, boff: 0x4000
Maze read from: 0x03dc1d - 252957
compresssed: 165
 06 0D 00 00 04 00 00 58 68 39 B5 28 80 C4 10 81
 D6 74 10 81 67 CA 05 C1 AF A8 03 80 A4 C8 11 82
 14 C0 14 C8 11 80 62 C0 2A C7 11 82 D0 35 A1 03
 80 AF AC 2E C2 2E 69 C0 2A CB 7F CD 51 39 C0 2E
 D5 18 DF C7 2E DF 4A 4E 46 D2 28 C4 7F 43 D5 28
 D3 BF DF D3 28 4C 44 44 48 DF DF 61 D3 BF 6F 42
 61 42 E2 41 FB 46 D6 04 CC 2C C0 7E 04 49 C3 AF
 AC 03 80 C0 13 C9 23 C6 24 C0 20 C3 10 81 3A 80
 C0 13 51 C7 51 23 51 C1 3B 81 C1 51 20 51 C4 10
 81 A2 03 80 AB B3 AE 28 CE 26 CC 1D BE 2A CD 51
 26 51 CB 06 00
  Encoded length: 165 bytes
  Wall pattern: 00, Wall color: 00     Floor pattern: 00, Floor color: 00
  Flags: 
 02 02 02 02 02 02 02 02 02 02 02 02 02 02 02 02 02 02 02 02 02 02 02 02 02 02 02 02 02 02 02 02 02
 02 40 00 00 00 00 00 16 16 16 00 00 00 00 00 00 00 00 00 00 00 00 00 00 00 00 00 00 00 00 00 00 02
 02 53 00 00 00 00 00 16 16 16 00 00 00 00 00 00 00 00 40 00 00 00 00 00 00 00 00 00 00 00 05 00 02
 02 02 02 02 02 02 02 02 02 02 02 02 02 02 02 02 02 02 02 02 02 02 02 02 02 02 03 03 02 02 02 02 02
 02 00 00 00 00 00 00 00 00 00 17 17 17 17 20 00 20 00 00 00 00 00 00 00 00 00 17 17 00 00 00 40 02
 02 42 00 00 00 00 00 00 00 00 17 17 17 17 00 00 00 00 00 00 00 00 00 00 00 00 00 00 00 00 00 53 02
 02 02 03 03 02 02 02 02 02 02 02 02 02 02 02 02 02 02 02 02 02 02 02 02 02 02 02 02 02 02 02 02 02
 02 46 00 00 00 46 00 00 00 00 00 00 00 00 00 00 40 02 42 00 00 00 00 00 00 00 00 00 00 00 57 53 02
 02 00 00 00 00 00 00 00 00 00 00 00 00 00 00 00 00 02 00 00 00 00 00 00 00 00 00 00 00 00 57 57 02
 02 46 00 00 00 00 00 00 00 00 00 00 00 00 00 00 00 02 00 00 00 00 00 00 24 00 00 00 00 00 00 00 02
 02 00 00 00 00 00 00 00 00 00 00 00 00 00 00 00 00 02 00 00 00 00 00 00 00 00 00 00 00 00 00 00 02
 02 46 00 00 00 00 00 00 00 00 00 00 00 00 00 00 00 02 00 00 00 00 00 00 00 00 00 00 00 00 00 00 02
 02 00 00 00 00 00 00 00 00 00 00 00 00 24 00 00 00 02 00 00 00 00 00 00 00 00 00 00 00 24 00 00 02
 02 00 00 00 00 24 00 00 00 00 00 00 00 00 00 00 00 02 00 00 00 00 00 00 00 40 00 00 00 00 00 53 02
 02 00 00 00 00 00 00 00 00 00 00 00 00 00 00 00 00 02 00 00 24 00 00 00 00 00 00 00 00 00 00 00 02
 02 00 00 00 00 00 00 00 00 00 00 40 00 00 00 00 00 02 00 00 00 00 00 00 00 00 00 00 00 00 00 00 02
 02 00 00 00 00 00 00 00 00 00 00 00 00 00 00 00 00 02 00 00 00 00 00 00 00 00 00 00 00 00 00 00 02
 02 00 00 00 00 00 00 00 00 00 00 00 00 00 00 00 00 02 00 00 00 40 00 00 00 00 00 00 00 00 00 00 02
 02 00 00 24 00 00 00 00 00 24 00 00 00 00 00 24 00 02 00 00 00 00 00 00 00 24 00 00 00 00 00 00 02
 02 00 00 00 00 00 00 00 00 00 00 00 00 00 00 00 00 02 00 00 00 00 00 00 00 00 00 00 00 00 00 00 02
 02 00 00 00 00 00 00 00 00 00 00 00 00 00 00 00 00 02 00 00 00 00 00 00 00 00 00 00 40 00 00 00 02
 02 00 00 00 00 00 00 00 00 00 00 00 00 00 00 00 00 02 00 00 00 00 00 00 00 00 00 00 00 00 00 00 02
 02 00 40 00 00 00 24 00 00 40 00 00 00 24 00 00 00 02 00 00 24 00 00 00 00 00 00 00 00 00 00 00 02
 02 00 00 00 00 00 00 00 00 00 00 00 00 00 00 00 00 02 00 00 00 00 00 00 00 24 00 00 00 00 00 00 02
 02 00 00 00 00 00 00 00 00 00 00 00 00 00 00 00 00 04 00 00 00 00 00 00 00 00 00 00 00 00 00 44 02
 02 53 00 00 00 00 00 00 00 00 00 00 00 00 00 00 00 04 00 00 00 00 00 00 00 00 00 00 24 00 00 00 02
 02 02 02 02 02 02 02 02 02 02 02 02 02 02 02 02 02 02 02 02 02 02 02 02 02 02 02 02 02 02 03 03 02
 02 19 57 00 00 00 00 00 00 00 00 57 35 57 00 00 00 02 00 00 36 57 32 57 00 00 00 16 16 16 58 58 02
 02 19 57 00 00 00 00 00 00 00 00 57 35 57 00 00 59 02 59 00 00 57 32 57 00 00 00 00 00 16 16 16 02
 02 02 02 03 03 02 02 02 02 02 02 02 02 02 02 02 02 02 02 02 02 02 02 02 02 02 02 02 02 02 02 02 02
 02 40 00 00 00 00 00 00 00 00 00 00 00 00 00 00 57 38 57 00 00 00 00 00 00 00 00 00 00 00 00 29 02
 02 42 00 00 00 00 00 00 00 00 00 00 00 00 00 00 57 38 57 00 00 00 00 00 00 00 00 00 00 00 00 06 02
