Gauntlet (rev 1 - 9)
Maze number: 69
Offset for maze 68: 236772 - 0x039ce4
big endian buf: [%!l(uint8=0) %!l(uint8=3) %!l(uint8=156) %!l(uint8=228)]
G:1 Maze real addr: 244967 - 0x03BCE7, bank 1, boff: 0x2000
Maze read from: 0x03bce7 - 244967
compresssed: 226
 00 00 00 00 00 43 48 68 9F 04 0E 1F 80 C1 2B C9
 06 C6 20 C0 20 C0 20 C0 20 C0 20 CB 03 88 CA 69
 1B 88 4D C6 1B 88 C4 2A C4 64 54 E3 28 85 A2 2A
 C5 2A C1 A3 C1 A4 03 88 CA 67 35 C0 1B C6 1B C3
 2A C1 2A 47 C5 1B C6 1B CB 67 AA 57 D7 1B C2 1B
 C1 03 82 C7 62 28 C7 1B C2 1B D4 A3 C1 1B C2 1B
 CD 66 28 80 5B A0 56 A0 57 A0 57 A0 56 A0 52 C8
 1A 44 DA 69 03 81 C0 03 83 C2 54 C0 1A C4 BF 03
 87 C0 35 82 C2 35 C1 35 CA 62 28 C4 AB D3 1E C8
 1E CA 6F D1 A2 28 40 D0 28 C4 64 A5 4D C4 A2 C1
 B2 2B D8 62 28 DF DA 62 28 D0 28 D2 77 C8 77 40
 46 C0 67 BF 1E A1 5B A0 5B A0 5A A1 1E BF 47 A3
 40 C3 A1 5C C6 5C A1 C9 67 35 C2 35 C6 35 DF C4
 2B C2 BE 62 2B C3 35 B3 C3 05 C3 B3 35 C1 1A C4
 1A 00
  Encoded length: 226 bytes
  Wall pattern: 03, Wall color: 08     Floor pattern: 04, Floor color: 04
  Flags: 
 02 02 02 02 02 02 02 02 02 02 02 02 02 02 02 02 02 02 02 02 02 02 02 02 02 02 02 02 02 02 02 02 02
 02 31 00 00 43 00 00 04 00 00 00 00 00 00 00 06 00 00 00 00 00 00 00 32 00 32 00 32 00 32 00 32 02
 02 00 00 00 00 00 00 04 00 00 00 04 03 03 03 03 03 03 03 03 03 04 00 00 00 00 00 00 00 00 00 00 02
 02 31 00 00 00 00 00 04 00 00 00 04 27 27 27 27 27 27 27 27 27 04 00 00 00 00 00 00 00 00 00 00 02
 02 00 00 00 40 00 00 04 00 00 00 04 27 27 27 27 27 27 27 27 27 04 00 00 00 00 00 42 00 00 00 00 02
 02 31 00 00 00 00 00 04 00 00 00 04 02 40 40 40 40 40 40 40 02 04 02 42 00 00 00 00 00 00 42 00 02
 02 02 02 02 02 00 00 02 02 02 02 04 03 03 03 04 03 04 03 03 03 04 00 00 00 00 00 00 00 00 00 00 02
 02 31 00 00 00 00 00 00 00 00 53 04 27 04 00 04 00 04 00 04 27 04 00 00 00 42 00 00 42 00 00 00 02
 02 00 00 00 00 40 00 00 00 00 00 04 27 04 00 04 00 04 00 04 27 04 00 00 00 00 00 00 00 00 00 00 02
 02 31 00 00 00 00 00 00 00 00 02 04 02 04 02 04 02 04 02 04 02 04 00 00 00 00 00 00 00 00 00 00 02
 02 00 00 00 00 00 00 00 00 00 00 04 00 04 27 04 00 04 27 04 00 03 03 03 03 00 00 00 00 00 00 00 02
 02 31 00 00 00 40 00 00 00 00 00 04 00 04 27 04 00 04 27 04 00 04 00 00 04 00 00 00 00 00 00 00 02
 02 00 00 00 00 00 00 00 02 02 02 04 00 04 27 04 00 04 27 04 00 04 02 00 04 00 00 00 00 00 00 00 02
 02 31 00 00 00 00 00 00 00 40 02 04 02 04 02 04 02 04 02 04 02 04 02 00 04 00 00 00 00 00 00 26 02
 02 00 00 00 00 40 00 00 00 00 02 00 00 00 00 00 00 00 00 00 00 00 02 00 04 00 00 00 00 00 00 00 02
 02 31 00 00 00 00 00 00 00 00 02 00 03 03 03 00 03 03 03 03 03 00 02 00 04 00 26 00 00 00 00 00 02
 02 03 03 03 03 03 03 03 03 03 02 53 04 53 04 00 04 00 53 00 04 53 02 00 00 00 00 00 00 00 00 00 02
 02 31 00 00 00 40 00 00 00 00 02 02 04 02 04 02 04 02 04 02 04 02 02 00 00 00 00 00 00 00 00 00 02
 02 00 00 00 00 00 00 00 00 00 02 30 04 00 04 00 04 00 04 00 04 30 02 00 00 00 00 00 00 00 00 00 02
 02 31 00 00 00 00 00 00 00 00 02 14 04 00 04 00 04 00 04 00 04 14 02 00 00 00 00 00 00 00 00 00 02
 02 00 00 00 02 02 02 40 00 40 02 14 04 00 04 00 04 00 04 00 04 14 02 00 00 00 00 40 00 00 00 00 02
 02 31 00 00 00 00 02 02 02 02 02 14 04 00 04 00 04 00 04 00 04 14 02 00 00 00 00 40 00 00 00 00 02
 02 02 02 02 00 00 02 43 00 00 02 14 04 00 04 00 04 00 04 00 04 14 02 00 00 00 00 00 00 00 00 00 02
 02 31 00 00 00 40 00 00 00 00 02 14 04 00 04 00 04 00 04 00 04 14 02 00 00 00 00 00 00 00 00 00 02
 02 00 00 00 00 00 00 00 00 00 02 14 04 00 04 00 04 00 04 00 04 14 02 00 00 00 00 00 00 00 00 00 02
 02 31 00 00 00 40 00 00 00 00 02 14 04 00 04 00 04 00 04 00 04 14 02 40 00 00 00 00 00 00 00 00 02
 02 00 00 00 00 00 00 00 00 00 02 14 04 00 04 00 04 00 04 00 04 14 02 40 00 00 00 00 00 00 00 40 02
 02 31 00 00 00 00 00 00 00 00 02 30 04 02 04 02 04 02 04 02 04 30 02 00 00 00 00 00 00 00 00 40 02
 02 02 02 02 00 40 00 00 00 00 02 02 04 00 00 00 00 00 00 00 04 02 02 00 00 00 00 00 00 00 00 00 02
 02 31 00 00 00 00 00 00 00 00 53 02 00 00 53 00 00 00 00 00 00 02 53 00 00 00 00 00 00 00 00 00 02
 02 00 00 00 00 00 00 00 00 00 00 02 00 00 00 00 00 00 00 00 00 02 00 00 00 00 00 00 43 00 00 00 02
 02 31 00 00 00 43 00 00 00 00 53 02 00 00 00 00 05 00 00 00 00 02 53 00 00 26 00 00 00 00 00 26 02
 02 02 02 02 02 02 02 02 02 02 02 02 02 02 02 02 02 02 02 02 02 02 02 02 02 02 02 02 02 02 02 02 02
