Gauntlet (rev 1 - 9)
Maze number: 80
Offset for maze 79: 230050 - 0x0382a2
big endian buf: [%!l(uint8=0) %!l(uint8=3) %!l(uint8=130) %!l(uint8=162)]
G:1 Maze real addr: 246437 - 0x03C2A5, bank 2, boff: 0x4000
Maze read from: 0x03c2a5 - 246437
compresssed: 220
 11 11 00 02 82 73 01 56 68 04 0D C1 21 C4 10 87
 63 C4 06 60 80 C3 AF A5 C1 A3 D5 28 C4 06 60 C4
 19 81 AF A2 C1 A1 2A D6 28 C4 06 C0 25 C0 2A C6
 19 AF A0 61 C2 1A 68 81 C1 1F C5 1F D4 03 8C F1
 1C C8 1C A0 CC 26 C0 1A 62 CA 35 C0 1F D2 03 84
 60 C1 2A D5 28 62 CF 26 DA 16 C8 1F D4 16 DA 25
 81 40 BF CE 05 C8 BF 43 81 BF DA BF 16 DE 16 C3
 BF C0 BF C6 35 62 C5 1F C1 BF 41 CC 58 03 83 59
 68 40 C2 26 83 BF 1F 69 49 6A CA 2A 46 C9 5F A0
 1C C8 1C A0 5E 45 C9 03 8D 45 D1 21 C5 1F 60 42
 C9 AF B9 C7 1A 84 C3 26 C5 2A C5 25 C8 2A 82 C0
 AF A1 B8 C5 06 83 C0 26 C2 26 CE 25 C3 BC A0 BA
 A0 BA A0 C1 AF A3 BC C0 BE 7E C0 1A C1 2A 06 B9
 0A 82 1A 0A 83 C6 1B 35 04 11 81 00
  Encoded length: 220 bytes
  Wall pattern: 03, Wall color: 01     Floor pattern: 07, Floor color: 00
  Flags: PLAYER_OFFSCREEN SHOTS_HURT 
  ╚══> while gauntlet has these elements, these flags probably do not operate
 02 02 02 02 02 02 02 02 02 02 02 02 02 02 02 02 02 02 02 02 02 02 02 02 02 02 02 02 02 02 02 02 02
 02 00 33 00 00 00 00 00 16 16 16 16 16 16 16 16 16 00 00 00 00 40 00 00 00 00 02 06 00 40 40 00 02
 02 00 02 02 02 02 02 02 02 02 02 02 02 02 02 02 02 02 02 02 02 02 02 02 02 00 02 02 02 02 02 00 02
 02 00 02 00 00 00 00 00 00 00 00 00 00 00 00 00 00 00 00 00 00 40 00 00 00 00 02 06 00 40 02 00 02
 02 00 02 25 02 25 02 02 02 02 02 02 02 02 02 02 02 02 02 02 02 02 02 02 02 00 02 02 02 42 02 00 02
 02 00 02 00 02 00 02 00 00 00 00 00 00 00 00 00 00 00 00 00 00 40 00 00 00 00 02 06 02 37 02 42 02
 02 00 02 00 02 00 02 25 02 02 02 02 02 02 02 02 02 02 02 02 02 02 02 02 02 00 02 40 02 00 02 26 02
 02 00 02 00 02 00 02 00 02 40 40 40 00 00 31 00 00 00 00 00 00 31 00 00 00 00 02 00 02 00 02 00 02
 02 00 02 00 02 00 02 00 02 00 04 03 03 03 03 03 03 03 03 03 03 03 03 03 03 00 02 00 02 00 02 00 02
 02 00 02 00 02 00 02 00 02 00 04 02 28 00 00 00 00 00 00 00 00 00 28 02 04 00 02 00 02 00 02 00 02
 02 00 02 00 02 38 02 26 02 00 04 40 00 00 00 00 00 00 00 00 00 00 00 53 04 31 02 00 02 00 02 00 02
 02 00 02 00 02 00 02 00 02 00 04 00 00 03 03 03 03 03 03 04 40 00 00 42 04 00 02 00 02 00 02 00 02
 02 00 02 00 02 00 02 00 02 00 04 00 00 04 40 00 00 00 40 04 00 00 00 00 04 00 02 00 02 00 02 00 02
 02 00 02 38 02 00 02 00 02 00 04 00 00 04 00 00 00 00 00 04 00 00 00 00 04 00 02 00 02 00 02 22 02
 02 00 02 00 02 00 02 00 02 31 04 00 00 04 00 00 00 00 00 04 00 00 00 00 04 00 02 00 02 00 02 22 02
 02 00 02 00 02 00 02 00 02 00 04 00 00 04 00 00 00 00 00 04 00 00 00 00 04 00 02 37 02 37 02 22 02
 02 00 02 00 02 00 02 00 02 00 04 00 00 04 00 00 05 00 00 04 00 00 00 00 04 00 02 00 02 00 02 22 02
 02 13 02 00 02 00 02 00 02 00 04 00 00 04 00 00 00 00 00 04 00 00 00 00 04 00 02 00 02 00 02 22 02
 02 13 02 00 02 00 02 00 02 00 04 00 00 04 00 00 00 00 00 04 00 00 00 00 04 00 02 00 02 00 02 22 02
 02 13 02 00 02 00 02 00 02 00 04 00 00 04 53 00 00 00 40 04 00 00 00 00 04 31 02 00 02 00 02 22 02
 02 13 02 00 02 00 02 00 02 00 04 00 00 04 03 03 03 03 03 04 00 00 00 00 04 00 02 00 02 40 02 22 02
 02 13 02 38 02 38 02 38 02 31 04 00 00 00 00 00 00 00 00 00 40 00 00 00 04 00 02 00 02 00 02 22 02
 02 13 02 00 02 00 02 00 02 00 04 40 00 00 00 00 00 00 00 00 00 00 00 42 04 00 02 00 02 00 02 22 02
 02 13 02 00 02 00 02 00 02 00 04 02 28 00 00 00 00 00 00 00 00 00 28 02 04 00 02 00 02 00 02 22 02
 02 13 02 00 02 00 02 00 02 00 03 03 03 03 03 03 03 03 03 03 03 03 03 03 03 00 02 00 02 00 02 22 02
 02 13 02 00 02 00 02 00 02 00 00 00 00 00 00 00 00 00 33 00 00 00 00 00 00 31 02 40 02 00 02 22 02
 02 13 02 00 02 00 02 00 02 00 02 02 02 02 02 02 02 02 02 02 02 02 02 02 02 02 02 00 02 00 02 00 02
 02 13 02 26 02 26 02 26 02 00 00 00 00 38 00 00 00 00 00 00 42 00 00 00 00 00 00 37 02 00 02 00 02
 02 13 02 00 02 42 02 42 02 00 02 02 02 02 02 02 02 02 02 02 02 02 02 02 02 02 02 02 02 00 02 00 02
 02 13 02 06 02 06 02 06 02 38 00 00 00 38 00 00 00 00 00 00 00 00 00 00 00 00 00 00 00 37 02 00 02
 02 13 02 02 02 02 02 02 02 00 02 02 02 02 02 02 02 02 02 02 02 02 02 02 02 02 02 02 02 02 02 00 02
 02 13 00 26 00 00 42 06 02 10 10 10 10 26 10 10 10 10 10 00 00 00 00 00 00 00 27 53 04 17 17 17 02
 02 02 02 02 02 02 02 02 02 02 02 02 02 02 02 02 02 02 02 02 02 02 02 02 02 02 02 02 02 02 02 02 02
