Gauntlet (rev 1 - 9)
Maze number: 104
Offset for maze 103: 233746 - 0x039112
big endian buf: [%!l(uint8=0) %!l(uint8=3) %!l(uint8=145) %!l(uint8=18)]
G:1 Maze real addr: 250133 - 0x03D115, bank 2, boff: 0x4000
Maze read from: 0x03d115 - 250133
compresssed: 239
 00 00 00 00 00 02 92 0E 5E 9B 6A 42 28 68 C7 2C
 C0 52 1E C1 2B 42 28 6E C0 A2 C8 41 A2 CD A1 CA
 42 1E 61 C8 50 A1 1A CA 43 B2 A6 C5 28 CC 0A 86
 C1 54 A0 28 80 C6 54 0D 86 C6 A1 6C 41 1B 41 1B
 42 C5 A1 58 A2 C2 0B 85 A7 68 C6 47 C0 1A C1 04
 C5 1A 76 CF 04 CE A3 70 80 70 80 C4 A2 6E CD 1D
 CC 5F C1 B2 A0 CA A2 D0 A1 19 69 C2 BF C8 1A C4
 A1 C4 BF D0 A2 B2 A0 C2 A1 64 C3 A3 28 80 C1 28
 82 C3 A1 C2 A1 35 76 60 CD 19 A1 60 C0 A1 D2 BF
 C5 A1 C2 A1 52 BF A2 7A 53 19 A1 C2 A2 63 CB 35
 2C C5 A1 E2 C9 A2 03 82 B2 A1 B3 C4 19 A1 C2 B6
 73 A3 F1 69 06 65 CB 1A 60 62 C0 54 1C C2 AE B2
 AB C4 1D C7 1C C8 1C CC B2 A0 1C C5 B2 A0 1C D4
 A1 C1 A1 C2 A1 C1 A1 C5 05 E6 C5 1B A1 C5 1B A1
 50 B9 C4 BE C0 1D C0 B2 A0 56 A0 56 A0 C7 00
  Encoded length: 239 bytes
  Wall pattern: 02, Wall color: 02     Floor pattern: 00, Floor color: 09
  Flags: 
 02 02 02 02 02 02 02 02 02 02 02 02 02 02 02 02 02 02 02 02 02 02 02 02 02 02 02 02 02 02 02 02 02
 02 14 14 40 00 00 00 00 00 00 00 00 00 30 00 00 00 00 00 00 00 00 44 02 27 00 00 00 30 00 00 43 02
 02 14 14 40 00 00 00 00 00 00 00 00 00 00 00 00 00 00 00 30 00 02 02 02 00 00 00 00 00 00 00 00 02
 02 14 14 02 02 02 00 00 00 00 00 00 00 00 00 00 00 00 00 00 02 02 00 02 00 00 00 00 00 00 00 00 02
 02 14 14 14 30 02 00 30 00 00 00 00 00 00 00 00 00 27 00 02 02 26 00 02 00 00 00 00 00 00 00 00 02
 02 14 14 14 14 02 02 02 02 02 02 02 02 00 00 00 00 00 00 40 00 00 00 02 00 00 02 00 00 00 00 00 02
 02 10 10 10 10 10 10 10 02 00 00 27 00 00 00 00 00 02 40 40 00 00 00 02 00 00 02 27 00 00 00 00 02
 02 13 13 13 13 13 13 13 02 00 00 00 00 00 00 00 02 02 00 00 00 00 00 02 00 00 02 00 00 00 00 30 02
 02 14 27 14 14 27 14 14 02 00 00 00 00 00 00 02 02 27 00 00 00 00 00 02 00 00 02 02 02 02 00 00 02
 02 11 11 11 11 11 11 11 02 02 02 02 02 02 02 02 00 00 00 00 00 00 00 02 00 30 02 00 00 00 00 00 02
 02 14 14 14 14 14 14 14 02 00 26 00 00 04 00 00 00 00 00 00 26 00 00 02 00 00 02 00 42 00 00 00 02
 02 00 00 00 00 00 00 00 02 00 00 00 00 04 00 00 00 00 00 00 00 00 00 02 00 00 02 00 00 02 02 02 02
 02 00 42 42 00 42 42 00 02 00 00 00 02 02 02 00 00 00 00 00 00 00 00 02 00 00 02 00 00 00 30 00 02
 02 00 00 00 00 00 00 00 02 00 00 00 00 29 02 00 00 00 00 00 00 00 00 02 00 00 02 27 00 00 00 00 02
 02 00 00 00 00 00 00 00 02 00 00 00 00 00 02 02 00 00 00 00 00 00 00 02 00 00 02 02 02 02 00 00 02
 02 00 00 00 00 00 00 00 02 00 00 00 02 00 00 02 02 25 00 00 00 00 00 02 00 00 02 00 30 00 00 00 02
 02 00 00 00 00 00 00 00 02 00 26 00 02 00 00 00 02 02 00 00 00 00 00 02 00 00 02 00 00 00 00 00 02
 02 00 00 00 00 00 00 00 02 02 02 02 02 02 00 00 00 02 02 00 00 00 00 02 30 00 02 00 00 02 02 02 02
 02 40 40 00 00 40 40 40 02 00 00 00 00 02 02 00 00 00 02 02 53 00 00 02 00 00 02 00 42 00 30 00 02
 02 00 00 00 00 00 00 00 02 00 00 00 00 25 02 02 00 30 00 02 02 00 00 02 00 00 02 00 00 00 00 00 02
 02 00 00 00 00 00 00 00 02 00 00 02 00 00 00 02 02 00 00 00 02 02 27 02 00 00 02 02 02 02 00 00 02
 02 00 00 00 00 00 00 00 02 42 27 02 00 00 00 25 02 02 00 00 00 02 02 02 00 00 02 00 30 00 00 00 02
 02 00 00 00 00 00 00 00 02 53 44 02 00 00 00 00 00 02 02 00 00 00 02 02 00 00 02 00 00 00 00 00 02
 02 02 02 02 03 03 03 03 02 02 02 02 00 00 00 00 00 25 02 02 00 00 00 02 00 00 02 00 42 02 02 02 02
 02 00 00 00 00 00 00 00 00 00 00 00 00 00 00 00 00 00 00 02 02 00 00 00 00 00 02 00 00 00 30 06 02
 02 00 00 00 00 00 30 00 00 00 00 00 00 00 00 00 00 00 00 26 02 30 00 00 00 30 02 27 00 00 00 00 02
 02 28 00 00 00 02 02 02 02 02 02 02 02 02 02 02 02 02 02 02 02 02 02 02 02 02 02 02 02 02 02 02 02
 02 00 00 00 00 00 29 02 00 00 00 00 00 00 00 28 02 00 00 00 00 00 00 00 00 28 02 00 00 00 00 00 02
 02 00 00 00 00 00 00 02 02 28 00 00 00 00 00 00 02 02 28 00 00 00 00 00 00 00 02 00 00 00 00 00 02
 02 00 00 00 02 00 00 00 02 02 00 00 02 02 00 00 00 02 02 00 00 02 02 00 00 00 02 00 00 05 00 00 02
 02 00 00 00 02 02 00 00 00 00 00 00 27 02 02 00 00 00 00 00 00 27 02 02 27 00 02 00 00 00 00 00 02
 02 00 29 00 02 02 27 00 00 00 00 00 00 00 02 27 00 00 00 00 00 00 00 02 00 00 00 00 00 00 00 00 02
 02 02 02 02 02 02 02 02 02 02 02 02 02 02 02 02 02 02 02 02 02 02 02 02 02 02 02 02 02 02 02 02 02
