Gauntlet (rev 1 - 9)
Maze number: 76
Offset for maze 75: 231943 - 0x038a07
big endian buf: [%!l(uint8=0) %!l(uint8=3) %!l(uint8=138) %!l(uint8=7)]
G:1 Maze real addr: 256522 - 0x03EA0A, bank 3, boff: 0x6000
Maze read from: 0x03ea0a - 256522
compresssed: 256
 15 00 01 02 80 20 66 68 CE 11 9B C4 2A F5 27 C4
 70 A0 E8 E8 E7 E0 21 A0 0E 82 E8 11 81 A0 1E C7
 0B 80 A0 E1 0E 80 A0 C0 21 A4 21 E3 E0 E2 C3 0B
 A0 43 C1 1B A0 11 83 A0 E2 C1 2E A2 C5 27 C0 A1
 18 1B A0 E0 E6 E0 11 82 60 E7 C1 A1 E0 2A C6 2A
 A0 C4 B2 0E E7 C5 A2 C2 A2 E4 E4 E5 F6 1E E4 E0
 41 43 43 C6 A1 C3 B5 E0 7F C1 B2 E7 E0 E1 F1 E8
 C3 B2 CC B2 E2 0E C6 0B A0 F5 0E C5 0B 80 A0 43
 C3 05 43 C5 2C A0 C2 BF C1 0B 28 D3 53 2A 60 E5
 C1 54 D1 27 60 E6 E1 F1 E9 71 B2 CC B2 E0 C1 06
 C2 18 E4 2A A0 41 43 43 C2 1E A7 E0 E2 F0 C3 06
 E6 C4 A2 C2 A2 E4 E9 C3 A1 E8 E4 EC 2A 1B A0 E6
 1B A0 11 CD 51 51 A0 C2 18 C0 11 A0 11 82 E2 51
 51 52 C8 B2 27 C8 1E E0 C3 70 A0 41 B2 E7 E3 27
 2C B2 C3 2A B2 E0 C2 A2 1C C6 70 A3 C0 A1 C0 A4
 D7 0E 83 CE 0E 81 E0 F1 E6 0E 80 BE DC 0E 80 00
  Encoded length: 256 bytes
  Wall pattern: 00, Wall color: 06     Floor pattern: 02, Floor color: 06
  Flags: PLAYER_OFFSCREEN 
  ╚══> while gauntlet has these elements, these flags probably do not operate
 02 02 02 02 02 02 02 02 02 02 02 02 02 02 02 02 02 02 02 02 02 02 02 02 02 02 02 02 02 02 02 02 02
 02 00 00 00 00 42 00 00 00 00 00 00 00 00 00 00 00 00 00 00 00 00 00 00 00 00 00 00 02 39 00 00 02
 02 00 00 27 00 02 00 00 00 00 00 00 00 00 00 02 00 00 00 00 00 00 00 00 00 02 00 00 00 00 00 00 02
 02 00 02 00 02 33 02 14 14 14 14 00 00 00 00 00 00 00 00 00 02 17 17 17 02 30 00 00 00 00 00 00 02
 02 00 11 11 02 00 00 02 14 14 02 00 33 02 02 02 02 02 33 00 00 00 00 02 00 02 00 00 00 02 00 00 02
 02 00 11 02 00 00 00 00 40 00 00 27 02 17 17 17 17 17 02 00 00 00 02 00 00 46 02 02 02 00 00 00 02
 02 00 02 39 00 02 02 24 27 02 00 02 00 00 00 00 00 00 00 02 00 02 17 17 17 17 02 14 00 00 00 00 02
 02 00 02 00 02 00 00 02 02 00 02 42 00 00 00 00 00 00 00 42 02 00 00 00 00 00 02 14 00 00 00 00 02
 02 00 02 00 02 00 00 00 00 00 00 02 02 02 00 00 00 02 02 02 00 00 00 00 00 02 00 00 00 00 00 02 02
 02 00 02 00 00 00 02 00 00 00 00 00 00 00 00 00 00 00 00 00 00 00 00 00 02 00 00 00 00 00 02 30 02
 02 00 02 00 00 02 00 02 00 00 40 00 00 00 00 40 00 00 00 00 40 00 00 00 02 00 00 00 02 02 00 00 02
 02 00 02 00 02 27 00 00 02 00 00 00 00 00 00 00 00 00 00 00 00 00 02 00 02 00 00 00 00 00 00 00 02
 02 02 00 02 00 00 02 00 02 00 00 00 00 00 00 00 00 00 00 00 00 00 02 00 00 02 00 00 00 00 00 00 02
 02 00 00 02 00 00 17 00 02 00 00 00 00 00 00 00 00 00 00 00 00 00 02 00 00 17 02 14 00 00 00 00 02
 02 00 00 11 02 00 17 00 00 00 00 00 00 00 00 00 00 00 00 00 00 00 00 00 00 17 00 02 14 00 00 00 02
 02 00 00 11 11 02 17 00 00 00 40 00 00 00 00 05 00 00 00 00 40 00 00 00 00 17 00 44 02 00 00 00 02
 02 00 00 11 40 00 17 00 00 00 00 00 00 00 00 00 00 00 00 00 00 00 00 00 00 17 42 02 14 00 00 00 02
 02 00 00 02 00 00 17 00 02 00 00 00 00 00 00 00 00 00 00 00 00 00 02 00 00 39 02 14 00 00 00 00 02
 02 00 00 02 00 00 02 00 02 00 00 00 00 00 00 00 00 00 00 00 00 00 02 00 00 02 00 00 00 00 00 00 02
 02 00 00 00 02 27 00 00 02 00 00 00 00 00 00 00 00 00 00 00 00 00 02 00 02 00 00 06 00 00 00 24 02
 02 00 00 00 00 02 42 02 00 00 40 00 00 00 00 40 00 00 00 00 40 00 00 00 30 02 02 02 02 02 02 02 02
 02 00 02 00 00 00 02 00 00 00 00 00 00 00 00 00 00 00 00 00 00 00 00 00 02 00 00 00 00 06 00 00 02
 02 00 00 00 00 02 00 00 00 00 00 02 02 02 00 00 00 02 02 02 00 00 00 00 00 02 00 00 00 00 00 00 02
 02 00 00 00 02 00 00 00 00 02 02 00 00 00 00 00 00 00 00 00 02 00 00 00 00 17 02 00 00 00 00 00 02
 02 00 00 02 00 17 17 00 02 42 27 02 00 00 00 00 00 00 00 02 27 02 17 17 17 17 00 02 00 00 00 00 02
 02 00 00 02 00 17 17 02 00 00 00 24 02 17 02 17 17 17 02 00 00 00 02 17 17 17 00 02 00 00 00 00 02
 02 00 00 02 39 00 00 00 00 00 00 00 02 00 30 00 02 00 02 00 00 27 00 02 00 00 40 02 00 00 00 00 02
 02 00 00 00 02 00 00 00 00 02 39 44 02 00 00 00 00 42 02 00 02 00 00 00 02 02 02 28 00 00 00 00 02
 02 00 00 27 00 02 02 02 02 00 02 02 00 02 02 02 02 02 00 00 00 00 00 00 00 00 00 00 00 00 00 00 02
 02 00 00 00 00 00 00 00 00 00 14 14 14 14 14 00 00 00 00 00 00 00 00 00 00 00 00 00 00 00 14 14 02
 02 00 02 00 00 00 00 00 00 00 00 00 00 00 00 00 00 00 00 00 00 02 00 00 00 00 00 00 00 02 14 14 02
 02 00 00 00 00 00 00 00 00 00 00 00 00 00 00 00 00 00 00 00 00 00 00 00 00 00 00 00 00 00 14 14 02
 02 02 02 02 02 02 02 02 02 02 02 02 02 02 02 02 02 02 02 02 02 02 02 02 02 02 02 02 02 02 02 02 02
