Gauntlet (rev 1 - 9)
Maze number: 71
Offset for maze 70: 237182 - 0x039e7e
big endian buf: [%!l(uint8=0) %!l(uint8=3) %!l(uint8=158) %!l(uint8=126)]
G:1 Maze real addr: 245377 - 0x03BE81, bank 1, boff: 0x2000
Maze read from: 0x03be81 - 245377
compresssed: 213
 00 00 00 00 80 50 78 03 B5 04 16 06 80 C1 35 80
 C2 19 C0 1A C6 35 26 C0 28 C1 18 C2 28 C0 06 C3
 44 C4 44 C4 44 C6 28 C1 65 61 2B C6 28 C6 20 D5
 19 C1 19 C2 20 C4 26 C8 26 C3 2B CB 42 C3 54 43
 54 C4 43 55 C3 55 43 6F CC 35 81 DC 63 2B C7 16
 85 C3 28 CA 44 C4 45 C3 44 C6 68 35 84 DE 73 D7
 74 C5 2A 16 83 C5 26 C4 26 C1 54 44 C3 5D 45 C0
 20 DA 68 BF C1 5F CB 05 C4 6F CE 35 57 CA 51 44
 C4 4A C2 58 43 28 C3 18 C4 74 16 89 76 DF C5 1A
 C7 52 C2 2A C9 52 C6 35 4C 5C C8 49 6F CE 20 C8
 20 C6 60 20 C8 19 C0 6E 2A 56 6A 2A 43 C8 4F 43
 DF DD 2A C0 20 D8 45 D0 6C BE 06 C0 55 19 28 C0
 19 58 35 19 60 54 C2 28 18 28 C2 54 35 19 35 51
 C0 20 C0 06 00
  Encoded length: 213 bytes
  Wall pattern: 00, Wall color: 08     Floor pattern: 05, Floor color: 07
  Flags: PLAYER_OFFSCREEN 
  ╚══> while gauntlet has these elements, these flags probably do not operate
 02 02 02 02 02 02 02 02 02 02 02 02 02 02 02 02 02 02 02 02 02 02 02 02 02 02 02 02 02 02 02 02 02
 02 06 00 04 53 53 00 00 00 25 00 26 00 00 00 00 00 00 04 53 38 00 40 04 00 24 00 00 04 40 00 06 02
 02 00 00 04 03 03 03 03 04 00 00 00 00 04 03 03 03 03 04 00 00 00 00 04 03 03 03 03 04 00 00 00 02
 02 00 00 04 40 00 00 53 04 00 00 00 00 04 53 00 00 43 04 00 00 00 00 04 00 40 00 00 04 00 00 00 02
 02 32 00 04 00 00 00 00 04 00 00 00 00 04 00 00 00 00 04 00 00 00 00 04 25 00 00 25 04 00 00 32 02
 02 00 00 04 00 38 00 00 04 00 00 00 00 04 00 38 00 00 04 00 43 00 00 04 00 00 00 00 04 00 00 00 02
 02 03 03 04 00 00 00 00 04 03 03 03 03 04 00 00 00 00 04 03 03 03 03 04 00 00 00 00 04 03 03 03 02
 02 53 00 04 00 00 00 00 00 00 00 00 00 00 00 00 00 00 04 00 00 00 00 00 00 00 00 00 00 00 00 53 02
 02 53 00 04 00 00 00 00 00 00 00 00 00 00 00 00 00 00 04 00 00 00 00 00 00 00 00 00 00 00 00 53 02
 02 00 00 04 43 00 00 00 00 00 00 00 22 22 22 22 22 22 04 22 00 00 00 00 40 00 00 00 00 00 00 00 02
 02 00 00 04 03 03 03 03 04 00 00 00 22 04 03 03 03 03 04 22 00 00 00 04 03 03 03 03 04 00 00 00 02
 02 00 00 04 53 00 00 00 04 00 00 00 22 04 53 53 53 53 04 22 00 00 00 04 00 00 00 00 04 00 00 00 02
 02 00 00 04 00 00 00 00 04 00 00 00 22 04 00 00 00 00 04 22 00 00 00 04 00 00 00 00 04 00 00 00 02
 02 00 00 04 00 00 00 00 04 00 00 00 22 04 00 00 00 00 04 42 22 22 22 04 22 00 00 00 04 00 00 38 02
 02 00 00 04 00 38 00 00 04 03 03 03 03 04 00 00 00 00 04 03 03 03 03 04 22 00 32 00 04 00 00 00 02
 02 00 00 04 00 00 00 00 00 00 00 00 22 04 00 00 00 00 00 00 00 00 53 04 22 00 00 00 04 00 00 00 02
 02 00 00 04 00 00 00 00 00 00 00 00 22 04 00 00 05 00 00 00 00 00 53 04 22 00 00 00 04 00 00 00 02
 02 00 00 04 00 00 00 00 00 00 00 00 22 04 00 00 00 00 00 00 00 00 53 04 22 00 00 00 04 00 00 00 02
 02 00 00 04 03 03 03 03 03 00 00 00 22 04 03 03 03 03 03 03 03 03 03 03 22 00 00 00 04 03 03 03 02
 02 40 00 00 00 00 24 00 04 00 00 00 22 04 22 22 22 22 04 22 22 22 22 04 22 00 00 00 00 00 00 00 02
 02 00 00 00 00 00 00 00 04 00 00 00 00 04 00 00 00 00 04 00 00 00 00 04 00 00 00 00 00 00 00 26 02
 02 00 00 00 00 00 00 00 04 00 00 00 42 04 00 00 00 00 04 00 00 00 00 04 00 00 00 00 00 00 00 53 02
 02 03 03 03 03 03 03 03 03 03 03 03 03 04 00 00 00 00 04 00 00 00 00 03 03 03 03 03 03 03 03 03 02
 02 53 00 00 00 00 00 00 04 00 00 00 00 00 00 00 00 00 04 00 00 00 00 00 00 00 00 00 00 00 00 00 02
 02 32 00 00 00 00 00 00 04 00 00 32 00 00 00 00 00 00 04 53 00 32 00 00 00 00 00 00 00 00 00 25 02
 02 53 00 00 00 00 00 00 04 00 00 00 00 00 00 00 00 42 04 53 00 00 00 00 00 00 00 00 00 00 00 42 02
 02 03 03 04 00 00 00 00 04 00 00 00 00 03 03 03 03 03 03 03 03 03 03 03 03 03 03 03 03 03 03 03 02
 02 00 00 04 00 00 00 00 04 00 00 00 00 04 00 00 00 00 00 00 00 00 00 04 00 00 00 00 00 00 00 00 02
 02 00 00 04 00 00 00 00 04 00 00 00 00 04 00 00 00 00 00 00 00 00 00 04 00 00 00 00 00 00 00 42 02
 02 32 00 04 00 00 00 00 04 00 00 00 00 04 00 00 00 00 00 00 00 00 00 04 00 00 00 03 03 03 03 03 02
 02 00 00 04 00 00 00 00 04 00 00 00 00 04 00 00 00 00 53 00 00 00 00 04 00 00 00 04 00 00 00 00 02
 02 06 00 04 25 40 00 25 04 53 25 53 00 04 00 00 00 40 24 40 00 00 00 04 53 25 53 04 00 32 00 06 02
 02 02 02 02 02 02 02 02 02 02 02 02 02 02 02 02 02 02 02 02 02 02 02 02 02 02 02 02 02 02 02 02 02
