Gauntlet (rev 1 - 9)
Maze number: 68
Offset for maze 67: 236507 - 0x039bdb
big endian buf: [%!l(uint8=0) %!l(uint8=3) %!l(uint8=155) %!l(uint8=219)]
G:1 Maze real addr: 244702 - 0x03BBDE, bank 1, boff: 0x2000
Maze read from: 0x03bbde - 244702
compresssed: 262
 00 00 00 00 00 30 40 5D E0 9A DF 2B 80 D3 04 C7
 06 E8 40 E0 40 E0 42 A0 40 C0 A1 40 E9 1F A0 E0
 1F A0 E0 1F A0 E1 2C A0 E0 E1 E0 45 E0 E2 E2 C2
 61 E1 E3 2B A0 E3 E0 EC 20 EC 35 A0 EA E2 E2 1F
 A0 E5 1F E3 E2 E2 E0 E2 E0 E0 E7 E2 C3 28 A0 2A
 A0 C0 50 A0 E2 C1 28 A0 56 A0 28 A0 E4 19 A0 E4
 E4 E1 E6 2A E3 E4 E2 E2 E3 E6 E2 E6 E0 E0 E2 E3
 E4 2A A0 E4 E4 C0 50 A0 E2 C2 53 A0 40 2A A0 E2
 C1 A1 E2 E2 E2 C3 03 80 A0 C3 19 E1 E1 E9 E2 EB
 E1 E3 E2 E2 E2 C0 BF 1D CD 05 E1 E2 E4 E2 E1 EE
 E2 E2 C9 B4 E1 E1 E8 E2 EB E1 E1 E2 E2 28 1F E0
 E3 E3 E2 E2 E1 E0 E2 E0 35 A0 E3 20 E4 1D A0 E0
 E9 E2 E3 E7 E1 E2 ED EC E2 19 A0 19 A0 E2 E4 EC
 C0 51 A0 E0 E2 E2 E8 E3 E1 E7 EC E3 20 E2 E2 E1
 E2 E8 E3 E3 E2 C0 A1 40 E0 ED E7 E3 E0 E1 E4 E4
 E7 E5 E3 E2 20 EA E5 E7 E0 20 C1 BE 20 A0 E5 1D
 E5 20 E1 C8 35 00
  Encoded length: 262 bytes
  Wall pattern: 00, Wall color: 00     Floor pattern: 03, Floor color: 04
  Flags: 
 02 02 02 02 02 02 02 02 02 02 02 02 02 02 02 02 02 02 02 02 02 02 02 02 02 02 02 02 02 02 02 02 02
 02 43 00 00 00 00 00 00 00 00 00 00 00 00 00 00 00 00 00 00 00 00 04 00 00 00 00 00 00 00 00 06 02
 02 00 00 00 00 00 00 00 00 02 00 29 00 02 00 29 00 02 00 00 00 29 02 00 29 00 02 02 00 29 00 00 02
 02 00 00 00 00 00 00 00 02 31 02 00 02 31 02 00 02 31 02 00 00 02 44 02 00 02 00 00 02 00 02 00 02
 02 00 00 00 00 29 00 02 00 00 00 02 00 00 00 02 00 00 00 02 02 32 00 00 02 00 00 00 00 02 43 02 02
 02 00 00 00 02 00 02 00 00 00 00 00 00 00 00 00 00 00 00 00 02 32 00 00 00 00 00 00 00 00 00 00 02
 02 00 00 02 53 02 00 00 00 00 00 00 00 00 00 00 00 02 00 00 00 02 00 00 00 02 31 02 00 00 00 00 02
 02 00 02 31 00 00 00 00 02 00 00 00 02 00 00 00 02 00 02 00 00 00 02 00 02 00 02 00 00 00 00 00 02
 02 00 00 02 00 00 00 02 00 00 00 00 40 02 42 02 00 26 00 02 00 00 00 02 00 00 40 02 26 00 00 00 02
 02 00 00 00 02 40 02 00 00 00 00 00 02 25 02 00 00 00 00 00 02 00 00 00 00 00 02 00 00 02 00 00 02
 02 00 00 00 00 02 42 00 00 00 00 02 00 00 00 00 00 02 00 00 00 02 00 00 00 02 00 00 00 00 02 00 02
 02 00 00 00 00 00 02 00 00 00 02 00 00 00 00 00 00 00 02 00 02 00 02 00 00 00 02 00 00 00 00 02 02
 02 00 00 00 00 02 42 02 00 00 00 00 00 02 00 00 00 00 00 02 00 26 00 02 00 00 00 02 00 00 00 26 02
 02 00 00 00 02 00 29 42 02 00 00 00 02 00 00 02 02 00 00 00 02 00 00 00 02 00 00 00 02 00 00 00 02
 02 03 03 02 00 00 00 02 25 00 00 02 00 00 02 00 00 00 00 00 00 00 00 00 00 02 00 00 00 02 00 00 02
 02 00 00 00 00 00 00 02 00 00 02 00 00 02 00 00 00 00 02 00 00 00 02 00 00 00 02 00 00 00 02 00 02
 02 29 00 00 00 00 00 02 00 00 00 00 00 00 00 00 05 00 00 02 00 00 00 02 00 00 00 00 00 02 00 00 02
 02 02 00 00 02 00 00 02 00 00 00 00 00 00 00 00 00 00 00 00 02 00 00 00 02 00 00 00 02 00 00 00 02
 02 00 00 00 00 00 00 02 00 00 02 00 00 02 00 00 00 00 00 00 00 00 00 02 00 00 00 02 00 00 00 00 02
 02 00 00 00 00 00 00 00 02 00 00 02 00 00 02 00 00 00 02 00 00 00 02 40 31 00 02 00 00 00 00 02 02
 02 00 00 00 02 00 00 00 02 00 00 00 02 00 00 02 00 02 00 00 00 02 00 02 53 02 00 00 00 00 02 32 02
 02 00 00 00 00 02 29 02 00 02 00 00 00 00 00 00 00 00 00 00 02 00 00 00 02 00 00 00 00 02 00 00 02
 02 00 00 00 00 00 02 00 00 02 00 00 00 02 00 00 00 00 00 00 00 00 00 00 00 00 00 00 02 00 00 00 02
 02 00 00 00 00 00 00 00 00 00 02 00 00 00 02 25 02 25 02 00 00 00 02 00 00 00 00 00 02 00 00 00 02
 02 00 00 00 00 00 00 00 00 00 02 00 26 00 00 02 00 02 00 00 00 02 00 00 00 02 00 00 00 00 00 00 02
 02 00 00 02 00 00 00 00 02 00 00 02 00 00 00 00 00 00 00 00 02 00 00 00 00 00 00 00 00 00 00 00 02
 02 00 02 00 00 00 00 02 32 00 00 00 02 00 00 00 02 00 00 02 00 00 00 02 00 00 00 00 00 00 00 00 02
 02 02 00 00 00 00 02 00 00 00 00 02 00 00 00 02 00 02 02 00 29 00 02 00 00 00 00 00 00 00 00 00 02
 02 00 00 00 00 02 00 00 00 00 00 00 00 00 02 00 00 00 00 02 00 02 00 00 02 00 00 00 00 00 02 00 02
 02 00 00 00 02 00 00 00 00 00 00 00 00 02 00 00 00 00 00 00 02 00 00 00 00 02 00 00 00 02 32 00 02
 02 00 00 00 00 00 00 00 00 00 02 00 00 00 00 00 00 02 00 00 00 00 00 00 00 00 02 00 02 32 00 00 02
 02 32 02 00 00 00 00 00 00 02 29 00 00 00 00 00 00 02 32 00 00 02 00 00 00 00 00 00 00 00 00 53 02
 02 02 02 02 02 02 02 02 02 02 02 02 02 02 02 02 02 02 02 02 02 02 02 02 02 02 02 02 02 02 02 02 02
