Gauntlet (rev 1 - 9)
Maze number: 75
Offset for maze 74: 231611 - 0x0388bb
big endian buf: [%!l(uint8=0) %!l(uint8=3) %!l(uint8=136) %!l(uint8=187)]
G:1 Maze real addr: 256190 - 0x03E8BE, bank 3, boff: 0x6000
Maze read from: 0x03e8be - 256190
compresssed: 329
 14 2A 01 02 08 52 19 A8 94 06 93 40 2A C2 1F C0
 42 28 81 C6 41 2A 63 40 51 C0 06 28 06 C0 51 CF
 51 06 81 C6 12 06 C5 52 D0 52 C2 06 80 CC 05 C6
 06 82 C2 52 C3 06 81 C6 54 C3 54 C2 28 70 4D 52
 06 80 C1 43 41 54 06 81 C2 06 81 C2 06 80 C8 28
 80 06 80 28 06 C0 44 53 C4 52 C1 4F C7 06 80 42
 72 51 06 81 C4 46 06 81 C2 72 06 81 D2 45 51 C2
 28 52 C8 48 7F C5 53 C1 52 C1 54 C9 06 84 C1 7F
 C0 52 C5 1F 44 42 56 C3 44 54 C3 53 C3 06 80 C3
 53 75 06 51 06 80 D5 55 C5 76 06 82 CF 06 C1 06
 C0 06 C0 06 C5 28 78 52 C0 06 82 C0 41 40 40 28
 53 C3 06 82 C0 55 C0 52 C0 28 52 CA 06 C0 06 C0
 06 C1 52 CB 40 06 80 C1 06 81 C4 65 60 06 80 C5
 51 C6 41 54 C1 06 28 06 C6 43 06 D2 06 83 C5 28
 80 06 81 C8 21 C2 28 06 C2 23 C7 23 40 44 52 C1
 52 C4 06 46 53 C2 53 C5 52 C1 4A 06 81 C0 40 4C
 06 82 C7 14 28 62 06 C6 52 C2 63 46 51 C7 54 C3
 61 06 81 C1 06 81 C2 55 C0 51 C4 52 DF C0 06 81
 C2 53 C0 06 81 C6 06 81 C6 53 CB 28 80 06 2A 51
 28 21 51 60 2A 55 40 51 28 80 52 C0 2C C0 51 21
 28 06 28 06 2A 28 06 C0 00
  Encoded length: 329 bytes
  Wall pattern: 02, Wall color: 09     Floor pattern: 05, Floor color: 01
  Flags: 
 02 02 02 02 02 02 02 02 02 02 02 02 02 02 02 02 02 02 02 02 02 02 02 02 02 02 02 02 02 02 02 02
 40 06 42 00 00 00 31 06 40 00 00 06 40 40 06 00 00 00 00 06 00 00 40 00 06 42 20 00 00 06 00 40
 00 06 00 06 40 06 00 06 00 00 00 06 00 00 06 00 00 00 00 06 00 00 06 00 06 06 06 06 00 06 00 06
 00 00 00 18 06 00 00 00 00 00 00 06 00 00 06 00 00 00 00 06 00 00 06 00 00 00 00 00 00 06 00 06
 00 06 06 00 00 00 00 00 00 06 00 00 00 00 06 00 05 00 00 06 00 00 06 00 06 06 06 06 00 00 00 06
 00 00 00 00 06 06 06 00 00 06 00 00 00 00 06 00 00 00 00 06 00 00 06 40 19 00 40 06 00 00 00 00
 00 06 00 00 00 00 00 00 00 06 06 06 00 00 40 00 00 00 00 40 00 00 06 06 06 06 00 06 00 06 06 06
 00 06 00 06 06 00 00 00 00 00 00 00 00 00 40 40 06 06 40 06 00 40 00 00 00 00 00 06 00 00 00 00
 00 06 00 00 40 00 00 06 00 00 00 00 06 00 00 00 00 00 00 00 00 06 00 00 00 00 00 00 00 06 06 40
 00 00 00 19 06 00 00 06 06 06 06 00 06 00 00 06 40 00 00 00 00 06 00 00 06 06 06 00 00 00 19 06
 00 00 06 06 06 00 00 00 00 00 00 00 06 00 00 06 00 00 06 00 00 06 00 06 40 00 00 00 00 00 00 06
 00 00 00 40 06 00 00 00 00 06 00 00 06 00 40 06 00 00 06 00 00 06 00 06 19 00 06 00 06 00 00 00
 00 00 00 00 00 00 00 06 00 06 00 00 06 00 00 06 00 00 06 00 00 06 00 06 00 00 06 00 06 00 00 00
 06 06 06 06 06 06 00 06 19 06 00 00 06 00 00 00 00 00 00 00 00 00 00 06 00 00 06 00 06 00 06 00
 00 31 40 00 00 00 00 06 40 06 00 00 06 00 00 00 06 40 00 00 00 00 00 06 00 00 00 00 06 00 06 00
 00 06 06 00 00 00 00 06 19 06 00 00 00 00 00 06 06 06 06 00 06 00 00 00 00 00 00 00 00 00 06 00
 00 00 00 00 00 06 00 00 00 06 00 00 00 00 00 00 19 00 00 00 06 00 00 00 06 06 06 06 00 00 06 00
 06 00 00 06 00 06 00 00 00 00 00 00 06 06 00 06 00 06 00 06 06 00 06 00 00 00 40 19 00 00 06 00
 06 00 00 06 00 06 00 06 06 06 06 00 40 06 00 40 00 40 00 40 06 00 06 00 00 06 06 06 06 00 06 00
 06 00 40 06 00 00 00 00 00 00 00 00 00 06 00 06 00 06 00 06 00 00 06 00 00 00 00 00 00 00 00 00
 00 00 06 40 00 06 06 00 00 06 06 06 00 06 00 00 00 20 00 00 00 00 00 00 20 00 06 06 00 00 00 00
 00 00 06 00 00 00 00 00 00 00 40 00 00 06 00 00 06 40 06 00 00 00 00 00 00 06 40 00 00 06 00 06
 00 00 00 00 00 00 00 06 00 00 06 00 00 00 00 00 00 00 00 06 06 06 06 06 00 06 00 00 00 06 40 40
 06 06 06 00 06 00 00 06 00 00 06 00 33 00 06 00 40 06 00 00 00 35 00 00 00 06 00 06 00 06 35 40
 00 40 00 00 06 00 00 06 00 00 06 00 00 00 06 00 06 40 00 00 00 00 00 00 00 06 00 06 00 06 00 00
 00 06 00 00 06 00 00 40 00 00 00 00 00 00 06 00 00 00 00 06 06 06 00 40 00 40 00 06 00 00 00 00
 00 06 00 00 00 00 00 06 06 06 06 00 06 00 06 00 00 00 06 20 40 20 06 00 00 06 00 06 00 00 06 00
 00 06 00 00 00 20 00 00 00 00 40 00 06 00 06 00 06 00 06 00 06 00 06 00 00 00 00 06 00 00 06 00
 20 00 00 06 06 06 00 00 06 06 06 00 06 00 06 00 06 00 00 00 06 00 06 00 00 00 00 00 00 00 06 00
 00 00 00 00 00 00 00 00 00 00 00 00 06 00 00 00 00 00 06 00 06 00 00 00 06 06 06 00 00 00 06 00
 06 06 06 00 00 06 00 00 06 00 06 06 06 00 00 06 00 00 06 00 06 00 06 00 00 00 00 00 00 00 00 00
 00 40 40 06 42 06 40 33 06 20 00 42 06 40 00 06 40 40 06 00 44 00 06 33 40 06 40 06 42 40 06 00
 02 02 02 02 02 02 02 02 02 02 02 02 02 02 02 02 02 02 02 02 02 02 02 02 02 02 02 02 02 02 02 02
