Gauntlet (rev 1 - 9)
Maze number: 72
Offset for maze 71: 229376 - 0x038000
big endian buf: [%!l(uint8=0) %!l(uint8=3) %!l(uint8=128) %!l(uint8=0)]
G:1 Maze real addr: 253955 - 0x03E003, bank 3, boff: 0x6000
Maze read from: 0x03e003 - 253955
compresssed: 264
 17 3B 0C 1F 80 42 F2 68 59 A0 9A 2A 80 43 C0 1B
 C4 06 40 42 40 A0 71 28 42 C0 1B 6F C3 A1 C3 1B
 C2 A2 C2 B2 E9 B2 C7 B2 A0 42 DF 47 C0 1B EA C7
 1B C3 A4 B3 E5 C4 73 A0 C7 71 19 40 65 C9 1B C9
 B2 C4 2A C0 2C 49 C2 2A A2 C8 B3 A1 B8 A2 B3 C2
 B4 A0 E1 B3 A3 6E E9 74 1A 80 C1 2C CE B2 CD B6
 A1 CD 77 28 6D 38 A0 38 C3 A5 C1 A2 28 46 C3 38
 C2 38 42 80 C1 1A A0 E1 06 AA C2 38 E2 60 40 80
 C7 BF C0 51 1F C1 1F 61 E1 C0 05 C0 38 42 80 7D
 B2 C5 38 C2 38 C2 AA C1 B3 CA 38 A0 38 19 C2 1C
 E0 28 C0 1C C2 1C D4 B8 C5 B2 CC B9 64 F2 C0 1F
 C6 A5 42 CB A3 2B C6 50 1D A5 E3 42 C5 A4 B2 C7
 1D C2 1C 28 C0 1C C2 A1 C2 50 28 C2 5A B3 A2 B2
 CD B2 E1 C4 1D C4 1D C5 52 A2 C7 2B E2 B4 48 C5
 5F 28 E1 C2 A2 28 D8 B4 E1 1D A3 E1 B9 EB CB 5F
 C1 1D C2 A1 C5 BE 48 B2 50 B3 C0 06 BA 06 C1 B2
 28 C0 1D A0 1D C3 2A 00
  Encoded length: 264 bytes
  Wall pattern: 02, Wall color: 02     Floor pattern: 04, Floor color: 15
  Flags: PLAYER_OFFSCREEN 
  ╚══> while gauntlet has these elements, these flags probably do not operate
 02 02 02 02 02 02 02 02 02 02 02 02 02 02 02 02 02 02 02 02 02 02 02 02 02 02 02 02 02 02 02 02 02
 02 42 00 00 00 00 40 02 27 00 00 00 00 00 06 02 40 00 00 02 40 00 40 02 26 00 00 40 02 00 00 40 02
 02 27 00 00 00 00 00 02 00 00 00 00 00 00 00 02 00 00 25 02 00 00 00 02 02 00 00 00 02 27 00 00 02
 02 02 02 02 00 00 00 02 00 00 00 02 00 00 00 02 00 00 02 02 00 00 00 00 00 00 00 00 02 02 00 00 02
 02 40 00 00 00 00 00 00 00 00 00 02 00 00 00 02 00 00 00 00 00 00 00 00 00 00 00 00 00 00 00 00 02
 02 00 00 00 00 00 00 00 00 00 40 02 27 00 00 02 00 00 00 00 00 00 00 02 02 00 00 00 00 00 00 00 02
 02 27 00 00 00 02 02 02 02 02 02 02 02 00 00 02 00 00 02 02 00 00 00 02 26 00 00 00 02 02 00 00 02
 02 00 00 00 00 02 26 00 02 25 00 40 02 00 00 02 00 00 25 02 00 00 00 02 00 00 00 00 02 27 00 00 02
 02 00 00 00 00 02 00 00 02 00 00 00 02 00 42 02 44 00 00 02 00 00 00 02 00 00 00 40 02 00 00 42 02
 02 02 02 00 00 02 00 00 00 00 00 00 02 02 02 02 02 02 02 02 00 00 02 02 02 00 00 02 02 02 02 02 02
 02 00 00 00 00 02 00 00 00 00 00 00 00 00 00 00 25 00 00 00 00 00 02 00 00 00 00 02 26 00 00 00 02
 02 00 26 26 00 02 44 00 00 00 02 00 00 00 00 00 00 00 00 00 00 02 02 00 00 00 00 00 00 00 00 00 02
 02 00 00 00 00 02 02 02 00 00 02 00 00 00 00 00 00 00 00 00 00 02 26 00 00 00 00 00 00 00 00 40 02
 02 00 00 00 00 00 00 00 00 00 02 00 00 00 25 56 02 56 00 00 00 02 02 02 02 02 02 02 00 00 02 02 02
 02 40 00 00 00 00 00 00 00 40 02 00 00 00 56 00 00 00 56 00 00 02 40 40 00 00 26 02 00 00 02 06 02
 02 02 02 02 02 02 02 02 02 02 02 00 00 00 56 00 00 00 02 00 25 02 40 40 00 00 00 00 00 00 00 00 02
 02 00 32 02 00 31 00 02 31 00 02 25 00 00 02 00 05 00 56 00 00 02 40 40 26 00 00 00 00 00 00 00 02
 02 00 00 02 00 00 00 02 00 00 02 00 00 00 56 00 00 00 56 00 00 02 02 02 02 02 02 02 02 02 02 02 02
 02 00 00 02 00 00 00 00 00 00 02 00 00 00 00 56 02 56 25 00 00 02 28 00 02 40 00 28 02 00 00 28 02
 02 00 00 00 00 00 00 00 00 00 02 00 00 00 00 00 00 00 00 00 00 02 00 00 00 00 00 00 02 00 00 00 02
 02 00 00 00 00 00 00 02 00 00 02 00 00 00 00 00 25 00 00 00 00 00 00 00 00 00 00 00 00 00 00 00 02
 02 00 00 00 02 00 31 02 00 00 00 00 00 02 02 02 02 02 02 02 00 00 00 40 02 00 00 00 00 00 00 00 02
 02 00 00 00 02 02 02 02 43 00 00 00 00 02 00 00 32 02 29 02 02 02 02 02 02 00 00 00 02 02 00 00 02
 02 40 00 00 00 00 00 02 02 02 02 02 02 02 00 00 00 02 00 00 00 02 29 00 02 00 28 40 02 28 00 00 02
 02 02 02 00 00 00 32 02 40 00 00 02 32 00 00 00 00 02 00 00 00 02 00 00 02 02 02 02 02 00 00 00 02
 02 00 00 00 00 00 00 02 00 00 00 02 00 00 02 00 00 02 00 00 29 02 00 00 00 00 29 02 00 00 00 00 02
 02 32 00 00 00 02 02 02 00 00 00 00 00 00 00 00 43 02 00 00 02 02 00 00 00 00 00 02 00 00 00 40 02
 02 00 00 00 00 00 32 02 00 00 00 00 00 00 00 00 00 02 00 00 00 00 00 40 00 00 02 02 00 00 02 02 02
 02 40 00 00 00 00 00 02 00 00 00 00 00 00 02 00 00 02 00 00 00 00 00 00 00 00 00 02 00 00 02 29 02
 02 02 02 02 00 00 02 02 00 00 00 02 00 00 02 00 00 02 00 00 02 02 00 00 00 00 00 00 00 00 00 00 02
 02 32 00 00 00 00 00 00 00 00 00 02 00 00 02 00 00 02 00 00 29 02 00 00 02 02 00 00 00 00 00 00 02
 02 00 00 00 00 00 00 00 00 00 40 02 32 00 02 00 06 02 06 00 00 02 40 00 29 02 29 00 00 00 00 42 02
 02 02 02 02 02 02 02 02 02 02 02 02 02 02 02 02 02 02 02 02 02 02 02 02 02 02 02 02 02 02 02 02 02
