Gauntlet (rev 1 - 9)
Maze number: 7
Offset for maze 6: 230776 - 0x038578
big endian buf: [%!l(uint8=0) %!l(uint8=3) %!l(uint8=133) %!l(uint8=120)]
G:1 Maze real addr: 230779 - 0x03857B, bank 0, boff: 0x0000
Maze read from: 0x03857b - 230779
compresssed: 90
 00 00 00 00 00 10 21 68 59 5A 5B 2B 80 DC 06 C2
 18 D1 1B 28 48 DE AB C5 AB 52 D9 28 43 DF DF 72
 4E 70 DF C3 2C C5 AF AA DF 5C 41 DF DF 53 42 59
 41 D8 BF 4A D3 AF A9 DF C2 BF CE 2A 62 6F DF DF
 49 C6 2A 62 DF 41 C6 AF A8 B5 DF DF 18 CF 05 6F
 DC 28 DE 28 DE 28 BE DD 28 00
  Encoded length:  90 bytes
  Wall pattern: 00, Wall color: 01     Floor pattern: 01, Floor color: 02
  Flags: 
 02 02 02 02 02 02 02 02 02 02 02 02 02 02 02 02 02 02 02 02 02 02 02 02 02 02 02 02 02 02 02 02 02
 02 43 00 00 00 00 00 00 00 00 00 00 00 00 00 00 00 00 00 00 00 00 00 00 00 00 00 00 00 00 00 06 02
 02 00 00 24 00 00 00 00 00 00 00 00 00 00 00 00 00 00 00 00 00 00 27 40 00 00 00 00 00 00 00 00 02
 02 40 00 00 00 00 00 00 00 00 00 00 00 00 00 00 00 00 00 00 00 00 00 00 00 00 00 00 00 00 02 00 02
 02 02 02 02 02 02 02 02 02 02 02 02 02 00 00 00 00 00 00 02 02 02 02 02 02 02 02 02 02 02 02 00 02
 02 00 26 00 00 00 00 00 00 00 00 00 00 00 00 00 00 00 00 00 00 00 00 00 00 00 00 00 00 40 02 00 02
 02 00 40 00 00 00 00 00 00 00 00 00 00 00 00 00 00 00 00 00 00 00 00 00 00 00 00 00 00 00 02 00 02
 02 00 00 00 00 00 00 00 00 00 00 00 00 00 00 00 00 00 00 00 00 00 00 00 00 00 00 00 00 00 02 00 02
 02 00 00 00 00 00 27 00 00 00 00 00 00 00 00 00 00 00 00 00 00 00 40 00 27 00 00 00 00 00 02 00 02
 02 00 00 00 00 00 00 00 00 00 00 00 00 00 00 00 00 00 00 00 00 00 00 00 00 00 00 00 00 44 02 00 02
 02 00 00 00 02 02 02 02 02 02 02 02 02 02 02 02 02 02 02 02 02 02 02 02 02 02 02 02 02 02 02 00 02
 02 00 00 00 00 00 00 00 00 00 00 00 00 00 00 00 00 00 00 00 00 00 00 00 00 00 00 00 00 00 02 00 02
 02 00 00 00 00 00 00 00 00 00 00 00 26 00 00 40 00 00 00 00 00 00 00 00 00 00 00 00 00 00 02 00 02
 02 00 00 00 00 00 00 00 00 00 00 00 00 00 00 00 00 00 00 00 00 00 00 00 00 00 00 00 00 00 02 00 02
 02 00 00 00 00 00 00 00 00 00 00 00 00 00 00 00 00 00 00 00 26 00 00 00 40 00 00 00 00 00 02 00 02
 02 00 00 26 00 00 40 00 00 00 00 00 00 00 00 00 00 00 00 00 00 00 00 00 00 00 00 00 00 00 02 00 02
 02 00 00 00 00 00 00 00 00 00 00 00 40 00 00 00 00 00 00 00 00 00 00 00 00 00 00 00 00 00 02 00 02
 02 02 02 02 02 02 02 02 02 02 02 02 02 02 02 02 02 02 02 02 02 02 02 02 02 02 02 00 00 00 02 00 02
 02 00 00 00 00 00 00 00 00 00 00 00 00 00 00 00 00 00 00 00 00 00 00 00 00 00 00 00 00 00 02 00 02
 02 00 00 00 00 00 00 00 00 00 00 00 00 00 42 00 00 00 25 00 00 00 00 00 00 00 00 00 00 00 02 00 02
 02 00 00 25 00 00 00 00 00 00 00 00 00 00 00 00 00 00 00 00 00 00 00 00 00 00 00 00 00 00 02 00 02
 02 00 00 00 00 00 00 00 00 00 00 00 00 00 00 00 00 00 00 00 00 00 00 00 00 00 00 00 00 00 02 00 02
 02 00 00 00 00 00 00 00 00 00 00 00 00 00 40 00 00 00 00 00 00 00 42 00 00 00 25 00 00 00 02 00 02
 02 00 00 00 00 00 00 00 00 00 00 00 00 00 00 00 00 00 00 00 00 00 00 00 00 00 00 00 00 40 02 00 02
 02 00 00 00 00 02 02 02 02 02 02 02 02 02 02 02 02 02 02 02 02 02 02 02 02 02 02 02 02 02 02 00 02
 02 00 00 00 00 00 00 00 00 00 00 00 00 00 00 00 00 00 00 00 00 00 00 00 00 00 00 00 00 00 00 00 02
 02 00 00 00 00 00 00 00 00 00 00 00 00 00 00 00 00 00 00 00 00 00 00 00 00 00 00 00 00 00 00 24 02
 02 00 00 00 00 00 00 00 00 00 00 00 00 00 00 00 05 00 00 00 00 00 00 00 00 00 00 00 00 00 00 00 02
 02 25 00 00 00 00 00 00 00 00 00 00 00 00 00 00 00 00 00 00 00 00 00 00 00 00 00 00 00 00 00 40 02
 02 00 00 00 00 00 00 00 00 00 00 00 00 00 00 00 00 00 00 00 00 00 00 00 00 00 00 00 00 00 00 40 02
 02 00 00 00 00 00 00 00 00 00 00 00 00 00 00 00 00 00 00 00 00 00 00 00 00 00 00 00 00 00 00 40 02
 02 00 00 00 00 00 00 00 00 00 00 00 00 00 00 00 00 00 00 00 00 00 00 00 00 00 00 00 00 00 00 40 02
 02 02 02 02 02 02 02 02 02 02 02 02 02 02 02 02 02 02 02 02 02 02 02 02 02 02 02 02 02 02 02 02 02
