Gauntlet (rev 1 - 9)
Maze number: 58
Offset for maze 57: 234376 - 0x039388
big endian buf: [%!l(uint8=0) %!l(uint8=3) %!l(uint8=147) %!l(uint8=136)]
G:1 Maze real addr: 242571 - 0x03B38B, bank 1, boff: 0x2000
Maze read from: 0x03b38b - 242571
compresssed: 168
 0E 1D 00 02 00 01 25 A8 AA 61 65 1B 80 D4 40 62
 21 A0 4F EC C9 28 1D 7C A0 E2 C7 A3 67 A0 E3 E2
 20 E0 F1 20 E6 CB 05 D8 40 64 B2 F1 C8 A2 C6 B2
 E9 C2 66 A0 E6 5A E2 E7 E4 EE 21 C3 B7 E3 E2 1D
 ED EE D2 19 E9 F0 4A A0 C2 A4 C5 B5 27 C4 A9 74
 E9 C3 BF C1 1F D1 BF E4 D5 41 A0 53 A0 C9 6D A0
 C5 42 4A A0 C0 40 B5 E2 D6 25 A2 E2 C8 4F E4 57
 C6 A4 E8 C3 A2 B4 C2 44 1F E3 C2 42 A0 F7 E4 C5
 06 F2 E2 27 C5 18 ED 1E E3 E0 C7 A2 C8 B4 E2 C3
 1D A0 C4 63 26 EE FF D3 26 C5 62 27 A0 D3 BE EA
 C5 1E C2 B9 C0 64 28 00
  Encoded length: 168 bytes
  Wall pattern: 01, Wall color: 05     Floor pattern: 00, Floor color: 02
  Flags: 
 02 02 02 02 02 02 02 02 02 02 02 02 02 02 02 02 02 02 02 02 02 02 02 02 02 02 02 02 02 02 02 02 02
 02 27 00 00 00 00 00 00 00 00 00 00 00 00 00 00 00 00 00 00 00 00 02 40 00 42 00 00 00 33 02 40 02
 02 00 00 00 00 00 00 00 00 00 00 00 00 00 00 00 00 00 00 00 00 00 02 00 00 00 00 00 00 02 00 00 02
 02 00 00 00 00 00 00 00 40 29 00 00 00 00 00 00 00 00 00 00 00 00 02 37 02 00 00 00 02 00 00 00 02
 02 00 00 00 02 02 02 02 02 42 00 00 00 00 00 00 00 00 02 00 00 00 02 02 00 00 00 02 32 00 02 00 02
 02 00 00 00 02 00 00 00 00 02 00 00 00 00 00 00 00 02 32 00 00 00 02 00 00 00 02 00 00 00 00 00 02
 02 00 00 00 02 00 00 05 00 02 00 00 00 00 00 00 02 00 00 00 00 00 02 00 00 00 00 00 00 00 00 00 02
 02 40 00 42 02 00 00 00 00 02 00 00 00 00 00 00 02 00 00 00 00 00 02 00 00 00 00 00 02 00 00 00 02
 02 00 00 00 02 00 02 02 02 00 00 00 00 00 00 00 02 00 00 00 00 00 02 00 00 00 00 02 00 00 00 42 02
 02 00 00 00 02 00 00 02 00 00 00 00 00 00 00 02 00 00 00 00 00 00 02 00 00 00 02 33 00 00 00 02 02
 02 00 00 00 02 00 00 00 02 00 00 00 00 00 02 00 00 00 00 00 00 00 02 00 00 00 02 00 00 00 02 33 02
 02 00 00 00 02 00 00 00 00 02 00 00 00 02 29 00 00 00 00 00 00 00 02 00 00 00 02 00 00 02 00 00 02
 02 00 00 00 00 00 00 00 00 00 00 00 00 02 00 00 00 00 00 00 00 00 02 00 00 00 02 00 00 00 00 00 02
 02 25 00 00 00 00 00 00 00 00 00 00 02 00 00 00 00 00 00 00 00 00 02 00 00 00 02 00 00 00 02 40 02
 02 00 00 00 00 00 00 00 00 00 00 02 00 00 00 02 02 02 02 02 00 00 02 00 00 00 02 39 00 00 00 00 02
 02 02 02 02 02 02 02 02 02 02 02 00 00 00 00 00 37 02 00 00 00 00 02 00 00 00 00 02 00 00 00 00 02
 02 00 00 31 00 00 00 00 00 00 00 00 00 00 00 00 00 02 00 00 00 00 02 00 00 00 00 00 02 00 00 00 02
 02 00 00 00 00 00 00 00 00 00 00 00 00 00 00 00 00 02 00 40 00 00 02 00 00 00 00 33 02 00 00 00 02
 02 00 00 00 00 00 00 42 00 00 00 00 00 00 00 00 00 02 00 00 00 00 02 00 00 00 00 02 00 40 00 00 02
 02 40 00 00 00 00 00 00 00 00 00 00 00 02 00 40 00 02 00 00 00 02 00 00 00 00 00 02 00 00 00 00 02
 02 00 00 00 00 00 00 00 00 00 00 00 00 37 02 02 02 00 00 00 02 00 00 00 00 00 00 02 00 00 40 00 02
 02 00 00 00 00 00 00 00 00 00 00 00 00 00 00 00 00 00 00 00 02 00 00 00 00 00 00 02 00 33 00 00 02
 02 00 00 00 00 02 02 02 02 02 00 00 00 00 00 00 00 00 00 02 00 00 00 02 02 02 02 02 00 00 00 40 02
 02 00 00 00 02 31 00 00 00 00 02 00 00 00 40 00 00 00 02 00 00 00 00 02 00 00 00 00 00 00 00 00 02
 02 00 00 00 02 00 00 00 00 00 00 02 00 00 00 00 00 02 00 00 00 00 00 02 06 00 00 00 00 00 00 00 02
 02 00 00 00 02 00 00 00 00 00 00 00 02 00 00 00 02 39 00 00 00 00 00 02 24 00 00 00 00 00 00 00 02
 02 00 00 00 02 00 00 02 30 00 00 00 00 02 00 02 00 00 00 00 00 00 00 02 02 02 02 00 00 00 00 00 02
 02 00 00 00 02 00 00 00 02 00 00 00 00 29 02 00 00 00 00 00 42 00 00 02 00 38 00 00 00 00 00 00 02
 02 00 00 00 00 00 00 00 00 02 00 00 00 00 00 00 00 00 00 00 00 00 00 02 00 00 00 00 00 00 00 00 02
 02 00 00 00 00 00 00 00 00 00 02 00 00 00 00 00 00 00 00 00 00 00 00 02 00 00 00 00 00 00 00 38 02
 02 00 00 00 00 00 42 00 00 00 39 02 00 00 00 00 00 00 00 00 00 00 00 02 00 00 00 00 00 00 00 00 02
 02 00 00 00 00 00 00 00 00 00 00 00 02 00 00 00 00 00 00 30 00 00 00 02 00 42 00 00 00 00 00 40 02
 02 02 02 02 02 02 02 02 02 02 02 02 02 02 02 02 02 02 02 02 02 02 02 02 02 02 02 02 02 02 02 02 02
