Gauntlet (rev 1 - 9)
Maze number: 92
Offset for maze 91: 232471 - 0x038c17
big endian buf: [%!l(uint8=0) %!l(uint8=3) %!l(uint8=140) %!l(uint8=23)]
G:1 Maze real addr: 248858 - 0x03CC1A, bank 2, boff: 0x4000
Maze read from: 0x03cc1a - 248858
compresssed: 255
 00 00 00 00 01 10 57 0A 5A 04 0B 2A 81 C1 19 C0
 06 C4 19 CB 43 0B C7 2A C5 51 03 C5 1B C3 40 C9
 B2 C0 72 CE 52 C1 41 72 62 C5 1B 73 C5 52 03 85
 A0 61 C0 1B A6 41 B2 A0 CE 04 35 C7 2A C0 A1 43
 75 C4 03 86 A0 CB A1 41 B2 A0 CD 35 C6 28 C2 28
 45 19 C1 52 C5 1B C0 51 C5 77 C5 B2 A0 03 81 B2
 AC CD A2 35 CB 35 68 61 61 C7 19 DF DF EF E0 E0
 E0 C6 03 82 C7 28 FE BE C2 BF E0 E0 E0 E0 C1 19
 C3 05 C3 19 C4 28 D1 53 C1 35 53 C6 BF A2 BF C1
 28 E2 C2 B8 C3 03 83 F3 CF BA A3 63 E2 D1 04 ED
 C7 19 C4 35 C0 A2 C0 A1 B2 61 E2 C2 53 35 CD 40
 C3 28 E7 C0 03 83 A8 03 51 40 B2 C1 B2 62 E2 E9
 C5 42 EC E0 E0 E0 64 C1 B2 A1 41 B2 C1 B2 61 E2
 E9 C4 2A C1 43 EA E0 E0 E0 C8 B2 42 B2 A3 28 ED
 61 69 C1 28 61 E8 C7 2A C0 B2 C6 2A ED CE BE C1
 2A 28 C0 28 60 60 60 E0 63 C5 B2 60 C1 2C 00
  Encoded length: 255 bytes
  Wall pattern: 00, Wall color: 07     Floor pattern: 01, Floor color: 05
  Flags: SHOTS_STUN 
  ╚══> while gauntlet has these elements, these flags probably do not operate
 02 02 02 02 02 02 02 02 02 02 02 02 02 02 02 02 02 02 02 02 02 02 02 02 02 02 02 02 02 02 02 02 02
 02 42 42 00 00 25 02 06 11 11 11 00 00 25 04 00 00 00 00 00 00 00 00 00 04 00 10 10 02 11 11 11 02
 02 00 00 00 00 00 02 42 11 11 11 00 00 00 04 03 04 00 00 00 00 00 27 00 04 00 02 10 02 11 02 11 02
 02 00 00 00 00 00 02 02 11 11 11 00 00 00 00 00 04 00 00 00 00 00 00 00 04 00 02 10 02 11 02 11 02
 02 26 00 00 00 00 00 02 27 11 11 00 00 00 00 00 04 03 03 03 03 03 03 03 02 00 02 26 02 27 02 11 02
 02 02 02 02 02 10 10 02 02 02 11 00 00 00 00 00 00 00 00 00 00 00 00 00 04 53 02 00 02 00 02 11 02
 02 00 42 00 02 02 10 10 10 02 11 00 00 00 00 04 03 03 03 03 03 03 03 03 02 00 02 00 02 00 02 11 02
 02 00 00 00 00 02 02 10 10 02 02 02 00 00 00 04 00 00 00 00 00 00 00 00 04 53 02 00 02 00 02 11 02
 02 40 00 00 00 40 02 10 10 10 10 02 25 00 00 04 00 00 00 00 00 00 27 00 04 00 02 00 02 00 02 11 02
 02 00 00 00 00 00 02 02 03 03 03 02 02 02 02 02 02 02 02 02 02 02 02 02 02 00 02 00 02 00 02 00 02
 02 00 00 00 00 00 00 02 02 02 53 00 00 00 00 00 00 00 00 00 00 00 00 53 02 00 02 00 02 00 02 00 02
 02 26 00 00 26 00 00 26 00 02 00 00 00 00 00 00 25 00 00 00 00 00 00 00 02 00 02 00 02 00 02 00 02
 02 00 00 00 00 00 00 00 00 02 00 00 00 00 00 00 00 00 00 00 00 00 00 00 02 00 02 00 02 00 02 00 02
 02 00 00 00 00 00 00 00 00 02 00 00 00 00 00 00 00 00 00 00 00 00 00 00 02 00 02 00 02 00 02 00 02
 02 02 00 02 00 02 00 02 00 02 00 00 00 00 04 03 03 03 04 00 00 00 00 00 02 00 02 40 02 00 02 00 02
 02 00 00 00 00 00 00 00 00 02 00 00 00 00 04 00 00 00 04 00 00 00 00 00 02 00 02 02 02 00 02 00 02
 02 00 02 00 02 00 02 00 02 02 00 25 00 00 04 00 05 00 04 00 00 25 00 00 02 00 02 40 00 00 02 00 02
 02 00 00 00 00 00 00 00 00 02 00 00 00 00 04 00 00 53 04 00 00 00 00 00 02 00 02 02 02 02 02 00 02
 02 40 00 00 00 02 00 00 00 02 00 00 00 00 03 03 03 03 03 00 00 00 00 00 02 00 00 00 00 00 00 00 02
 02 00 00 00 00 00 00 02 00 04 00 00 00 00 00 00 00 00 00 00 00 00 00 00 02 02 02 02 02 00 02 00 02
 02 26 00 00 00 02 00 00 00 04 00 00 00 00 00 00 00 00 00 00 00 00 00 00 04 00 00 00 00 00 02 00 02
 02 00 00 00 00 00 00 02 00 04 00 00 00 00 00 00 25 00 00 00 00 00 53 00 02 02 02 00 02 02 02 00 02
 02 26 00 00 00 02 00 00 00 04 53 00 00 00 00 00 00 00 00 00 00 00 00 00 04 10 02 00 00 02 40 00 02
 02 00 00 00 00 00 00 02 00 03 03 03 03 03 02 02 02 02 02 02 02 02 02 03 04 10 02 02 00 02 02 00 02
 02 26 00 00 00 02 00 00 00 00 00 00 00 00 00 00 02 00 00 00 00 00 02 10 10 10 00 02 00 00 02 00 02
 02 00 00 00 00 00 00 02 00 02 00 02 00 02 00 00 00 00 00 26 00 00 02 02 02 10 10 02 02 00 02 00 02
 02 26 00 00 00 02 00 00 00 00 00 00 00 00 00 00 02 00 00 00 00 00 42 00 02 10 10 10 02 00 00 00 02
 02 00 00 00 00 00 00 00 02 00 02 00 02 00 02 00 00 00 00 00 00 00 00 00 02 02 10 10 02 02 02 02 02
 02 40 00 00 00 00 00 00 00 00 00 00 00 00 00 00 02 00 00 26 00 00 00 00 00 02 00 00 00 00 26 00 02
 02 40 00 00 26 00 00 00 00 00 00 00 00 00 02 00 00 00 00 00 00 00 00 42 00 02 02 00 00 00 00 00 02
 02 42 00 00 00 00 00 00 00 00 00 00 00 00 00 00 02 00 00 00 00 00 00 00 00 00 02 00 00 00 00 00 02
 02 00 00 42 40 00 40 00 26 00 26 00 26 00 02 00 00 00 00 26 00 00 00 00 00 00 02 00 26 00 00 44 02
 02 02 02 02 02 02 02 02 02 02 02 02 02 02 02 02 02 02 02 02 02 02 02 02 02 02 02 02 02 02 02 02 02
