Gauntlet (rev 1 - 9)
Maze number: 40
Offset for maze 39: 231230 - 0x03873e
big endian buf: [%!l(uint8=0) %!l(uint8=3) %!l(uint8=135) %!l(uint8=62)]
G:1 Maze real addr: 239425 - 0x03A741, bank 1, boff: 0x2000
Maze read from: 0x03a741 - 239425
compresssed: 366
 10 12 07 17 08 50 5E A1 68 0E B5 61 C1 40 A0 E0
 C2 14 A0 E7 E0 C0 0E 82 C0 03 A1 E2 E2 C2 A1 03
 A1 E2 C0 40 A0 C2 A1 E2 C0 76 A0 E4 E6 E0 E5 E6
 E6 C1 2A E3 65 E0 E4 60 E4 C0 74 A0 E0 C1 40 A0
 C2 A1 03 A0 E3 C0 40 A0 C2 A4 E2 E1 E3 E7 E0 C1
 51 E0 E2 C0 2A C1 A1 C4 04 C6 40 A0 C1 51 61 C1
 0E 04 C2 51 0E E0 C1 2A E0 52 52 52 E4 E0 C1 2A
 E0 C0 52 E0 E3 40 A0 C2 A1 35 A0 B4 2C E1 C0 40
 A0 C2 A4 E2 63 E0 E4 60 E4 E0 E4 C0 75 A0 C1 2A
 E3 E6 E6 E5 E0 64 E0 C4 70 74 70 A0 C1 A2 E2 E2
 C2 A4 E2 C0 40 A0 E3 E1 E3 E0 E3 76 A0 E0 C5 06
 C0 04 C2 40 A0 C0 42 04 C0 05 C4 0E E0 C0 46 A0
 E3 E0 E3 C4 51 51 E0 E0 C5 A2 E2 E2 C1 54 A3 B4
 E2 E2 C2 B4 A0 E2 60 E4 E0 E4 E0 C2 0E 60 E0 E5
 E6 C3 2C E1 C1 0E E3 65 E0 E4 60 C4 70 A0 C1 52
 0E E0 C0 71 40 A0 C2 A1 35 A0 E3 C0 40 A0 C2 A1
 03 A0 E3 E1 C1 2A E0 C4 2C E1 E0 C1 2A E0 C4 2A
 C1 A1 C4 04 E8 C4 04 E9 E3 E7 E0 C0 52 0E E0 C0
 51 E5 40 A0 C2 A3 B4 C1 52 A0 C0 40 A0 C2 A3 B4
 E2 E3 E0 E4 C0 74 A0 E0 E4 60 E5 E6 E6 C1 0E 81
 E1 E5 60 C4 70 A0 E4 C0 74 28 E0 C1 03 A1 E2 E2
 C2 A1 03 A1 E2 C0 40 A0 C2 A1 61 C1 40 A0 E0 C2
 14 A0 C0 0E C0 04 C0 0E 80 E0 E0 63 C0 00
  Encoded length: 366 bytes
  Wall pattern: 00, Wall color: 14     Floor pattern: 05, Floor color: 05
  Flags: 
 02 02 02 02 02 02 02 02 02 02 02 02 02 02 02 02 02 02 02 02 02 02 02 02 02 02 02 02 02 02 02 02
 00 00 40 00 00 33 00 02 00 02 00 00 00 20 02 00 00 00 00 00 00 00 00 02 00 02 00 14 14 14 14 00
 03 02 02 00 00 00 02 00 00 00 02 00 00 00 02 02 03 02 02 00 00 00 02 00 33 00 02 00 00 00 02 02
 00 00 00 02 00 53 00 00 00 00 00 00 00 02 00 00 00 00 00 02 00 00 00 00 00 00 00 02 00 02 00 00
 00 00 00 00 02 00 00 00 00 00 00 00 02 00 00 00 00 00 00 00 02 00 00 42 00 00 00 00 02 00 00 00
 00 00 00 40 00 02 00 00 00 00 00 02 00 40 00 00 00 00 00 02 00 53 00 00 00 00 00 02 00 02 00 00
 33 00 02 00 00 00 02 02 03 02 02 00 00 00 02 00 33 00 02 00 14 00 02 02 02 02 02 00 00 00 02 00
 00 02 00 00 00 00 02 14 14 14 02 00 00 00 00 02 00 02 00 14 14 00 02 00 14 00 02 00 42 00 14 02
 02 00 00 00 00 00 04 14 14 14 02 00 00 00 33 00 02 00 00 14 00 00 40 00 14 14 04 00 00 00 14 14
 00 02 00 00 42 00 02 14 14 14 02 00 00 00 00 02 00 02 00 00 42 00 02 00 14 00 02 00 00 00 00 02
 33 00 02 00 00 00 02 02 53 02 02 44 00 00 02 00 33 00 02 00 00 00 02 02 02 02 02 00 00 00 02 00
 00 00 00 40 00 02 00 00 00 00 00 02 00 40 00 00 00 00 00 02 00 02 00 00 00 00 00 02 00 53 00 00
 00 00 00 00 02 00 00 42 00 00 00 00 02 00 00 00 00 00 00 00 02 00 00 00 00 00 00 00 02 00 00 00
 00 00 00 02 00 02 00 00 00 00 00 40 00 02 00 00 00 00 00 53 00 53 00 00 00 00 00 53 00 02 00 00
 02 02 02 00 00 00 02 00 00 00 02 00 00 14 02 02 02 02 02 00 00 00 02 00 33 00 02 00 00 00 02 02
 00 00 02 00 00 00 00 02 00 02 00 00 00 14 02 53 00 00 02 00 00 00 00 02 00 02 00 00 00 00 02 00
 06 00 04 00 00 00 33 00 02 00 33 00 00 14 04 00 05 00 02 00 14 14 14 00 02 00 33 00 00 00 02 00
 00 00 02 00 00 00 00 02 00 02 00 00 00 14 02 00 00 00 02 00 14 14 00 02 00 02 00 00 00 00 02 00
 02 02 02 00 00 00 02 00 00 00 02 00 00 14 02 02 02 02 02 00 00 00 02 00 00 00 02 00 00 00 02 02
 00 00 00 02 00 40 00 00 00 00 00 02 00 02 00 00 00 00 00 02 00 02 00 00 14 14 00 40 00 02 00 00
 00 00 00 00 02 00 00 00 00 00 00 00 02 00 00 00 00 44 00 00 02 00 00 14 14 00 00 00 02 00 00 00
 00 00 00 40 00 02 00 00 00 00 00 02 00 40 00 00 00 00 00 53 00 02 00 00 14 14 00 02 00 53 00 00
 33 00 02 00 00 00 02 02 53 02 02 00 00 00 02 00 33 00 02 00 00 00 02 02 03 02 02 00 00 00 02 00
 00 02 00 00 42 00 02 00 00 00 02 00 44 00 00 02 00 02 00 14 42 00 02 00 00 00 02 00 42 00 00 02
 02 00 00 00 00 00 04 00 00 00 02 00 00 14 00 00 02 00 00 14 00 00 04 00 14 00 02 00 00 00 00 00
 00 02 00 00 00 00 02 00 00 00 02 00 00 14 00 02 00 02 00 14 14 00 02 00 14 00 02 00 00 00 00 02
 33 00 02 00 00 00 02 02 02 02 02 00 00 14 02 00 33 00 02 00 00 00 02 02 02 02 02 00 00 00 02 00
 00 00 00 02 00 02 00 00 00 00 00 02 00 53 00 00 00 00 00 02 00 02 00 00 00 00 00 02 00 40 00 00
 00 00 00 00 02 00 00 00 00 00 00 00 02 00 00 00 00 00 00 00 02 00 00 14 14 14 00 00 02 00 00 00
 00 00 00 02 00 40 00 00 00 00 00 53 00 02 00 00 00 00 00 02 00 53 00 00 00 00 00 40 00 02 00 00
 03 02 02 00 00 00 02 00 00 00 02 00 00 00 02 02 03 02 02 00 00 00 02 00 33 00 02 00 00 00 02 02
 00 00 40 00 00 33 00 02 00 02 00 00 00 20 02 00 14 00 04 00 14 14 00 02 00 02 00 00 00 00 40 00
 02 02 02 02 02 02 02 02 02 02 02 02 02 02 02 02 02 02 02 02 02 02 02 02 02 02 02 02 02 02 02 02
