Gauntlet (rev 1 - 9)
Maze number: 109
Offset for maze 108: 234915 - 0x0395a3
big endian buf: [%!l(uint8=0) %!l(uint8=3) %!l(uint8=149) %!l(uint8=163)]
G:1 Maze real addr: 251302 - 0x03D5A6, bank 2, boff: 0x4000
Maze read from: 0x03d5a6 - 251302
compresssed: 145
 00 00 00 00 00 83 A3 0B 5B 5A A8 28 80 1B 60 60
 C0 2B CA 2B 61 60 60 60 C0 70 1B DF DE 1B DF CD
 2B 6F DF DF C5 A2 D5 75 2A C5 1D C0 1D C8 7B A0
 63 64 DF D3 2C 66 67 80 61 80 C7 B5 A3 C8 06 D6
 A2 03 A0 C1 B5 A2 C8 42 56 D3 BF 42 CB 05 53 CA
 42 56 C2 35 D0 42 EA 03 A0 CE 42 D0 1A CA 42 56
 C1 B6 C2 B6 CD 42 C2 2A C5 19 E0 C0 19 C4 2A C7
 42 E9 E2 D7 1A C1 A1 C0 A1 51 DF DF D5 1A 52 53
 C6 43 DB 43 DB 43 DB 43 DB 42 BE 7D 2A CB 41 28
 00
  Encoded length: 145 bytes
  Wall pattern: 03, Wall color: 03     Floor pattern: 08, Floor color: 10
  Flags: 
 02 02 02 02 02 02 02 02 02 02 02 02 02 02 02 02 02 02 02 02 02 02 02 02 02 02 02 02 02 02 02 02 02
 02 40 27 00 27 00 27 00 43 00 00 00 00 00 00 00 00 00 00 00 43 00 00 27 00 27 00 27 00 27 00 40 02
 02 27 00 00 00 00 00 00 00 00 00 00 00 00 00 00 00 00 00 00 00 00 00 00 00 00 00 00 00 00 00 00 02
 02 00 00 00 00 00 00 00 00 00 00 00 00 00 00 00 00 00 00 00 00 00 00 00 00 00 00 00 00 00 00 00 02
 02 27 00 00 00 00 00 00 00 00 00 00 00 00 00 00 00 00 00 00 00 00 00 00 00 00 00 00 00 00 00 00 02
 02 00 00 00 00 00 00 00 00 00 00 00 00 00 00 00 43 00 00 00 00 00 00 00 00 00 00 00 00 00 00 00 02
 02 27 00 00 00 00 00 00 00 00 00 00 00 00 00 00 00 00 00 00 00 00 00 00 00 00 00 00 00 00 00 00 02
 02 00 00 00 00 00 00 00 00 00 00 00 00 00 00 00 00 00 00 00 00 00 00 00 00 00 00 00 00 00 00 00 02
 02 00 00 00 00 00 00 02 02 02 02 00 00 00 00 00 00 00 00 00 00 00 00 00 00 00 00 00 00 00 00 00 02
 02 40 00 00 00 00 00 02 42 00 00 00 00 00 00 29 00 29 00 00 02 00 00 00 00 00 00 40 00 00 00 00 02
 02 00 00 00 00 00 00 02 02 00 00 00 00 27 00 00 00 00 00 27 02 00 00 00 00 00 00 00 00 00 00 00 02
 02 00 00 00 00 00 00 02 00 00 00 00 00 00 00 00 00 00 00 00 02 00 00 00 00 00 00 00 00 00 00 00 02
 02 00 00 00 00 00 00 02 44 00 00 00 00 00 00 00 27 00 00 00 02 00 00 00 00 27 27 00 00 27 27 00 02
 02 00 00 00 00 00 00 02 02 02 02 02 00 00 00 00 00 00 00 00 02 06 00 00 00 00 00 00 00 00 00 00 02
 02 00 00 00 00 00 00 00 00 00 00 00 00 02 02 02 03 02 02 00 02 02 02 02 00 00 00 00 00 00 00 00 02
 02 11 11 11 00 00 00 00 00 00 00 26 00 00 02 00 00 00 02 00 00 00 00 00 00 00 00 00 00 00 00 00 02
 02 11 11 11 00 00 00 00 00 00 00 00 00 00 02 00 05 00 02 00 00 26 00 00 00 00 00 00 00 00 00 00 02
 02 11 11 11 00 00 00 00 00 00 00 26 00 00 02 53 00 00 02 00 00 00 00 00 00 00 00 00 00 00 00 00 02
 02 11 11 11 00 00 00 00 00 00 00 00 00 00 02 02 03 02 02 00 00 00 00 00 00 00 00 00 00 00 00 00 02
 02 11 11 11 00 00 00 00 00 00 00 00 00 00 02 00 00 00 02 00 00 26 00 00 00 00 00 00 00 00 00 00 02
 02 11 11 11 00 00 00 00 00 00 00 26 00 00 02 00 00 00 02 00 00 00 00 00 00 00 00 00 00 00 00 00 02
 02 11 11 11 00 00 00 42 00 00 00 00 00 00 25 00 02 00 25 00 00 00 00 00 42 00 00 00 00 00 00 00 02
 02 11 11 11 00 00 00 00 00 00 00 00 00 00 02 00 00 00 02 00 00 00 00 00 00 00 00 00 00 00 00 00 02
 02 00 00 00 00 00 00 00 00 00 00 26 00 00 02 02 00 02 02 00 00 26 00 00 00 00 00 00 00 00 00 00 02
 02 00 00 00 00 00 00 00 00 00 00 00 00 00 00 00 00 00 00 00 00 00 00 00 00 00 00 00 00 00 00 00 02
 02 00 00 00 00 00 00 00 00 00 00 00 00 00 00 00 00 00 00 00 00 00 00 00 00 00 00 00 00 00 00 00 02
 02 00 00 00 00 00 00 00 00 00 00 00 26 00 00 00 26 00 00 00 00 26 00 00 00 00 00 00 00 11 11 11 02
 02 00 00 00 00 00 00 00 00 00 00 00 00 00 00 00 00 00 00 00 00 00 00 00 00 00 00 00 00 11 11 11 02
 02 00 00 00 00 00 00 00 00 00 00 00 00 00 00 00 00 00 00 00 00 00 00 00 00 00 00 00 00 11 11 11 02
 02 00 00 00 00 00 00 00 00 00 00 00 00 00 00 00 00 00 00 00 00 00 00 00 00 00 00 00 00 11 11 11 02
 02 00 00 00 00 00 00 00 00 00 00 00 00 00 00 00 00 00 00 00 00 00 00 00 00 00 00 00 00 11 11 11 02
 02 40 00 00 00 00 00 00 00 00 00 00 00 00 00 00 42 00 00 00 00 00 00 00 00 00 00 00 00 11 11 40 02
 02 02 02 02 02 02 02 02 02 02 02 02 02 02 02 02 02 02 02 02 02 02 02 02 02 02 02 02 02 02 02 02 02
