Gauntlet (rev 1 - 9)
Maze number: 87
Offset for maze 86: 231677 - 0x0388fd
big endian buf: [%!l(uint8=0) %!l(uint8=3) %!l(uint8=136) %!l(uint8=253)]
G:1 Maze real addr: 248064 - 0x03C900, bank 2, boff: 0x4000
Maze read from: 0x03c900 - 248064
compresssed: 124
 00 00 00 00 01 31 17 A8 60 5A 9F 35 80 20 A0 C9
 4F 05 60 E2 FA C8 19 42 A0 7F FF E3 DF ED D4 2B
 A0 EE C4 41 A0 20 A0 DB 4F C2 42 4F E0 F6 C1 43
 19 D4 1A A0 E7 DF E0 E6 D7 7F C1 2B EC CB BF E8
 FE 20 E1 E7 C0 42 7F DF C0 4F D5 4C A1 EB D0 20
 A0 DF EC D4 1A 57 E2 E6 E9 D3 2E C1 03 A4 EC CD
 1E C0 06 E3 C4 48 2B A0 FD 6E E1 F0 C1 B4 D2 28
 A0 66 BE 20 04 C2 B5 4F E4 20 35 00
  Encoded length: 124 bytes
  Wall pattern: 01, Wall color: 07     Floor pattern: 03, Floor color: 01
  Flags: SHOTS_STUN 
  ╚══> while gauntlet has these elements, these flags probably do not operate
 02 02 02 02 02 02 02 02 02 02 02 02 02 02 02 02 02 02 02 02 02 02 02 02 02 02 02 02 02 02 02 02 02
 02 53 32 02 00 00 00 00 00 00 00 00 00 00 40 00 00 00 00 00 00 00 00 00 00 00 00 00 00 00 00 05 02
 02 32 00 00 00 02 00 00 00 00 00 00 00 00 00 00 00 00 00 00 00 00 00 00 00 00 00 00 00 00 00 00 02
 02 02 00 00 00 00 00 00 00 00 00 25 40 00 00 00 02 31 00 00 00 00 00 00 00 00 00 00 00 00 00 00 02
 02 00 00 00 00 00 00 00 00 00 00 00 00 00 00 00 00 00 00 00 00 00 00 00 00 00 00 00 00 00 00 00 02
 02 00 02 00 00 00 00 02 00 00 00 00 00 00 00 00 00 00 00 00 00 00 00 00 00 00 00 00 00 00 00 00 02
 02 00 00 00 00 00 00 00 00 00 00 00 00 00 00 00 00 00 00 00 00 00 02 00 00 00 00 00 00 00 00 00 02
 02 00 00 00 00 00 00 00 00 00 00 00 43 02 00 00 00 00 00 00 00 00 00 00 00 00 00 00 00 02 00 00 02
 02 00 00 40 00 00 02 32 02 00 00 00 00 00 00 00 00 00 00 00 00 00 00 00 00 00 00 00 00 00 00 00 02
 02 00 00 00 00 40 00 00 00 00 00 00 00 00 00 00 00 00 00 00 00 00 00 00 00 40 00 00 00 40 00 00 02
 02 00 00 00 00 00 00 00 00 00 00 00 00 00 00 02 00 00 00 00 00 00 00 00 00 00 00 00 00 00 00 00 02
 02 00 00 00 00 00 00 02 00 00 40 00 00 00 00 25 00 00 00 00 00 00 00 00 00 00 00 00 00 00 00 00 02
 02 00 00 00 00 26 02 00 00 00 00 00 00 00 00 02 00 00 00 00 00 00 00 00 00 00 00 00 00 00 00 00 02
 02 00 00 00 00 00 00 00 00 00 00 00 00 00 00 00 00 02 00 00 00 00 00 00 00 02 00 00 00 00 00 00 02
 02 00 00 00 00 00 00 00 00 00 00 00 00 00 00 00 00 00 31 00 00 00 00 00 00 00 00 00 00 00 00 00 02
 02 00 00 00 00 43 00 00 00 00 00 00 00 00 00 00 00 00 00 02 00 00 00 00 00 00 00 00 00 00 00 00 02
 02 00 00 00 00 00 00 00 00 00 02 00 00 00 00 00 00 00 00 00 00 00 00 00 00 00 00 00 00 00 00 00 02
 02 00 00 00 00 00 00 00 00 00 02 32 00 00 02 00 00 00 00 00 00 00 00 02 00 40 00 00 00 31 00 00 02
 02 00 00 00 00 00 00 00 00 00 00 00 00 00 00 00 00 00 00 00 00 00 00 00 00 00 00 00 00 00 00 00 02
 02 00 00 00 00 00 00 00 00 00 00 00 00 00 00 40 00 00 00 00 00 00 00 00 00 00 00 00 00 00 00 00 02
 02 00 00 00 00 00 00 00 00 00 00 00 00 00 00 00 00 00 00 00 00 00 40 00 00 00 00 00 00 00 00 00 02
 02 00 00 00 02 02 00 00 00 00 00 00 00 00 00 00 00 00 02 00 00 00 00 00 00 00 00 00 00 00 00 00 02
 02 00 00 00 32 02 00 00 00 00 00 00 00 00 00 00 00 00 00 00 00 00 00 00 00 00 00 00 00 00 00 00 02
 02 00 00 00 00 00 00 00 00 00 00 00 00 00 00 00 00 00 00 02 00 00 00 00 00 00 00 00 00 00 00 00 02
 02 00 00 00 00 00 00 00 00 26 00 00 00 00 00 00 00 00 26 00 00 00 02 00 00 00 00 00 00 00 02 00 02
 02 00 00 00 00 00 00 00 00 02 00 00 00 00 00 00 00 00 00 00 00 00 00 00 00 00 00 00 00 00 46 00 02
 02 03 02 02 02 02 02 00 00 00 00 00 00 00 00 00 00 00 00 00 02 00 00 00 00 00 00 00 00 00 00 00 02
 02 00 02 30 00 06 02 00 00 00 02 00 00 00 00 00 40 00 00 00 00 00 00 00 00 00 43 02 00 00 00 00 02
 02 00 02 00 00 00 02 00 00 00 00 00 00 00 00 00 00 00 00 00 00 00 00 00 00 00 02 00 00 00 00 00 02
 02 00 02 00 00 00 02 00 00 00 32 00 00 02 00 00 00 00 00 00 00 00 00 00 00 00 00 00 00 00 00 02 02
 02 00 02 00 00 00 02 00 00 00 00 00 00 00 00 00 00 00 00 00 00 00 40 02 00 00 00 00 00 00 00 32 02
 02 32 04 00 00 00 02 40 00 00 00 00 00 00 00 00 00 00 00 00 00 00 00 00 00 00 00 00 00 02 32 53 02
 02 02 02 02 02 02 02 02 02 02 02 02 02 02 02 02 02 02 02 02 02 02 02 02 02 02 02 02 02 02 02 02 02
