Gauntlet (rev 1 - 9)
Maze number: 86
Offset for maze 85: 231490 - 0x038842
big endian buf: [%!l(uint8=0) %!l(uint8=3) %!l(uint8=136) %!l(uint8=66)]
G:1 Maze real addr: 247877 - 0x03C845, bank 2, boff: 0x4000
Maze read from: 0x03c845 - 247877
compresssed: 184
 00 00 00 00 00 60 D0 5A 68 1F D9 42 A0 C9 1F C0
 1F C0 1F F0 E4 D4 1A E3 E4 EE E9 E4 C6 53 E4 EB
 E4 EA E7 E4 E4 C3 B5 E3 C4 52 E3 E4 41 A0 E0 E6
 E5 E4 E6 2A E1 E4 E5 E6 E4 E4 E2 E5 E2 E4 E2 28
 64 A0 2B A0 E5 E4 E4 E0 28 C6 20 E6 44 E0 E4 EC
 CC 21 C0 21 A0 6B A0 CD A2 2A C6 A3 B3 A5 69 20
 2C A0 D6 BF C3 20 E2 4D CA B3 2B E3 28 E4 F2 E4
 E3 19 A0 E1 43 EA E4 20 E2 E3 EF E4 E8 43 EA 63
 E9 CA 19 E3 C3 B6 E2 E5 43 EA E7 E5 6E A0 E7 E5
 64 C4 19 E3 E7 E5 EF 42 E3 E5 EF E7 E5 4A E3 42
 E3 E5 EF E7 E7 E2 E9 42 E3 C4 BE 70 A0 06 70 A0
 2C 43 62 A0 E7 C2 05 00
  Encoded length: 184 bytes
  Wall pattern: 00, Wall color: 00     Floor pattern: 06, Floor color: 13
  Flags: 
 02 02 02 02 02 02 02 02 02 02 02 02 02 02 02 02 02 02 02 02 02 02 02 02 02 02 02 02 02 02 02 02 02
 02 00 00 26 02 00 00 00 00 00 00 00 00 00 00 31 00 31 00 31 02 31 00 00 00 00 00 00 00 00 00 00 02
 02 00 00 00 00 02 00 00 00 00 00 02 00 00 00 00 00 00 00 00 02 31 00 00 00 00 00 00 00 00 00 00 02
 02 26 00 00 00 00 02 00 00 00 00 00 02 00 00 00 00 00 00 00 02 31 00 00 00 00 00 00 02 00 00 00 02
 02 00 00 00 00 00 00 02 00 00 00 00 00 02 00 00 00 00 00 00 02 31 00 00 00 00 00 02 00 00 00 31 02
 02 00 00 00 00 00 00 00 02 00 00 00 00 00 02 00 00 00 00 00 02 00 00 00 00 00 02 00 00 00 00 31 02
 02 00 00 02 00 00 00 00 00 02 00 00 00 00 00 02 00 00 00 00 02 00 00 00 00 02 00 00 00 00 00 31 02
 02 00 00 00 02 00 00 00 00 00 02 00 00 26 02 00 02 00 00 00 00 00 00 00 02 00 00 00 00 00 00 02 02
 02 00 00 00 00 02 00 00 00 00 00 00 00 02 42 00 00 02 00 00 00 00 00 02 00 00 00 00 00 00 02 00 02
 02 00 00 00 00 00 02 00 00 00 00 00 02 00 00 00 00 00 02 00 00 00 02 00 00 00 00 00 00 02 00 00 02
 02 02 00 00 00 00 00 02 00 00 00 02 40 00 00 00 00 00 40 02 43 02 00 00 00 00 00 00 02 00 00 00 02
 02 00 02 00 00 00 00 00 02 00 02 40 00 00 00 00 00 00 00 32 02 00 00 00 00 00 00 02 00 00 00 00 02
 02 26 00 02 00 00 00 00 00 02 00 00 00 00 00 00 00 00 00 00 02 00 00 02 00 00 00 00 00 00 00 00 02
 02 00 00 00 00 33 00 33 02 00 00 00 00 00 00 00 00 00 00 00 02 40 02 00 00 00 00 00 00 00 00 00 02
 02 00 00 00 02 02 02 02 42 00 00 00 00 00 00 00 02 02 02 02 02 02 02 02 02 02 02 00 00 00 00 00 02
 02 00 00 00 02 40 32 44 02 00 00 00 00 00 00 00 00 00 00 00 00 00 00 00 00 00 00 00 00 00 00 00 02
 02 00 00 00 02 32 00 00 00 02 00 00 00 00 02 00 00 00 00 00 00 00 00 00 26 00 00 00 00 00 00 00 02
 02 00 00 00 02 43 00 00 00 00 02 40 00 00 02 00 00 02 00 00 00 00 00 00 00 00 00 00 00 00 00 00 02
 02 00 00 00 00 02 00 00 00 00 00 02 00 00 02 00 02 25 02 00 00 02 00 00 00 00 26 00 00 00 00 00 02
 02 00 00 00 00 00 02 00 00 00 00 00 02 32 02 00 00 02 00 00 00 00 02 00 00 00 00 00 00 00 00 00 02
 02 00 00 00 00 00 00 02 00 00 00 00 00 02 02 00 00 00 00 00 00 00 00 02 00 00 00 00 26 00 00 00 02
 02 00 00 00 00 00 00 00 02 00 00 00 00 40 02 00 00 00 00 00 00 00 00 00 02 00 00 00 00 00 00 00 02
 02 00 00 00 25 00 00 00 00 02 00 00 00 00 02 00 00 00 02 00 00 00 00 00 00 02 00 00 00 00 26 00 02
 02 00 00 00 00 00 00 00 00 00 02 00 00 00 00 00 00 00 00 02 00 00 00 00 00 00 02 00 00 00 00 00 02
 02 00 00 00 00 00 00 00 00 00 40 02 00 00 00 00 00 00 00 00 02 00 00 00 00 00 00 02 00 00 00 00 02
 02 40 00 00 00 00 00 25 00 00 00 00 02 00 00 00 00 00 00 00 00 02 00 00 00 00 00 00 02 00 00 00 02
 02 00 00 00 00 00 00 00 00 00 00 00 00 02 00 00 00 26 00 00 00 00 02 00 00 00 00 00 00 02 00 00 02
 02 00 00 00 00 00 00 00 00 00 00 00 00 00 02 00 00 00 00 00 00 00 00 02 00 00 00 00 00 00 02 00 02
 02 00 00 00 00 00 00 00 00 00 26 00 00 00 00 02 00 00 00 26 00 00 00 00 02 00 00 00 00 00 00 02 02
 02 00 00 00 00 00 00 00 00 00 00 00 00 00 00 00 02 00 00 00 00 00 00 00 00 02 00 00 00 00 00 00 02
 02 00 02 00 00 00 02 00 00 00 00 00 00 00 00 00 00 02 00 00 00 26 00 00 00 00 02 00 00 00 00 00 02
 02 02 25 02 06 02 25 02 44 00 00 00 00 26 00 00 00 40 02 00 00 00 00 00 00 00 00 02 00 00 00 05 02
 02 02 02 02 02 02 02 02 02 02 02 02 02 02 02 02 02 02 02 02 02 02 02 02 02 02 02 02 02 02 02 02 02
