Gauntlet (rev 1 - 9)
Maze number: 62
Offset for maze 61: 235292 - 0x03971c
big endian buf: [%!l(uint8=0) %!l(uint8=3) %!l(uint8=151) %!l(uint8=28)]
G:1 Maze real addr: 243487 - 0x03B71F, bank 1, boff: 0x2000
Maze read from: 0x03b71f - 243487
compresssed: 156
 0F 04 00 02 00 31 80 A8 AA 66 5D 05 80 D3 1F C7
 4F E9 C0 1B C1 4D 26 65 A2 E3 B2 4F C0 27 C2 A1
 DC A1 43 A0 B2 D5 A1 C5 20 D5 A1 E1 E1 B2 E2 D1
 A1 C5 4F EC B2 DD 1E F9 E1 B2 E1 C2 A1 DD 1D F4
 B2 DF E0 C0 19 A2 B3 C1 63 26 58 CB 1A E2 BF C2
 69 60 4B A0 C3 AC BE A8 E2 C0 20 C3 27 C1 21 CF
 42 A0 7C EF CD AC D2 49 1D E6 CE 6C 1E A0 C1 40
 20 C2 46 AB B9 A1 C1 A2 59 C6 27 CA 25 C2 6A 4F
 D4 A9 DF C3 A2 BB CB 45 1E C8 1B C6 B6 C4 B6 A8
 D2 B4 CF BE C7 BB C4 1F CD B5 06 00
  Encoded length: 156 bytes
  Wall pattern: 01, Wall color: 00     Floor pattern: 03, Floor color: 08
  Flags: 
 02 02 02 02 02 02 02 02 02 02 02 02 02 02 02 02 02 02 02 02 02 02 02 02 02 02 02 02 02 02 02 02 02
 02 05 00 00 00 00 00 00 00 00 00 00 00 00 00 00 00 00 00 00 00 00 31 00 00 00 00 00 00 00 02 40 02
 02 00 00 00 00 00 00 00 00 00 00 00 00 00 00 00 00 00 00 00 00 00 00 00 00 00 02 00 27 00 02 40 02
 02 00 00 00 00 00 00 00 00 00 00 00 00 00 38 42 02 00 00 00 00 00 02 02 02 00 00 00 02 02 02 40 02
 02 00 00 00 00 00 00 00 00 00 00 00 00 00 00 00 02 39 00 00 00 02 02 00 00 00 00 00 02 00 00 00 02
 02 00 00 00 00 00 00 00 00 00 00 00 00 00 00 00 02 00 00 00 02 02 40 00 00 00 02 02 02 00 00 00 02
 02 00 00 00 00 00 00 00 00 00 00 00 00 00 00 00 02 00 00 02 02 00 00 00 00 00 02 32 00 00 00 00 02
 02 00 00 00 00 00 00 00 00 00 00 00 00 00 00 00 02 00 02 02 00 00 02 00 02 02 02 00 00 00 02 00 02
 02 00 00 00 00 00 00 00 00 00 00 00 00 00 00 00 02 02 02 00 00 00 00 00 02 40 00 00 00 00 00 00 02
 02 00 00 00 00 00 00 00 00 00 00 00 00 00 00 00 02 00 00 00 00 00 02 02 02 00 00 00 00 00 00 00 02
 02 00 00 00 00 00 00 00 00 00 00 00 00 00 00 00 02 00 00 00 00 00 02 30 00 00 00 00 00 00 00 00 02
 02 00 00 00 00 00 00 00 00 00 00 00 00 00 00 00 02 00 02 00 02 02 02 00 00 02 00 00 02 02 02 00 02
 02 00 00 00 00 00 00 00 00 00 00 00 00 00 00 00 02 00 00 00 02 00 00 00 00 00 00 00 02 29 00 00 02
 02 00 00 00 00 00 00 00 00 00 00 00 00 00 00 00 02 00 00 02 02 00 00 00 00 00 00 00 02 00 00 00 02
 02 00 00 00 00 00 00 00 00 00 00 00 00 00 00 00 02 00 00 00 00 00 02 00 25 02 02 02 02 00 00 42 02
 02 00 00 00 38 00 00 00 00 00 00 00 00 00 38 00 02 00 00 00 00 00 00 00 00 02 00 26 00 00 00 02 02
 02 00 00 00 42 00 00 00 00 00 00 00 00 00 00 42 02 40 00 00 00 00 00 00 00 02 00 00 00 00 02 00 02
 02 00 00 02 02 02 02 02 02 02 02 02 02 02 02 02 02 02 02 02 02 02 02 02 02 02 00 00 00 02 00 32 02
 02 00 00 00 39 00 02 33 00 00 00 00 00 00 00 00 00 00 00 00 00 00 00 00 40 02 00 00 02 00 00 00 02
 02 00 00 00 00 00 02 00 00 00 29 00 00 00 00 00 00 00 00 00 00 00 00 00 00 02 00 02 00 00 00 00 02
 02 00 00 00 00 00 02 00 00 02 02 02 02 02 02 02 02 02 02 02 02 02 02 00 00 02 00 00 00 00 00 00 02
 02 00 00 00 00 00 02 00 00 02 40 00 00 00 00 00 00 00 00 00 00 29 00 00 00 02 00 00 00 02 00 00 02
 02 00 00 00 00 00 02 00 00 02 00 00 00 42 00 00 00 00 00 00 00 00 00 00 00 02 00 30 02 00 00 40 02
 02 32 00 00 00 40 02 00 00 02 00 00 02 02 02 02 02 02 02 02 02 02 02 02 02 02 02 02 00 00 02 02 02
 02 00 00 00 00 00 02 00 00 02 00 38 02 00 00 00 00 00 02 39 00 00 00 00 00 00 00 00 00 00 00 37 02
 02 00 00 42 00 00 02 00 00 02 00 00 02 00 00 40 00 00 02 00 00 00 00 00 00 00 00 00 00 00 00 00 02
 02 00 00 00 00 00 02 00 00 02 00 00 02 00 00 02 00 00 02 00 00 02 02 02 02 02 02 02 02 02 02 00 02
 02 00 00 00 00 00 02 00 00 02 00 00 02 00 00 02 00 00 02 00 00 00 00 00 00 00 00 00 00 00 02 00 02
 02 00 00 02 02 02 02 00 00 02 00 00 02 00 00 02 00 00 02 40 00 00 00 00 00 00 30 00 00 00 02 00 02
 02 00 00 00 27 00 00 00 00 02 00 00 02 00 00 02 00 00 02 02 02 02 02 02 02 02 02 02 00 00 02 00 02
 02 00 00 00 00 00 00 00 00 02 00 00 00 00 00 02 00 00 00 00 00 00 00 00 00 00 00 00 00 00 02 00 02
 02 00 00 00 00 00 00 00 00 02 00 00 00 00 00 31 00 00 00 00 00 00 00 00 00 00 00 00 00 00 02 06 02
 02 02 02 02 02 02 02 02 02 02 02 02 02 02 02 02 02 02 02 02 02 02 02 02 02 02 02 02 02 02 02 02 02
