Gauntlet (rev 1 - 9)
Maze number: 24
Offset for maze 23: 235705 - 0x0398b9
big endian buf: [%!l(uint8=0) %!l(uint8=3) %!l(uint8=152) %!l(uint8=185)]
G:1 Maze real addr: 235708 - 0x0398BC, bank 0, boff: 0x0000
Maze read from: 0x0398bc - 235708
compresssed: 233
 09 14 00 00 00 00 02 A8 5B 0B 59 C5 42 1B 28 2B
 40 1B A0 28 A0 2B A0 28 A0 1B C0 1A 28 83 2B 6C
 C1 0B C0 0B C0 0B C0 0B C1 0B 85 C0 42 1B DF A4
 C3 14 17 0E C2 0E 17 14 CD 41 43 B4 A3 03 A3 B4
 A3 D2 19 80 72 74 D8 4F C3 B4 A3 CC B3 CC 23 C1
 23 C0 4F 6E 66 C0 44 45 4B 55 C3 B3 A7 D1 0A CA
 45 23 CB 0A CF 5A BA A5 74 C0 09 70 E0 19 A2 19
 A0 D2 1B C0 09 60 C0 A6 C1 BF AA CC 24 28 24 C4
 4F DF DF DF BF C0 BF C8 51 51 DC 52 60 C0 20 C0
 21 C1 21 C0 20 C3 40 2C C0 35 C2 35 C0 2C C4 03
 A5 C2 A6 BF A2 B2 C0 B2 A2 B8 71 C2 35 76 C7 28
 A0 06 C0 06 A0 4F DF E8 06 C2 06 A0 CB A2 B4 DF
 DF D3 1B BE E8 E4 EC C4 BE 1B 2A 28 80 1B A0 19
 A0 21 A0 19 A0 28 A0 2A A0 28 B4 05 B4 28 A0 2A
 A0 28 A0 19 A0 19 A0 21 00
  Encoded length: 233 bytes
  Wall pattern: 00, Wall color: 02     Floor pattern: 00, Floor color: 00
  Flags: 
 02 02 02 02 02 02 02 02 02 02 02 02 02 02 02 02 02 02 02 02 02 02 02 02 02 02 02 02 02 02 02 02 02
 02 00 00 00 00 00 40 00 00 00 27 40 43 40 02 27 02 40 02 43 02 40 02 27 02 26 40 40 40 40 40 43 02
 02 00 00 00 00 00 00 00 00 00 00 00 00 27 02 00 11 00 11 00 11 00 11 00 02 11 11 11 11 11 11 11 02
 02 40 00 00 00 27 00 00 00 00 00 00 00 00 02 00 00 00 00 00 00 00 00 00 02 00 00 00 00 00 00 00 02
 02 00 00 00 11 02 02 02 02 02 02 00 00 00 02 20 23 14 00 00 00 14 23 20 02 00 00 00 00 00 00 00 02
 02 00 00 00 11 02 40 00 00 40 02 00 00 00 02 02 02 02 02 03 02 02 02 02 02 02 02 02 02 00 00 00 02
 02 00 00 00 11 02 00 00 00 00 02 00 00 00 00 00 25 25 02 11 02 25 00 00 00 00 00 25 02 00 00 00 02
 02 00 00 00 11 02 00 00 00 00 02 00 00 00 00 00 00 00 02 11 02 40 00 00 00 00 00 00 02 00 00 00 02
 02 00 00 00 11 02 00 00 00 00 02 02 02 02 02 00 00 00 02 11 02 00 00 00 02 00 00 00 02 00 00 00 02
 02 00 00 00 11 02 00 00 00 00 35 00 00 35 02 40 00 00 02 11 02 00 00 00 02 00 00 00 00 00 00 00 02
 02 00 00 00 11 02 00 00 00 00 00 00 00 00 02 27 00 00 02 11 02 00 00 27 02 40 00 00 00 00 00 40 02
 02 00 00 00 11 02 40 00 00 00 00 00 00 00 02 00 00 00 02 11 02 00 00 00 02 02 02 02 02 02 02 02 02
 02 00 00 00 11 02 00 00 00 00 00 00 00 00 02 00 00 00 02 10 02 00 00 00 00 00 00 00 00 00 00 40 02
 02 00 00 00 11 02 35 00 00 00 00 00 00 00 02 00 00 00 02 10 02 00 00 00 00 00 00 00 00 00 00 00 02
 02 00 00 00 11 02 02 02 02 02 02 02 00 00 02 00 00 25 02 09 02 25 00 02 25 02 02 02 25 02 00 00 02
 02 00 00 00 00 00 00 00 00 00 00 00 00 00 02 00 00 27 02 09 02 27 00 02 02 02 02 02 02 02 00 00 02
 02 02 02 02 02 02 02 02 02 02 02 02 00 00 02 00 00 00 02 00 02 00 00 00 02 36 40 36 02 00 00 00 02
 02 40 00 00 00 00 00 00 00 00 00 00 00 00 02 00 00 00 02 00 02 00 00 00 02 00 00 00 02 00 00 00 02
 02 00 00 00 00 00 00 00 00 00 00 00 00 00 02 00 00 00 02 00 02 00 00 00 02 00 00 00 02 00 00 00 02
 02 00 00 00 00 00 00 00 00 00 00 00 00 00 02 00 00 00 02 00 02 00 00 00 02 00 00 00 02 11 11 11 02
 02 00 00 00 00 00 00 00 00 00 00 00 00 00 02 00 00 00 02 00 02 00 00 00 02 00 00 00 02 11 11 11 02
 02 00 00 00 00 00 00 00 00 00 00 00 00 00 02 00 00 00 02 00 02 00 00 00 02 00 00 00 02 11 00 27 02
 02 32 00 33 00 00 33 00 32 00 00 00 00 40 02 44 00 53 02 00 02 53 00 44 02 00 00 00 02 03 02 02 02
 02 02 02 02 00 00 02 02 02 02 02 02 02 02 02 02 02 02 02 00 02 02 02 02 02 00 00 25 02 00 00 53 02
 02 00 00 00 00 00 02 25 00 00 00 00 00 00 00 00 40 02 06 00 06 02 40 00 00 00 00 00 02 00 00 00 02
 02 00 00 00 00 00 02 00 00 00 00 00 00 00 00 00 00 00 00 00 00 00 00 00 00 00 00 00 02 00 00 00 02
 02 00 00 00 00 00 02 00 00 00 00 00 00 00 00 00 02 06 00 00 00 06 02 00 00 00 00 00 02 00 00 00 02
 02 00 00 02 02 02 02 00 00 00 00 00 00 00 00 00 00 00 02 00 02 00 00 00 00 00 00 00 02 00 00 00 02
 02 00 00 00 00 00 00 00 00 00 00 00 00 00 00 00 00 00 02 00 02 00 00 00 00 00 00 00 02 00 00 00 02
 02 00 00 00 00 00 00 00 00 00 00 00 00 00 00 00 00 00 02 00 02 00 00 00 00 00 00 27 02 00 00 00 02
 02 00 00 00 00 00 02 00 00 00 00 00 02 00 00 00 00 00 02 00 02 00 00 00 00 00 02 00 00 00 00 00 02
 02 27 42 40 40 27 02 25 02 33 02 25 02 40 02 42 02 40 02 05 02 40 02 42 02 40 02 25 02 25 02 33 02
 02 02 02 02 02 02 02 02 02 02 02 02 02 02 02 02 02 02 02 02 02 02 02 02 02 02 02 02 02 02 02 02 02
