Gauntlet (rev 1 - 9)
Maze number: 37
Offset for maze 36: 230157 - 0x03830d
big endian buf: [%!l(uint8=0) %!l(uint8=3) %!l(uint8=131) %!l(uint8=13)]
G:1 Maze real addr: 238352 - 0x03A310, bank 1, boff: 0x2000
Maze read from: 0x03a310 - 238352
compresssed: 351
 00 2A 07 1A 09 20 A5 68 5B D0 61 E1 21 80 41 A0
 2A 4E E2 06 E3 21 E0 E6 E2 E1 E2 E3 41 80 E0 40
 E8 E4 C0 2C E0 C1 05 C0 A1 C7 A3 E1 1E A0 E4 E2
 F3 C3 1D 0D 80 A0 C1 10 A0 74 82 E7 E2 C1 0D 81
 28 C0 10 81 A0 6B C8 B6 0D A0 0D 70 80 51 A0 C1
 B3 E3 28 E1 C1 A6 E2 C0 A1 10 82 28 A0 C3 B5 C6
 1D E5 E2 21 A0 21 E7 EA 42 E1 28 E5 E2 C5 1E E3
 E0 E1 E0 41 A2 E0 2A 80 E0 C0 1F 1E A2 E0 41 A0
 40 C0 A1 21 A0 71 A0 40 E0 C0 18 E2 CB 2A 72 A0
 E1 41 E1 28 E3 C2 BB C2 B6 E2 E2 1F A0 28 E2 C2
 A1 E5 E0 E2 21 A0 E2 E2 E1 E0 C2 1E A0 E3 E2 E2
 10 E1 C3 1F A1 C0 1F E0 E1 E3 44 E0 10 81 A0 C1
 2C A0 70 28 71 E1 28 A0 C5 1D A0 1D E1 10 81 A0
 E2 C1 1F A2 C0 1E C2 0F A0 C3 1D A0 E0 1D A0 E0
 10 80 28 E1 E2 E2 E2 22 0F A0 E2 E2 C2 A4 E2 C4
 A2 0F 80 A0 42 A0 28 40 A0 28 E4 E2 E2 40 E2 EF
 E2 1F 21 40 E0 E1 66 62 60 E2 E2 E0 1F A0 E2 E1
 41 A5 B2 A3 28 A0 E2 E2 E0 64 48 1B 82 E3 42 E2
 C0 2A C5 27 44 60 E4 E2 E4 C6 20 4C E3 E0 E9 E2
 E2 C1 A7 C2 A3 B4 A0 28 A1 28 40 BB 2A 1B 28 40
 C0 2A 47 20 81 43 46 C0 27 C4 B8 E2 42 80 B2 E4
 C2 B9 42 C2 B4 27 C4 26 A0 26 68 A0 C1 18 00
  Encoded length: 351 bytes
  Wall pattern: 00, Wall color: 05     Floor pattern: 02, Floor color: 10
  Flags: SHOTS_STUN 
  ╚══> while gauntlet has these elements, these flags probably do not operate
 02 02 02 02 02 02 02 02 02 02 02 02 02 02 02 02 02 02 02 02 02 02 02 02 02 02 02 02 02 02 02 02
 00 00 02 33 33 00 00 40 02 42 00 00 00 00 00 00 00 00 00 00 02 00 00 00 00 40 00 00 00 02 06 00
 00 00 00 02 33 00 02 00 00 00 00 00 00 00 02 00 00 00 02 00 02 02 00 00 00 02 00 00 00 00 02 00
 00 40 40 00 02 00 40 00 02 00 00 00 00 00 00 00 02 00 00 00 02 00 02 00 44 00 02 00 00 05 00 02
 02 00 00 00 00 02 00 00 02 02 02 02 02 00 00 02 30 02 00 00 02 00 00 02 00 00 00 02 00 00 00 00
 00 02 00 00 00 02 00 00 02 00 00 00 00 00 00 00 02 00 00 00 02 29 13 13 02 00 00 16 02 00 00 00
 00 02 33 33 33 02 00 00 02 00 00 00 00 00 02 00 00 00 02 00 02 13 13 13 40 00 16 16 16 02 00 00
 00 02 00 00 00 02 00 00 02 00 27 00 00 00 00 00 00 00 00 00 02 13 02 13 00 33 33 02 02 16 02 00
 00 02 00 00 00 02 02 40 02 00 02 00 02 02 02 02 02 02 02 02 00 00 00 02 00 02 02 16 16 16 16 40
 02 00 00 00 00 02 00 00 02 00 00 00 02 29 00 00 00 00 00 00 02 00 00 00 02 33 02 33 00 00 00 00
 00 00 00 00 02 00 00 00 02 00 00 00 02 00 00 00 02 00 00 00 40 00 00 02 40 00 00 00 00 00 00 02
 00 00 00 02 00 00 00 00 02 00 30 00 02 00 00 02 00 02 00 00 02 00 02 00 00 40 02 02 02 00 02 42
 42 00 02 00 31 30 02 02 02 00 02 00 02 40 02 00 40 00 02 02 33 02 00 00 33 02 00 40 00 02 00 24
 00 00 00 02 00 00 00 00 02 00 00 00 02 00 00 00 42 00 00 00 33 02 00 00 02 00 00 40 00 00 02 40
 00 00 00 00 02 00 00 00 02 00 00 00 02 00 00 00 02 00 00 00 02 31 02 40 00 00 00 02 00 00 00 02
 02 00 00 00 00 00 00 02 00 02 00 00 00 02 33 02 00 00 00 02 00 00 00 02 00 00 02 00 02 00 00 00
 30 02 00 00 00 00 02 00 00 00 02 00 00 00 02 16 00 00 02 00 00 00 00 31 02 02 00 31 00 02 00 00
 02 00 00 00 00 02 00 00 00 00 00 40 00 02 16 16 16 02 00 00 44 02 00 33 40 00 00 33 00 00 02 40
 02 00 00 00 02 00 00 29 02 29 00 00 02 16 16 16 02 00 00 00 02 00 00 31 02 02 02 00 30 00 00 00
 15 02 00 00 02 00 29 02 00 02 29 02 00 02 16 16 40 00 00 02 00 00 00 02 00 00 00 02 00 00 00 02
 34 15 02 00 02 00 02 00 00 00 02 00 00 00 02 02 02 02 02 00 00 00 02 00 00 00 00 00 02 02 02 15
 15 02 00 00 02 40 02 40 00 40 02 40 00 00 00 00 00 02 00 00 00 02 00 00 00 02 00 40 00 00 00 02
 02 00 00 00 02 00 00 00 02 00 00 00 02 00 00 00 02 00 00 00 02 31 33 00 40 00 02 00 00 02 00 00
 02 00 00 00 02 27 00 00 02 27 00 27 02 00 00 02 00 00 00 02 00 02 31 02 00 00 00 02 00 00 02 00
 02 40 02 02 02 02 02 02 02 02 02 02 02 40 02 00 00 00 02 00 00 00 02 00 02 00 00 00 02 00 27 00
 02 00 00 00 02 00 00 00 40 27 27 27 02 00 00 00 00 02 00 00 00 40 00 00 00 02 00 42 02 00 00 00
 02 00 39 00 02 00 00 00 40 00 27 00 02 00 00 00 02 00 00 00 02 00 00 00 00 00 02 00 02 00 00 00
 02 00 32 00 02 00 00 00 02 00 00 00 02 00 00 00 40 00 00 00 00 02 00 02 00 00 00 00 02 00 00 00
 02 00 02 00 02 00 02 00 02 00 02 00 02 02 02 02 02 02 02 02 02 00 02 00 02 02 02 02 02 02 40 02
 02 40 00 40 02 42 27 40 02 40 00 42 02 00 00 00 00 00 00 00 40 32 02 32 00 00 00 00 40 00 00 00
 02 00 00 00 40 00 39 00 02 00 00 00 02 00 00 00 02 00 00 00 40 40 02 00 00 00 00 00 02 00 00 00
 02 00 00 00 40 00 00 00 02 39 00 00 00 00 00 38 02 38 00 00 00 00 00 00 00 00 00 27 02 00 00 24
 02 02 02 02 02 02 02 02 02 02 02 02 02 02 02 02 02 02 02 02 02 02 02 02 02 02 02 02 02 02 02 02
