Gauntlet (rev 1 - 9)
Maze number: 13
Offset for maze 12: 232359 - 0x038ba7
big endian buf: [%!l(uint8=0) %!l(uint8=3) %!l(uint8=139) %!l(uint8=167)]
G:1 Maze real addr: 232362 - 0x038BAA, bank 0, boff: 0x0000
Maze read from: 0x038baa - 232362
compresssed: 323
 03 38 00 04 00 14 44 68 5B 39 BB 2E 80 D3 39 C0
 75 2B C2 21 C4 51 C2 A6 71 51 69 C4 51 E2 C1 24
 C0 1E E1 C2 51 CD 51 E2 C0 51 39 83 51 E0 C2 51
 13 80 C9 51 E2 44 E4 C2 51 14 80 C7 51 E2 C2 A6
 E2 C2 51 C7 51 E2 E2 42 E2 E2 C2 51 C3 3B 80 51
 E2 E2 C3 39 E3 E2 C2 51 18 80 C0 39 51 E2 C1 19
 A0 C2 A1 1B A1 E2 E2 C2 51 3A 81 E2 E2 E2 C0 52
 39 52 E0 E2 E2 C2 51 E3 E2 E2 19 E5 E2 E2 C4 3B
 A0 E2 E2 C2 A2 E2 E2 E2 C4 39 E5 E2 40 E0 E2 C5
 39 EA E2 E4 E2 CA 24 C4 39 C4 A2 C4 39 64 C1 BF
 45 C0 24 E4 0C 41 C2 24 40 40 66 C3 52 39 52 C3
 3A A0 B2 C1 B2 C0 52 39 52 C3 24 F4 C1 19 A0 C9
 B6 39 56 EC E2 C2 B6 C0 56 39 B6 E3 CB A1 E2 E2
 E2 7F C3 19 A0 E2 E2 D2 39 E1 E2 E2 48 C7 B7 18
 80 A1 E2 19 E1 C3 51 E4 BB C7 52 39 52 E2 E2 C3
 51 73 A1 C1 3A C2 BA 42 E2 E2 C3 51 C4 A1 E2 B8
 C2 A6 E2 C3 51 43 A1 C2 A1 2A A0 3A 43 E4 C3 51
 C4 A1 C2 A1 C1 2C A0 C1 39 84 E0 C3 51 63 A1 C2
 A1 E4 51 C0 21 60 C0 51 A0 C3 51 C3 1E C4 A1 45
 A6 C3 51 C3 24 C1 BE 05 C0 A1 06 CF 39 51 C3 27
 C1 2A 00
  Encoded length: 323 bytes
  Wall pattern: 04, Wall color: 04     Floor pattern: 01, Floor color: 04
  Flags: 
 02 02 02 02 02 02 02 02 02 02 02 02 02 02 02 02 02 02 02 02 02 02 02 02 02 02 02 02 02 02 02 02 02
 02 46 00 00 00 00 00 00 00 57 00 00 00 00 00 00 00 00 00 00 00 00 57 57 59 00 00 00 00 00 00 43 02
 02 00 00 33 00 00 00 00 57 57 00 00 00 02 02 02 02 02 02 02 59 00 00 57 57 00 00 00 00 00 00 00 02
 02 00 27 00 00 00 00 57 57 00 00 00 02 57 00 36 00 30 00 57 02 00 00 00 57 57 00 00 00 00 00 00 02
 02 00 00 00 00 00 57 57 00 00 00 02 00 57 57 57 57 57 57 57 00 02 00 00 00 57 57 19 00 00 00 00 02
 02 00 00 00 00 57 57 00 00 00 02 00 00 00 00 00 40 00 00 00 00 00 02 00 00 00 57 57 20 00 00 00 02
 02 00 00 00 57 57 00 00 00 02 00 00 00 02 02 02 02 02 02 02 00 00 00 02 00 00 00 57 57 00 00 00 02
 02 00 00 57 57 00 00 00 02 00 00 00 02 00 00 00 40 00 00 00 02 00 00 00 02 00 00 00 57 57 00 00 02
 02 59 57 57 00 00 00 02 00 00 00 02 00 00 00 57 57 57 00 00 00 02 00 00 00 02 00 00 00 57 57 24 02
 02 57 57 00 00 00 02 00 00 25 02 00 00 00 02 57 27 57 02 00 00 00 02 00 00 00 02 00 00 00 57 57 02
 02 58 00 00 00 02 00 00 00 02 00 00 00 02 00 57 57 57 00 02 00 00 00 02 00 00 00 02 00 00 00 57 02
 02 00 00 00 02 00 00 00 02 00 00 00 02 25 00 00 00 00 00 00 02 00 00 00 02 00 00 00 02 00 00 00 02
 02 00 59 02 00 00 00 02 00 00 00 02 00 00 00 02 02 02 00 00 00 02 00 00 00 02 00 00 00 02 00 00 02
 02 00 02 57 57 00 02 00 00 00 02 00 00 00 02 00 40 00 02 00 00 00 02 00 00 00 02 00 57 57 02 00 02
 02 00 02 00 57 00 02 00 00 02 00 00 00 02 00 00 00 00 00 02 00 00 00 02 00 00 02 00 57 00 02 00 02
 02 00 02 36 57 00 02 00 57 57 57 00 02 00 00 02 02 02 00 00 02 00 57 57 57 00 02 00 57 27 02 00 02
 02 00 02 00 57 00 02 40 57 36 57 00 02 00 02 02 12 02 00 40 02 00 57 36 57 40 02 40 57 00 02 00 02
 02 00 02 27 57 00 02 00 57 57 57 00 02 00 02 58 02 02 00 00 02 00 57 57 57 00 02 00 57 36 02 00 02
 02 00 02 00 57 00 02 00 00 02 00 00 02 00 02 00 00 00 00 02 00 00 25 02 00 00 02 00 57 00 02 00 02
 02 00 02 57 57 00 02 00 00 02 00 00 02 00 02 00 00 00 02 00 00 00 02 00 00 00 02 00 57 57 02 00 02
 02 00 00 02 00 00 02 00 00 02 00 00 02 00 02 00 02 02 00 00 00 02 00 00 00 02 00 00 00 02 59 00 02
 02 00 00 00 00 00 02 00 00 02 00 00 02 00 02 00 00 00 00 25 02 00 00 00 02 00 00 00 02 00 00 00 02
 02 00 00 00 00 00 02 00 00 02 00 00 02 00 02 57 57 57 00 02 00 00 00 02 00 00 00 02 00 00 00 57 02
 02 00 00 00 00 40 02 00 00 02 00 00 02 00 02 57 24 57 02 00 00 00 02 25 00 00 02 00 00 00 57 57 02
 02 00 00 00 00 02 02 00 00 02 00 00 02 00 00 57 57 57 00 00 00 02 00 00 00 02 00 00 00 57 57 59 02
 02 00 00 00 02 02 00 00 58 02 00 00 02 00 00 00 40 00 00 00 02 00 00 00 02 00 00 00 57 57 00 00 02
 02 00 00 02 02 00 00 00 02 02 00 00 00 02 02 02 02 02 02 02 00 00 00 02 00 00 00 57 57 00 00 00 02
 02 40 02 02 00 00 00 02 02 42 02 58 00 00 00 00 40 00 00 00 00 00 02 00 00 00 57 57 00 00 00 00 02
 02 02 02 00 00 00 02 02 00 00 44 02 00 57 57 57 57 57 57 57 00 02 00 00 00 57 57 00 00 00 00 27 02
 02 02 00 00 00 02 02 00 00 00 00 00 02 57 00 33 00 27 00 57 02 00 00 00 57 57 00 00 00 00 30 00 02
 02 00 00 00 02 02 00 00 00 00 00 00 40 02 02 02 02 02 02 02 00 00 00 57 57 00 00 00 00 36 00 00 02
 02 05 00 02 02 06 00 00 00 00 00 00 00 00 00 00 00 00 00 00 00 00 57 57 00 00 00 00 39 00 00 42 02
 02 02 02 02 02 02 02 02 02 02 02 02 02 02 02 02 02 02 02 02 02 02 02 02 02 02 02 02 02 02 02 02 02
