Gauntlet (rev 1 - 9)
Maze number: 46
Offset for maze 45: 232869 - 0x038da5
big endian buf: [%!l(uint8=0) %!l(uint8=3) %!l(uint8=141) %!l(uint8=165)]
G:1 Maze real addr: 241064 - 0x03ADA8, bank 1, boff: 0x2000
Maze read from: 0x03ada8 - 241064
compresssed: 229
 17 3B 0C 1F 00 00 00 A8 5A 06 60 2A 80 C5 28 82
 C5 44 45 2A C9 1B C8 4D 20 C4 52 C8 52 19 C1 4F
 C2 53 7F D5 06 D9 1A D7 56 C5 46 47 40 06 82 66
 C1 56 C3 28 57 06 81 C1 06 83 C0 49 4F C1 4A 06
 80 54 06 81 C2 4E 1B C5 42 19 C2 54 06 80 C1 06
 81 C7 28 81 C2 4E 42 1A C4 06 81 C0 06 81 56 C4
 53 4F C0 47 1A 28 51 C2 06 41 47 41 55 06 89 C4
 06 82 51 C1 54 C1 06 81 BF C7 28 19 C4 05 65 C6
 19 61 06 89 C6 06 81 C1 06 81 C1 06 C0 45 45 40
 42 48 40 06 89 C2 06 81 C0 4A 28 81 C8 41 51 C0
 40 51 C3 51 C6 40 1B D1 54 CB 4F 67 44 06 86 CF
 06 81 54 C0 56 C1 4F C0 4F DF CA 28 1A 42 1A C8
 4D 55 06 81 55 C1 06 28 55 C6 42 20 D7 20 D6 56
 DF CA BE 2A C7 28 5A 28 80 52 28 1B 28 51 41 28
 52 C1 43 2A 00
  Encoded length: 229 bytes
  Wall pattern: 00, Wall color: 00     Floor pattern: 00, Floor color: 00
  Flags: 
 02 02 02 02 02 02 02 02 02 02 02 02 02 02 02 02 02 02 02 02 02 02 02 02 02 02 02 02 02 02 02 02 02
 02 42 00 00 00 00 00 06 40 06 40 06 00 00 00 00 00 00 40 06 00 06 00 00 40 00 00 00 00 00 00 42 02
 02 00 00 00 00 00 00 06 00 06 27 06 00 00 00 06 00 00 00 06 40 06 00 00 00 00 00 00 00 00 00 00 02
 02 00 00 32 00 00 00 06 00 06 00 06 00 00 00 06 00 00 00 06 25 06 00 40 00 00 00 00 00 00 00 00 02
 02 00 00 00 00 00 00 06 00 00 00 06 00 00 00 06 00 00 00 00 00 06 00 00 00 00 00 00 32 00 00 00 02
 02 00 00 00 00 00 00 06 00 00 00 00 00 00 00 06 00 00 00 06 00 06 00 00 00 00 00 00 00 00 00 00 02
 02 00 00 00 00 00 00 06 00 00 00 00 00 06 26 06 00 00 00 00 00 06 00 00 00 00 00 00 00 00 00 00 02
 02 00 00 00 00 00 00 06 00 00 06 00 00 06 40 06 00 00 00 06 00 06 40 00 00 00 00 00 00 00 00 40 02
 02 06 06 06 06 00 00 00 00 00 06 00 26 06 00 06 00 00 00 06 40 06 06 06 06 00 00 06 06 06 06 06 02
 02 40 00 00 00 00 00 00 00 00 06 00 40 06 00 00 00 00 00 06 00 00 00 00 00 00 00 00 00 00 00 40 02
 02 00 06 00 00 00 00 00 00 00 06 06 06 06 06 06 06 00 00 06 40 00 00 00 00 00 00 00 00 00 00 00 02
 02 00 06 00 27 00 00 00 00 00 06 40 00 00 00 25 06 00 00 06 06 06 00 00 06 06 06 00 00 00 00 00 02
 02 00 06 40 40 40 00 00 00 40 06 00 00 00 00 00 06 00 00 00 00 00 00 00 00 40 06 00 00 26 00 00 02
 02 00 06 06 06 06 00 06 06 06 06 00 00 00 06 00 06 40 00 00 00 00 00 00 00 00 06 00 00 00 00 00 02
 02 00 06 40 00 00 00 00 00 00 00 00 26 40 06 00 00 00 06 40 00 00 40 06 00 00 06 00 00 00 00 40 02
 02 00 06 06 06 06 06 06 06 06 06 06 06 06 00 00 00 00 00 06 06 06 06 06 00 00 06 00 00 06 06 06 02
 02 00 00 00 00 00 00 00 00 40 25 00 00 00 00 00 05 00 00 00 00 00 00 26 00 00 00 00 00 00 00 25 02
 02 00 26 06 06 06 06 06 06 06 06 06 06 06 00 00 00 00 00 00 06 06 06 06 00 00 06 06 06 00 06 06 02
 02 40 00 00 00 00 00 00 40 00 00 00 00 00 00 40 00 40 00 00 06 40 00 00 00 00 00 00 00 00 06 40 02
 02 06 06 06 06 06 06 06 06 06 06 06 00 00 06 06 06 06 06 40 06 00 00 06 00 00 00 00 06 00 06 40 02
 02 40 00 00 00 00 00 00 00 00 00 40 00 00 06 00 40 00 06 00 06 00 00 06 00 00 00 00 06 00 06 40 02
 02 27 00 00 00 00 00 00 00 00 00 06 00 00 00 00 00 00 00 00 06 00 00 00 00 00 00 00 06 00 06 00 02
 02 40 00 00 00 00 00 00 00 00 00 06 00 00 06 00 00 00 06 00 00 00 00 06 00 00 26 40 06 00 06 00 02
 02 06 06 06 06 06 06 06 06 00 00 06 00 00 06 00 00 00 06 00 06 00 00 06 00 06 06 06 06 00 06 00 02
 02 40 00 00 00 00 00 00 00 00 00 06 00 00 06 00 00 00 06 40 06 00 00 06 00 00 00 00 00 00 00 00 02
 02 00 00 00 00 00 00 00 00 00 00 06 00 00 06 00 00 00 06 00 06 00 00 06 00 00 00 00 00 00 00 00 02
 02 00 00 00 00 00 00 00 00 00 00 06 00 00 06 40 26 40 06 00 06 26 00 06 00 00 00 00 00 00 00 40 02
 02 00 00 00 00 00 00 00 00 00 00 06 00 00 06 06 06 06 06 00 06 06 40 06 00 00 00 00 00 00 00 40 02
 02 00 00 32 00 00 00 00 00 00 00 06 00 00 00 00 00 00 00 00 06 00 00 00 00 00 00 00 32 00 00 00 02
 02 00 00 00 00 00 00 00 00 00 00 06 00 00 06 00 00 00 00 00 06 00 00 06 00 00 00 00 00 00 00 00 02
 02 00 00 00 00 00 00 00 00 00 00 06 00 00 06 00 00 00 06 00 00 00 00 06 00 00 00 00 00 00 00 00 02
 02 42 00 00 00 00 00 00 00 00 40 06 40 40 06 40 27 40 06 40 00 00 40 06 00 00 40 00 00 00 00 42 02
 02 02 02 02 02 02 02 02 02 02 02 02 02 02 02 02 02 02 02 02 02 02 02 02 02 02 02 02 02 02 02 02 02
