Gauntlet (rev 1 - 9)
Maze number: 5
Offset for maze 4: 230555 - 0x03849b
big endian buf: [%!l(uint8=0) %!l(uint8=3) %!l(uint8=132) %!l(uint8=155)]
G:1 Maze real addr: 230558 - 0x03849E, bank 0, boff: 0x0000
Maze read from: 0x03849e - 230558
compresssed: 105
 00 00 00 00 00 20 04 4F 5F 68 6B 1F 82 5A 50 6A
 82 7D 70 D1 AB B2 AB 56 D6 28 D3 20 DF D5 AF 6F
 7E DF D2 A6 45 F8 D1 0F EC DC 20 47 DF D3 06 CE
 BF 0F 81 40 D3 0F 41 82 DF C9 B8 DF D7 BF D6 BF
 CF A7 B8 D0 BF FE 1F 6D CE AF A0 BF 4B D4 0F 48
 D4 0F 65 41 D4 0F 61 C4 B7 A9 C2 A9 B7 43 DC 0F
 40 DC 0F BE 0F CD 05 4D 00
  Encoded length: 105 bytes
  Wall pattern: 00, Wall color: 04     Floor pattern: 02, Floor color: 00
  Flags: 
 02 02 02 02 02 02 02 02 02 02 02 02 02 02 02 02 02 02 02 02 02 02 02 02 02 02 02 02 02 02 02 02 02
 02 31 31 31 00 00 00 00 00 00 00 00 00 00 00 40 02 40 00 00 00 00 00 00 00 00 00 00 00 31 31 31 02
 02 00 00 00 00 00 00 00 00 00 00 00 00 00 00 43 02 43 00 00 00 00 00 00 00 00 00 00 00 00 00 00 02
 02 00 00 00 02 02 02 02 02 02 02 02 02 02 02 02 02 02 02 02 02 02 02 02 02 02 02 02 02 00 00 00 02
 02 00 00 00 40 00 00 00 00 00 00 00 00 00 00 00 00 00 00 00 00 00 00 00 00 00 00 00 40 00 00 00 02
 02 00 00 00 02 00 00 00 00 00 00 00 00 00 00 00 00 32 00 00 00 00 00 00 00 00 00 00 02 00 00 00 02
 02 00 00 00 02 00 00 00 00 00 00 00 00 00 00 00 00 00 00 00 00 00 00 00 00 00 00 00 02 00 00 00 02
 02 00 00 00 02 00 00 02 02 02 02 02 02 02 02 02 02 02 02 02 02 02 02 02 00 00 00 00 02 00 00 00 02
 02 00 00 00 02 00 00 02 31 00 00 00 00 00 00 00 00 00 00 00 00 00 00 00 43 00 00 00 02 00 00 00 02
 02 00 00 00 02 00 00 02 00 00 00 00 00 00 00 00 00 00 00 00 00 00 00 00 02 00 00 00 02 00 00 00 02
 02 00 00 00 02 00 00 02 00 00 00 02 02 02 02 02 02 02 02 00 00 00 00 00 02 15 00 00 02 00 00 00 02
 02 00 00 00 02 00 00 02 00 00 00 02 00 00 00 00 00 00 00 02 00 00 00 00 02 00 00 00 02 00 00 00 02
 02 00 00 00 02 00 15 02 00 00 00 02 00 00 00 00 00 00 00 00 02 00 00 00 02 00 00 00 02 00 00 00 02
 02 00 00 00 02 00 00 02 00 00 00 02 00 00 00 00 00 00 32 00 00 02 00 00 02 00 00 15 02 00 00 00 02
 02 00 00 00 02 00 00 02 00 00 00 02 00 00 00 00 00 00 00 00 00 02 00 00 02 00 00 00 02 00 00 00 02
 02 00 00 00 02 00 00 02 00 00 00 02 00 00 00 00 06 00 00 00 00 02 00 00 02 00 00 00 02 00 00 00 02
 02 15 15 15 02 15 00 02 00 00 00 02 00 00 00 00 00 00 00 00 00 02 00 00 02 00 15 00 02 15 15 15 02
 02 00 00 00 02 00 00 02 00 00 00 02 00 00 00 00 00 00 00 00 00 02 00 00 02 00 00 00 02 00 00 00 02
 02 00 00 00 02 00 00 02 00 00 00 02 00 00 00 00 00 00 00 00 00 02 00 00 02 00 00 00 02 00 00 00 02
 02 00 00 00 02 00 00 02 00 00 00 00 00 00 00 00 00 00 00 00 00 02 00 00 02 00 00 00 02 00 00 00 02
 02 00 00 00 02 00 00 02 00 00 00 00 00 00 00 00 00 00 00 00 00 02 00 00 02 00 00 00 02 00 00 00 02
 02 00 00 00 02 00 00 02 00 00 00 00 00 02 02 02 02 02 02 02 02 02 00 00 02 00 00 00 02 00 00 00 02
 02 00 00 00 02 00 00 02 00 00 00 00 00 00 00 00 00 00 00 00 00 00 00 00 02 00 00 00 02 00 00 00 02
 02 00 00 00 02 00 00 02 31 00 00 00 00 00 00 00 00 00 00 00 00 00 00 31 02 00 00 00 02 00 00 00 02
 02 00 00 00 02 00 00 02 02 02 02 02 02 02 02 02 02 02 02 02 02 02 02 02 02 00 00 00 02 00 00 00 02
 02 00 00 00 02 15 00 00 00 00 00 00 00 00 00 00 00 00 00 00 00 00 00 00 00 00 00 15 02 00 00 00 02
 02 00 00 00 02 15 00 00 00 00 00 00 00 00 00 00 00 00 00 00 00 00 00 00 00 00 00 15 02 00 00 00 02
 02 00 31 00 02 15 00 00 00 00 00 00 00 00 00 00 00 00 00 00 00 00 00 00 00 00 00 15 02 00 31 00 02
 02 00 00 00 02 02 02 02 02 02 02 02 02 02 02 00 00 00 02 02 02 02 02 02 02 02 02 02 02 00 00 00 02
 02 15 00 00 00 00 00 00 00 00 00 00 00 00 00 00 00 00 00 00 00 00 00 00 00 00 00 00 00 00 00 15 02
 02 15 00 00 00 00 00 00 00 00 00 00 00 00 00 00 00 00 00 00 00 00 00 00 00 00 00 00 00 00 00 15 02
 02 15 00 00 00 00 00 00 00 00 00 00 00 00 00 00 05 00 00 00 00 00 00 00 00 00 00 00 00 00 00 15 02
 02 02 02 02 02 02 02 02 02 02 02 02 02 02 02 02 02 02 02 02 02 02 02 02 02 02 02 02 02 02 02 02 02
