Gauntlet (rev 1 - 9)
Maze number: 29
Offset for maze 28: 237115 - 0x039e3b
big endian buf: [%!l(uint8=0) %!l(uint8=3) %!l(uint8=158) %!l(uint8=59)]
G:1 Maze real addr: 237118 - 0x039E3E, bank 0, boff: 0x0000
Maze read from: 0x039e3e - 237118
compresssed: 222
 08 03 07 1A 00 21 DE A8 5B 0C 0B DC 40 42 AF AB
 24 C2 0C 81 C4 1C D0 40 44 AF AB C3 1C C2 1C C2
 0B 81 C1 28 80 0B 1B 2C 2A C1 0B 81 28 82 C5 AF
 A0 B2 61 CA 4E 1B 0B CF AF A1 CF 0C C1 0C 80 C8
 74 C4 73 CA A3 C1 A5 D3 0C C0 0C 80 64 D1 54 C3
 A3 B2 E1 D2 1C C3 28 81 C3 2A D4 51 C2 B2 A3 B2
 CD 54 C0 54 C8 2A C2 0F 82 CA BF EB C1 06 D0 BF
 C9 4F CD B4 1B A3 B2 D0 BF C9 4D BF EB C1 B4 A0
 C0 A3 C1 4D BF C3 44 0F 80 42 A0 BD C0 BF C0 BF
 CE B2 A6 BA C0 BC 0B 80 CE BF C5 0F 83 62 6C B2
 C2 BE C0 AA C5 72 CD 28 81 C5 35 C2 28 84 C5 A2
 B2 A3 B2 A9 B3 A0 B4 A0 B4 1B C5 B7 CA 0C 85 0B
 82 C6 BA C2 AF A7 B8 71 CF 0C 86 60 C1 0B 81 41
 05 C1 AF A9 28 BE CE 0C 86 C3 0B 81 28 00
  Encoded length: 222 bytes
  Wall pattern: 01, Wall color: 14     Floor pattern: 02, Floor color: 13
  Flags: 
 02 02 02 02 02 02 02 02 02 02 02 02 02 02 02 02 02 02 02 02 02 02 02 02 02 02 02 02 02 02 02 02 02
 02 00 00 00 00 00 00 00 00 00 00 00 00 00 00 00 00 00 00 00 00 00 00 00 00 00 00 00 00 40 00 40 02
 02 00 02 02 02 02 02 02 02 02 02 02 02 02 02 02 02 02 02 02 02 02 02 02 02 02 02 02 02 02 02 36 02
 02 00 02 12 12 12 00 00 00 00 00 28 00 00 00 00 00 00 00 00 00 00 00 00 00 00 00 00 00 40 00 40 02
 02 00 02 00 02 02 02 02 02 02 02 02 02 02 02 02 02 02 02 02 02 02 02 02 02 02 02 02 02 02 02 02 02
 02 00 02 00 02 28 00 00 00 28 00 00 00 11 11 11 00 00 40 40 11 27 44 42 02 11 11 11 11 40 02 40 02
 02 00 02 00 02 00 02 02 02 02 02 02 02 02 02 02 02 02 02 02 02 02 02 02 02 11 02 27 02 00 02 11 02
 02 00 02 00 02 00 02 40 00 00 00 00 00 00 00 00 00 00 00 00 00 00 00 27 11 11 02 00 02 00 02 11 02
 02 00 02 00 02 00 02 12 02 02 02 02 02 02 02 02 02 02 02 02 02 02 02 02 02 11 02 00 02 00 02 11 02
 02 00 02 00 02 00 02 12 02 00 00 12 00 00 12 12 00 00 00 00 00 00 00 00 02 11 02 00 02 00 02 11 02
 02 00 02 00 02 00 02 12 02 00 02 02 02 02 02 00 02 02 02 02 02 02 02 00 02 00 02 00 02 00 02 00 02
 02 12 02 12 02 00 02 12 02 00 02 12 00 12 12 00 02 00 00 00 27 00 02 00 02 00 02 00 02 00 02 00 02
 02 12 02 12 02 00 02 12 02 00 02 00 02 02 02 02 02 00 02 02 02 00 02 00 02 00 02 00 02 00 02 00 02
 02 12 02 12 02 00 02 28 02 12 02 00 40 02 40 00 00 00 02 42 02 00 02 00 02 00 02 00 02 00 02 00 02
 02 12 02 12 02 00 02 00 02 12 02 00 02 02 02 02 02 02 02 00 02 00 02 00 02 00 02 00 02 00 02 00 02
 02 12 02 12 02 00 02 00 02 00 02 00 02 42 00 00 00 15 15 15 02 00 02 00 02 00 02 00 02 00 02 00 02
 02 00 02 00 02 00 02 00 02 00 02 00 02 02 02 00 06 00 02 00 02 00 02 00 02 00 02 00 02 00 02 00 02
 02 00 02 00 02 00 02 00 02 00 02 00 02 40 02 00 00 00 02 00 02 00 02 00 02 00 02 00 02 00 02 00 02
 02 00 02 00 02 00 02 00 02 00 02 00 02 27 02 02 02 02 02 00 02 00 02 00 02 00 02 00 02 00 02 00 02
 02 00 02 00 02 00 02 00 02 00 02 00 00 00 02 40 00 00 00 00 02 00 02 00 02 00 02 00 02 00 02 00 02
 02 00 02 00 02 00 02 00 02 00 02 02 02 00 02 02 00 02 02 02 02 00 02 40 02 00 02 00 02 00 02 00 02
 02 00 02 00 02 00 02 00 02 00 02 40 02 00 00 00 00 15 15 40 02 00 02 02 02 00 02 00 02 00 02 00 02
 02 00 02 00 02 00 02 00 02 00 02 00 02 02 02 02 02 02 02 02 02 00 02 11 11 00 02 00 02 11 02 00 02
 02 00 02 00 02 00 02 00 02 00 02 00 00 00 00 15 15 15 15 15 00 00 00 27 02 00 02 00 02 11 02 00 02
 02 00 02 00 02 27 02 00 02 00 02 00 02 02 02 02 02 02 02 02 02 02 02 00 02 00 02 00 02 11 02 00 02
 02 00 02 00 02 00 00 00 02 00 00 00 40 02 40 00 00 00 00 00 00 53 00 00 02 40 02 40 02 40 02 00 02
 02 00 02 00 02 02 02 02 02 02 02 02 02 02 02 02 02 02 02 02 02 02 02 02 02 02 02 02 02 27 02 00 02
 02 00 02 00 02 00 00 00 00 00 00 00 00 00 00 00 12 12 12 12 12 12 12 11 11 11 11 00 00 00 02 11 02
 02 00 02 00 00 00 02 02 02 02 02 02 02 02 02 02 02 02 02 02 02 02 02 02 02 02 02 02 02 02 02 11 02
 02 00 00 00 00 00 00 00 00 00 00 00 00 00 00 00 12 12 12 12 12 12 12 12 00 27 00 00 11 11 11 40 02
 02 00 05 00 00 02 02 02 02 02 02 02 02 02 02 02 02 02 02 02 02 02 02 02 02 02 02 02 02 02 02 40 02
 02 00 00 00 00 00 00 00 00 00 00 00 00 00 00 00 12 12 12 12 12 12 12 12 00 00 00 00 11 11 11 40 02
 02 02 02 02 02 02 02 02 02 02 02 02 02 02 02 02 02 02 02 02 02 02 02 02 02 02 02 02 02 02 02 02 02
