Gauntlet (rev 1 - 9)
Maze number: 27
Offset for maze 26: 236543 - 0x039bff
big endian buf: [%!l(uint8=0) %!l(uint8=3) %!l(uint8=155) %!l(uint8=255)]
G:1 Maze real addr: 236546 - 0x039C02, bank 0, boff: 0x0000
Maze read from: 0x039c02 - 236546
compresssed: 301
 04 36 01 02 08 63 A0 03 51 04 61 21 80 C2 04 77
 C0 04 21 C7 04 73 C3 43 C5 43 C5 43 C6 41 C1 41
 C3 41 C1 41 C3 41 C0 2A 41 C4 41 C3 41 C1 41 61
 C0 41 C1 41 60 C1 41 C2 41 71 C2 43 C5 43 63 C0
 43 C0 04 64 64 CC 2A 04 C3 41 62 D1 11 C0 41 C4
 41 60 C0 44 A0 41 A0 44 C3 35 41 7B C4 2A 73 CE
 51 D5 51 C6 41 C4 28 C7 28 C6 41 73 41 C6 41 A0
 41 A0 41 65 C1 41 70 5C C0 04 C4 54 C1 04 35 C1
 35 C1 04 C1 55 C5 35 04 C1 42 E4 C0 41 C5 41 E0
 C6 42 70 41 60 C4 35 6A C3 41 70 C2 41 C2 51 2A
 51 C7 51 2A 51 C4 41 EA C0 41 C4 05 41 E0 CD 51
 60 C3 04 35 C4 04 C7 51 C6 41 C5 41 A0 41 A0 41
 C7 41 73 41 C6 28 C6 28 C7 41 C2 41 D3 11 C3 35
 43 C6 54 21 C4 2A 73 54 C6 04 C9 44 A0 41 A0 44
 63 C0 41 6E CC 41 C3 06 61 DC 54 60 60 60 D1 51
 C4 41 2A C4 43 62 C1 43 61 C0 41 C4 41 C3 41 C1
 41 C3 41 C1 41 C3 41 C4 41 C0 2A 41 C3 41 C1 41
 C3 41 C1 28 C0 41 C0 5F 21 7A 73 C9 28 70 04 C2
 51 C1 51 C5 51 C1 51 C5 51 C4 51 C0 00
  Encoded length: 301 bytes
  Wall pattern: 03, Wall color: 00     Floor pattern: 06, Floor color: 10
  Flags: 
 02 02 02 02 02 02 02 02 02 02 02 02 02 02 02 02 02 02 02 02 02 02 02 02 02 02 02 02 02 02 02 02
 04 33 00 00 00 04 00 00 00 00 00 00 00 00 33 00 04 33 00 00 00 00 00 00 00 00 04 00 00 00 00 33
 04 00 00 00 03 03 03 03 00 00 00 00 00 00 03 03 03 03 00 00 00 00 00 00 03 03 03 03 00 00 00 00
 04 00 00 03 03 00 00 03 03 00 00 00 00 03 03 00 00 03 03 00 00 00 00 03 03 00 42 03 03 00 00 00
 04 00 03 03 00 00 00 00 03 03 00 00 03 03 00 00 17 00 03 03 00 00 03 03 00 17 00 00 03 03 00 00
 04 03 03 00 00 33 00 00 00 03 03 03 03 00 00 00 00 00 00 03 03 03 03 00 00 00 00 17 00 03 03 03
 04 00 04 00 00 00 00 00 17 00 00 00 00 00 17 00 00 00 00 00 00 00 00 00 00 00 00 00 42 04 00 00
 04 00 03 03 00 00 00 17 00 00 00 00 00 00 00 00 00 00 00 00 00 00 00 00 00 00 17 00 03 03 00 00
 04 00 00 03 03 00 17 00 03 03 03 03 03 02 03 03 02 03 03 03 03 04 00 00 00 00 53 03 03 00 00 00
 04 00 00 00 04 00 00 00 04 33 00 00 00 00 00 42 00 00 00 00 33 04 00 00 00 00 00 04 00 00 00 00
 04 00 00 00 04 00 00 00 04 00 00 00 00 00 00 00 00 00 00 00 00 04 00 00 00 00 00 04 00 00 00 00
 04 00 00 03 03 00 00 00 04 00 40 00 00 00 00 00 00 00 00 40 00 04 00 00 00 00 00 03 03 00 00 00
 04 33 03 03 00 00 00 00 04 00 00 03 03 02 03 03 02 03 03 00 00 04 00 00 00 17 00 00 03 03 00 33
 04 00 04 00 00 00 00 00 04 00 00 04 53 00 00 53 00 00 04 00 00 04 00 00 00 00 00 00 53 04 00 00
 03 03 03 00 00 00 00 00 02 00 03 03 00 00 00 00 00 00 03 03 00 02 00 00 00 00 00 00 00 03 03 03
 04 33 03 03 00 17 00 00 04 00 04 53 00 00 00 00 00 00 00 04 00 04 00 17 00 00 00 00 03 03 00 33
 04 00 00 03 03 00 00 00 04 42 04 00 00 00 00 00 00 00 00 04 42 04 00 00 00 00 00 03 03 00 00 00
 04 00 00 00 04 00 00 00 02 00 03 03 00 00 00 00 00 05 03 03 00 02 00 00 00 00 00 04 00 00 00 00
 04 00 00 00 04 00 17 00 04 00 00 04 53 00 00 00 00 00 04 00 00 04 00 00 00 00 00 04 00 00 00 00
 04 00 00 03 03 00 00 00 04 00 00 03 03 02 03 03 02 03 03 00 00 04 00 00 00 00 00 03 03 00 00 00
 04 33 03 03 00 00 00 00 04 00 00 40 00 00 00 00 00 00 00 40 00 04 00 00 00 00 00 00 03 03 00 00
 04 03 03 00 00 00 00 00 04 00 00 00 00 00 00 00 00 00 00 00 00 04 00 17 00 00 00 00 53 03 03 03
 04 00 04 00 00 00 00 00 04 33 00 00 00 00 00 42 00 00 00 00 33 04 00 00 00 00 00 00 00 04 00 00
 04 00 04 00 00 00 00 00 03 03 03 03 03 02 03 03 02 03 03 03 03 03 00 00 00 00 17 00 03 03 00 00
 04 00 04 00 00 00 00 00 00 00 00 00 00 17 00 00 00 00 00 00 00 00 00 00 00 00 00 03 03 00 00 00
 04 06 04 00 17 00 00 00 00 00 00 00 00 00 00 00 00 00 00 00 00 00 00 00 00 00 00 04 00 00 00 00
 04 00 04 00 17 00 17 00 17 00 00 00 00 00 00 00 00 00 00 00 00 00 00 00 00 00 00 04 00 00 00 00
 04 03 03 42 00 00 00 00 00 03 03 03 03 00 00 00 17 00 00 03 03 03 03 00 00 17 00 03 03 00 00 00
 04 00 03 03 00 00 00 00 03 03 00 00 03 03 00 00 00 00 03 03 00 00 03 03 00 00 00 00 03 03 00 00
 04 00 00 03 03 00 42 03 03 00 00 00 00 03 03 00 00 03 03 00 00 00 00 03 03 00 00 40 00 03 03 00
 04 33 00 00 04 00 00 04 00 00 00 00 00 33 04 00 00 04 33 00 00 00 00 00 04 00 00 00 00 40 04 33
 04 00 00 00 04 00 00 04 00 00 00 00 00 00 04 00 00 04 00 00 00 00 00 00 04 00 00 00 00 00 04 00
 02 02 02 02 02 02 02 02 02 02 02 02 02 02 02 02 02 02 02 02 02 02 02 02 02 02 02 02 02 02 02 02
