Gauntlet (rev 1 - 9)
Maze number: 94
Offset for maze 93: 232632 - 0x038cb8
big endian buf: [%!l(uint8=0) %!l(uint8=3) %!l(uint8=140) %!l(uint8=184)]
G:1 Maze real addr: 257211 - 0x03ECBB, bank 3, boff: 0x6000
Maze read from: 0x03ecbb - 257211
compresssed: 269
 00 01 00 02 00 33 12 68 61 0B 9E 22 80 C4 2C A0
 E4 06 C0 2A 39 80 21 0E 1E 0E 27 17 80 E7 C1 2B
 A0 C2 0E 71 A0 C2 11 39 28 39 28 38 28 39 C1 0B
 E2 E1 28 A0 E3 0E E2 41 80 39 28 39 28 39 28 39
 51 1B 42 C1 1B E4 E5 C2 3A C5 39 18 C2 A1 52 0B
 E3 2C C6 A5 C4 39 53 C1 18 43 E2 1A CA 1B A0 C4
 39 2A A2 C0 A4 E1 1A 41 C5 51 E1 E4 C5 74 A8 CF
 B5 4C 66 48 D3 B2 E9 F4 C4 3B E2 71 28 D0 21 A0
 C3 A3 C0 A1 B6 A5 28 44 E5 C3 3B D1 B6 A2 EB 21
 E4 60 B2 C7 13 A0 C6 BF C2 A2 03 81 A0 C0 A1 EA
 C6 05 E4 E2 26 44 C1 27 E3 EC C1 17 A0 26 A7 E4
 42 E8 C1 17 A0 26 E6 E4 41 CC 0E A0 E7 E4 40 E5
 E5 E4 28 E2 C0 1B E2 28 E6 C0 1A E1 E4 35 A0 E3
 E4 C6 1A A3 E4 C0 2C E0 E3 EB E8 E3 E3 60 C3 35
 E2 28 C4 A3 74 A0 EE C6 2B F7 D2 B2 C5 BC A0 11
 C2 A3 CC 2B A0 10 66 A0 11 CE A4 C9 18 A0 D7 28
 BE 35 C2 35 A0 C8 B6 21 C0 27 49 2B 00
  Encoded length: 269 bytes
  Wall pattern: 03, Wall color: 02     Floor pattern: 03, Floor color: 01
  Flags: 
 02 02 02 02 02 02 02 02 02 02 02 02 02 02 02 02 02 02 02 02 02 02 02 02 02 02 02 02 02 02 02 02 02
 02 34 00 00 00 00 00 44 02 00 00 00 00 00 02 06 00 42 57 57 33 14 30 14 39 23 23 00 00 00 00 00 02
 02 00 00 02 00 00 43 02 00 00 00 14 30 00 00 02 00 00 00 17 57 40 57 40 56 40 57 00 11 11 11 00 02
 02 02 00 11 02 40 02 00 00 00 00 02 14 00 00 00 02 00 00 40 40 57 40 57 40 57 40 57 11 27 11 00 02
 02 40 00 11 27 02 00 00 00 00 02 00 00 00 00 00 00 02 00 00 00 58 00 00 00 00 00 00 57 24 11 00 02
 02 02 02 11 11 02 00 00 00 02 44 00 00 00 00 00 00 00 02 02 02 02 02 02 00 00 00 00 00 57 11 00 02
 02 24 00 00 00 02 40 00 00 00 02 26 00 00 00 00 00 00 00 00 00 00 11 27 02 00 00 00 00 00 57 42 02
 02 02 02 00 02 02 02 02 02 00 00 02 26 00 00 40 00 00 00 00 00 00 11 00 00 02 00 00 00 00 00 02 02
 02 00 00 00 00 02 30 00 02 00 00 00 02 02 02 02 02 02 02 02 02 00 00 00 00 00 02 00 00 00 00 00 02
 02 00 00 00 00 02 00 00 02 00 00 00 00 00 00 00 00 00 00 40 02 00 00 00 00 00 02 33 00 00 00 00 02
 02 00 00 00 00 40 00 00 02 00 00 00 00 00 00 00 00 00 00 00 02 00 00 00 00 00 02 00 00 00 00 00 02
 02 00 00 00 00 02 00 00 02 00 00 00 00 00 00 00 00 00 00 00 02 00 00 00 00 00 00 02 00 00 00 00 02
 02 59 00 00 00 02 30 00 02 40 00 00 00 00 00 00 00 00 00 00 02 00 00 00 00 00 00 33 02 00 00 00 02
 02 02 02 02 02 00 02 02 02 02 02 02 02 02 02 40 00 00 00 00 02 40 00 00 00 00 00 00 02 00 00 00 02
 02 59 00 00 00 00 00 00 00 00 00 00 00 00 02 00 00 00 00 00 02 02 02 02 00 00 00 00 00 00 00 00 02
 02 00 00 00 02 33 00 00 00 00 00 02 00 33 02 00 00 00 00 00 00 00 00 19 02 00 00 00 00 00 00 00 02
 02 00 00 02 02 02 02 03 03 03 02 00 02 02 00 00 00 00 00 00 00 00 00 00 00 02 00 00 00 00 00 00 02
 02 05 00 02 00 00 00 02 00 00 00 02 38 00 00 00 00 00 40 00 00 39 00 00 00 00 02 00 00 00 00 00 02
 02 00 00 02 00 00 00 00 02 00 00 23 02 38 02 02 02 02 02 02 02 02 00 00 00 00 00 02 00 00 00 40 02
 02 00 00 02 00 00 00 00 00 02 00 00 23 02 38 00 00 00 00 00 00 00 02 00 00 00 00 00 02 00 00 40 02
 02 00 00 02 00 00 00 00 00 00 00 00 00 14 02 00 00 00 00 00 00 00 00 02 00 00 00 00 00 02 00 40 02
 02 00 00 02 00 00 02 00 00 00 00 00 00 02 00 00 00 00 00 02 40 00 00 00 02 00 27 00 00 00 02 40 02
 02 00 00 02 00 00 00 02 00 26 00 00 02 00 00 00 00 00 02 53 02 00 00 00 00 02 00 00 00 00 00 02 02
 02 00 00 02 00 00 00 26 02 02 02 02 00 00 00 00 00 02 00 44 00 02 00 00 00 00 02 00 00 00 00 00 02
 02 00 00 02 00 00 00 02 00 00 00 00 00 00 00 00 00 02 00 00 00 00 02 00 00 00 00 02 00 33 00 00 02
 02 00 53 02 00 00 02 40 00 00 00 00 00 02 02 02 02 30 00 00 00 00 00 02 00 00 00 00 02 00 00 00 02
 02 00 00 02 00 00 00 02 00 00 00 00 00 00 00 43 02 00 00 00 00 00 00 00 00 00 00 00 02 00 00 00 02
 02 00 00 02 00 00 00 00 02 00 00 00 00 00 00 00 02 00 00 00 00 00 00 00 00 00 00 00 02 00 00 00 02
 02 00 00 02 02 17 00 00 00 02 02 02 02 00 00 00 02 00 00 00 00 00 00 00 00 00 43 02 16 00 00 00 02
 02 00 00 00 33 02 17 00 00 00 00 00 00 00 00 00 02 00 00 00 00 00 02 02 02 02 02 00 00 00 00 00 02
 02 00 00 00 00 24 02 00 00 00 00 00 00 00 00 00 02 00 00 00 00 00 00 00 00 00 00 00 00 00 00 40 02
 02 53 00 00 00 53 02 00 00 00 00 00 00 00 00 00 02 33 00 39 00 00 00 00 00 00 00 00 00 00 40 43 02
 02 02 02 02 02 02 02 02 02 02 02 02 02 02 02 02 02 02 02 02 02 02 02 02 02 02 02 02 02 02 02 02 02
