Gauntlet (rev 1 - 9)
Maze number: 103
Offset for maze 102: 233558 - 0x039056
big endian buf: [%!l(uint8=0) %!l(uint8=3) %!l(uint8=144) %!l(uint8=86)]
G:1 Maze real addr: 249945 - 0x03D059, bank 2, boff: 0x4000
Maze read from: 0x03d059 - 249945
compresssed: 185
 00 00 00 00 01 71 53 5A 5B 04 68 C5 06 63 EE D4
 1B C0 2A 42 C1 A1 C1 05 62 D5 A1 FD CC 2A 68 D9
 2A C2 A4 C2 A1 4C CE A1 E3 4D C7 35 A1 E4 B2 B3
 D1 1B C1 A1 FD E5 C3 2A 40 C1 03 83 E7 BA E5 D5
 A1 E5 C2 19 67 E9 C2 19 C1 A7 4B DF E9 75 BF 67
 E3 BA E6 43 CF A1 C6 AA 42 C4 56 C0 A1 7F 0B C5
 57 35 81 A2 E6 78 0B A6 03 80 A1 E7 42 75 0B C0
 35 C5 A1 C2 19 C3 AE E0 40 C1 A1 D0 28 C3 2A C5
 A1 E7 C7 B2 E7 C1 A1 E7 41 C4 35 04 63 C4 A1 C7
 AF A2 C1 A1 D3 1A 70 C0 2A 2C 2A C0 03 A1 E7 C8
 B2 F3 61 C6 04 C3 2A 61 45 C2 AF A2 B5 F2 E7 C5
 BE 35 E5 62 E7 40 75 80 00
  Encoded length: 185 bytes
  Wall pattern: 01, Wall color: 03     Floor pattern: 07, Floor color: 05
  Flags: SHOTS_STUN 
  ╚══> while gauntlet has these elements, these flags probably do not operate
 02 02 02 02 02 02 02 02 02 02 02 02 02 02 02 02 02 02 02 02 02 02 02 02 02 02 02 02 02 02 02 02 02
 02 00 00 00 00 00 06 00 00 00 00 27 00 00 00 00 00 00 00 00 02 00 00 00 00 00 00 02 00 00 00 00 02
 02 00 00 00 00 00 00 00 00 00 00 00 00 00 00 00 00 27 00 42 02 00 00 26 00 00 02 02 00 00 05 00 02
 02 00 27 00 00 00 00 00 00 00 00 00 00 00 00 00 00 00 00 00 02 00 00 00 00 02 02 00 00 00 00 00 02
 02 00 00 00 00 00 00 00 00 00 00 00 00 00 00 00 00 00 00 00 02 00 00 00 00 02 00 00 00 00 00 00 02
 02 00 00 00 00 00 00 42 00 00 00 00 00 00 00 00 00 27 00 00 02 00 00 00 00 00 00 00 00 00 00 02 02
 02 00 00 00 00 00 00 00 00 00 00 00 42 00 00 02 02 02 02 02 02 00 00 00 02 02 00 00 00 00 02 02 02
 02 00 00 00 00 00 00 26 00 00 00 00 00 00 00 02 00 00 00 00 02 00 00 02 02 00 00 00 00 02 02 02 02
 02 00 00 00 00 00 00 00 00 00 00 00 26 00 00 02 00 00 00 00 02 53 02 02 00 00 00 00 00 02 02 02 02
 02 00 00 00 00 00 00 00 00 00 00 00 00 00 00 02 00 00 27 00 02 02 02 00 00 00 00 00 00 00 00 00 02
 02 00 00 00 00 00 00 00 00 00 00 00 00 00 00 02 00 00 00 00 02 02 00 00 00 00 00 00 02 00 00 00 02
 02 42 00 26 00 00 03 03 03 03 03 00 00 00 00 02 00 00 00 02 02 00 00 00 00 00 00 02 00 00 00 00 02
 02 00 00 00 00 00 04 00 00 00 04 00 00 00 00 02 00 00 02 02 00 00 00 00 00 00 02 00 00 00 25 00 02
 02 00 00 00 00 00 04 27 00 00 04 00 00 00 00 02 00 00 02 00 00 00 25 00 00 02 02 02 02 02 02 02 02
 02 00 00 00 00 00 04 00 00 00 04 00 00 26 00 02 00 00 00 00 00 00 00 00 00 00 00 00 00 00 00 00 02
 02 00 00 00 00 00 04 00 00 00 04 00 00 00 00 02 00 00 00 00 00 00 00 00 02 00 00 00 00 00 00 40 02
 02 00 00 00 00 00 04 00 00 27 04 00 00 00 02 02 00 00 00 00 00 00 00 02 00 00 00 00 26 00 00 00 02
 02 00 00 00 00 00 04 00 00 00 04 00 00 02 02 00 00 00 00 00 00 00 02 02 02 02 02 02 02 02 02 02 02
 02 00 00 00 26 00 04 00 00 00 04 00 02 02 00 00 00 00 00 00 00 00 00 00 00 00 00 00 00 00 40 11 02
 02 00 00 00 00 00 04 53 53 53 02 02 02 00 00 00 00 00 00 00 02 00 00 00 00 00 00 00 00 00 40 11 02
 02 02 02 02 02 02 02 03 03 02 02 00 00 00 00 00 00 00 00 02 00 00 00 26 00 00 00 00 00 00 40 11 02
 02 53 00 00 00 00 00 00 02 02 00 00 00 25 00 00 00 00 02 02 02 02 02 02 02 02 02 02 02 02 02 02 02
 02 00 02 00 26 00 00 02 02 00 00 00 00 00 00 00 00 00 00 00 00 00 00 00 00 02 40 00 00 00 00 42 02
 02 00 00 00 00 00 02 02 00 00 00 00 00 00 00 00 02 00 00 00 00 00 00 00 00 02 00 00 00 00 00 00 02
 02 00 02 00 00 02 02 00 00 00 00 00 00 00 00 02 00 00 26 00 00 00 00 00 53 04 00 00 02 00 27 00 02
 02 00 00 00 02 02 00 00 00 00 00 00 00 00 02 02 02 02 02 02 02 02 02 02 02 02 02 02 02 02 02 02 02
 02 00 00 02 02 00 00 00 00 00 00 00 00 00 00 00 00 00 00 00 00 00 02 00 00 26 00 40 02 42 44 42 02
 02 03 02 02 00 00 00 00 00 00 00 00 02 00 00 00 00 00 00 00 00 00 02 00 00 00 00 00 02 00 00 00 02
 02 00 00 00 00 00 00 00 00 00 00 02 00 00 27 00 00 00 00 00 00 00 04 00 00 00 00 42 02 00 27 00 02
 02 00 00 00 00 26 00 00 00 02 02 02 02 02 02 02 02 02 02 02 02 02 02 02 02 02 02 02 02 00 00 00 02
 02 00 00 00 00 00 00 00 00 00 00 00 00 00 00 00 02 00 00 00 00 00 00 00 00 02 00 00 00 00 00 00 02
 02 53 00 00 00 00 00 00 02 00 00 00 27 00 00 00 00 00 00 00 00 02 00 26 00 00 00 00 00 00 40 40 02
 02 02 02 02 02 02 02 02 02 02 02 02 02 02 02 02 02 02 02 02 02 02 02 02 02 02 02 02 02 02 02 02 02
