Gauntlet (rev 1 - 9)
Maze number: 106
Offset for maze 105: 234241 - 0x039301
big endian buf: [%!l(uint8=0) %!l(uint8=3) %!l(uint8=147) %!l(uint8=1)]
G:1 Maze real addr: 250628 - 0x03D304, bank 2, boff: 0x4000
Maze read from: 0x03d304 - 250628
compresssed: 188
 00 00 00 00 00 10 57 9E 6A 0E 04 CE 35 D6 A1 4D
 4C 28 C0 52 CA A9 03 81 C4 28 A0 C0 A7 D1 52 52
 52 2A DB 28 82 DF 66 F2 E8 C0 4F DF EC C0 A2 D0
 1E 80 B2 CE 57 57 6A 0E 54 C4 53 51 51 51 51 51
 51 C3 28 81 C9 AD F2 D4 51 51 51 51 51 51 51 C2
 0E E0 C1 42 4C A0 2B A0 2B A0 C1 BF A1 E0 E0 E4
 C2 BF F0 C5 1D D0 45 0E E3 E2 C6 BF E4 E2 E5 DF
 C0 1C E1 C1 1C E9 C0 42 40 A0 E3 D0 BF EC E0 E0
 E0 E0 C9 46 4F D1 B5 A0 D2 2C C6 35 C1 0E C8 A1
 BC C0 B8 C4 B3 A9 5C 06 51 CD 54 D8 71 C3 55 49
 42 A2 B4 AD B9 AA C4 35 6E 4B 05 CD 46 2A 44 BE
 C3 72 52 52 52 52 52 C1 4F 2A 1E 00
  Encoded length: 188 bytes
  Wall pattern: 00, Wall color: 07     Floor pattern: 01, Floor color: 05
  Flags: 
 02 02 02 02 02 02 02 02 02 02 02 02 02 02 02 02 02 02 02 02 02 02 02 02 02 02 02 02 02 02 02 02 02
 02 00 00 00 00 00 00 00 14 00 00 00 00 00 00 53 02 00 00 00 00 00 00 00 00 00 00 00 00 00 00 00 02
 02 00 00 00 00 00 00 02 14 30 00 00 00 00 00 00 02 00 00 00 00 00 00 00 30 00 00 00 00 00 00 00 02
 02 00 00 14 14 14 40 00 14 00 00 00 00 00 00 00 02 00 00 02 02 02 02 02 02 02 02 02 02 02 03 03 02
 02 00 00 14 14 14 40 02 00 02 02 02 02 02 02 02 02 00 00 02 14 14 00 00 00 00 00 00 00 00 00 00 02
 02 00 00 14 14 14 42 00 00 00 00 00 00 00 00 00 02 00 00 02 14 14 00 00 00 00 00 00 00 00 00 00 02
 02 00 00 40 40 40 40 00 00 00 00 00 00 00 00 00 02 00 00 02 14 14 02 00 00 00 00 00 00 00 00 00 02
 02 00 00 00 00 00 00 00 00 00 00 00 00 00 42 00 02 00 00 02 14 14 02 00 00 00 00 00 00 00 00 00 02
 02 00 02 14 00 00 00 00 00 00 00 00 02 00 30 00 02 00 00 02 14 14 02 00 00 00 00 00 00 00 00 00 02
 02 00 00 14 02 00 00 00 00 14 00 00 00 00 00 00 02 00 00 02 14 14 02 00 00 00 00 00 00 00 00 00 02
 02 00 00 14 02 00 00 00 00 14 00 00 02 00 02 02 02 00 00 02 14 14 02 00 00 00 00 00 00 00 00 00 02
 02 00 30 14 02 00 00 00 00 14 14 14 14 14 14 14 02 00 00 02 14 14 02 00 00 00 00 00 00 00 00 00 02
 02 42 14 14 00 00 00 00 00 14 14 14 14 14 14 14 02 00 00 02 40 40 02 00 00 00 00 00 00 00 00 00 02
 02 02 02 02 02 02 02 02 02 02 02 02 02 02 02 00 02 00 00 02 00 00 02 00 14 14 14 14 14 14 14 00 02
 02 14 02 00 00 00 00 00 00 00 00 00 00 00 02 00 02 00 00 02 00 00 02 00 14 14 14 14 14 14 14 00 02
 02 14 14 00 02 00 00 30 00 00 00 30 00 00 02 00 02 00 00 02 00 00 02 00 00 02 43 02 43 02 00 00 02
 02 14 02 00 02 00 02 00 00 00 00 00 02 00 02 00 02 00 00 02 00 00 02 00 00 00 00 00 00 00 00 00 02
 02 14 02 00 00 00 00 00 00 29 00 00 00 00 02 00 02 00 00 02 00 00 02 00 00 00 00 30 00 00 00 00 02
 02 14 14 00 00 00 00 02 00 00 00 02 00 00 02 00 02 00 00 02 00 00 02 00 00 02 00 00 00 02 00 00 02
 02 14 02 00 02 00 00 00 00 00 00 00 00 00 02 00 02 00 00 02 00 00 02 00 00 00 00 00 00 00 00 00 02
 02 14 02 00 00 00 28 00 00 02 00 00 28 00 02 00 02 00 00 02 00 00 02 02 00 30 00 00 00 30 00 02 02
 02 14 02 00 02 00 00 00 00 00 00 00 00 00 02 00 02 00 00 02 00 00 02 00 00 00 00 00 00 00 00 00 02
 02 14 02 00 02 00 02 00 02 00 02 00 02 00 02 00 02 14 14 02 00 00 02 30 00 00 00 00 00 00 00 30 02
 02 14 02 00 00 00 00 00 00 00 00 00 00 00 02 00 02 14 14 02 00 00 02 00 00 00 00 00 00 00 00 00 02
 02 14 02 02 02 00 00 00 00 00 00 00 00 00 02 00 02 14 14 02 00 00 02 44 00 00 00 00 00 00 00 53 02
 02 14 14 14 02 00 00 00 00 00 00 00 02 02 02 00 02 14 14 02 00 00 02 02 02 02 02 02 02 02 02 02 02
 02 14 06 14 02 00 00 00 00 00 00 00 04 00 00 00 00 14 14 02 00 00 00 00 00 00 00 00 00 00 00 00 02
 02 00 00 00 02 00 00 00 00 00 00 00 04 00 00 00 00 14 30 02 00 00 00 00 00 00 00 00 00 30 00 00 02
 02 02 02 02 02 02 02 02 02 02 02 02 02 02 02 02 02 02 02 02 02 02 02 02 02 02 02 02 02 02 02 00 02
 02 00 00 00 53 04 14 14 14 14 14 00 00 00 00 00 00 00 00 00 42 30 00 00 00 00 00 00 00 00 00 00 02
 02 00 05 00 00 04 14 14 14 14 14 00 00 00 00 00 00 30 00 00 00 00 00 00 00 42 30 00 00 00 00 00 02
 02 00 00 00 00 04 14 14 14 14 14 00 00 30 00 00 00 00 00 00 00 00 00 00 00 00 00 00 00 00 42 30 02
 02 02 02 02 02 02 02 02 02 02 02 02 02 02 02 02 02 02 02 02 02 02 02 02 02 02 02 02 02 02 02 02 02
