Gauntlet (rev 1 - 9)
Maze number: 78
Offset for maze 77: 229639 - 0x038107
big endian buf: [%!l(uint8=0) %!l(uint8=3) %!l(uint8=129) %!l(uint8=7)]
G:1 Maze real addr: 246026 - 0x03C10A, bank 2, boff: 0x4000
Maze read from: 0x03c10a - 246026
compresssed: 221
 00 00 00 00 00 20 23 68 5A 04 5D 35 80 C0 2B C7
 35 40 C0 2C C2 35 C1 2A 70 74 6A 2A C0 1F C0 1F
 C0 1F 2A C2 1B DA 1F 42 42 C7 53 D5 28 6E C6 1F
 C1 1B DE 28 CA 05 C9 B6 C6 B6 CF 19 C1 19 C8 1F
 77 C7 2B 45 51 45 73 C1 2C C3 A9 03 81 A7 42 44
 A4 28 C7 27 28 80 25 6C 60 82 70 46 C5 54 D7 2C
 4E C2 06 CA 26 C4 25 40 C2 21 62 76 6E C8 BF D2
 2A C2 BF DA 26 41 CB BD 35 1C C1 1C 40 1E B7 C2
 26 2A 26 35 C1 1B C0 21 47 60 A5 03 83 A4 B6 C0
 2A 63 61 61 42 C0 19 C7 19 D3 28 D9 1A C3 2A D0
 B5 C1 BF 40 80 6A 63 D1 1A DF 72 D5 1A 80 64 C0
 35 40 62 80 41 70 40 70 28 53 48 C1 B8 AF A4 B4
 47 70 C9 2C 26 C1 26 43 4E C6 26 44 D1 28 41 C2
 26 43 C7 BE 77 42 C3 26 C1 26 43 C4 00
  Encoded length: 221 bytes
  Wall pattern: 00, Wall color: 03     Floor pattern: 02, Floor color: 02
  Flags: 
 02 02 02 02 02 02 02 02 02 02 02 02 02 02 02 02 02 02 02 02 02 02 02 02 02 02 02 02 02 02 02 02
 02 53 00 43 04 00 00 00 00 00 00 00 53 02 40 00 44 00 00 00 53 02 00 42 02 29 00 00 00 00 00 29
 02 00 00 00 04 00 00 00 00 00 00 26 42 02 31 00 31 00 31 42 00 02 00 27 02 00 00 00 00 00 00 00
 02 00 00 00 04 00 00 00 00 00 00 00 00 02 00 00 00 00 00 31 00 02 00 40 02 00 00 40 00 00 00 00
 02 00 00 00 04 00 00 00 00 00 00 00 00 02 00 00 00 00 00 00 00 02 00 00 02 00 00 40 00 00 00 00
 02 00 00 00 02 00 00 00 00 00 00 26 00 02 00 00 00 00 00 31 00 02 27 00 02 00 00 00 00 00 00 00
 02 00 00 00 02 00 00 00 00 00 00 00 00 02 00 00 00 00 00 00 00 02 40 00 02 00 00 00 00 00 00 00
 02 00 05 00 02 00 00 00 00 00 00 00 00 02 00 00 00 00 00 00 00 02 00 00 02 00 00 02 00 00 00 00
 02 00 00 00 02 00 25 00 00 25 00 00 00 04 00 00 00 00 00 31 00 04 00 00 02 00 00 02 29 00 00 00
 02 00 00 00 02 43 00 00 00 00 00 00 40 04 00 00 00 00 00 00 40 04 00 00 02 29 00 02 44 00 00 00
 02 02 02 02 02 02 02 02 02 02 02 03 03 03 02 02 02 02 02 02 02 04 00 00 02 40 00 02 00 00 00 40
 02 02 02 02 02 40 00 00 00 00 00 00 00 02 39 40 40 37 00 00 00 04 00 00 02 00 00 02 00 00 00 26
 02 26 26 26 02 00 29 00 00 00 00 00 00 02 40 00 00 00 00 00 00 04 00 00 02 00 00 02 00 00 00 00
 02 00 00 00 02 00 00 00 00 00 00 00 00 02 44 00 00 00 00 00 00 02 00 00 02 00 00 02 00 00 40 00
 02 00 06 00 02 00 00 00 00 00 00 00 00 02 38 00 00 00 00 00 37 02 40 00 02 00 33 02 00 00 26 00
 02 00 00 00 02 00 29 00 00 00 00 00 00 02 00 00 00 00 00 00 00 02 26 00 02 00 00 02 00 00 00 00
 02 00 00 00 02 00 00 00 00 00 00 00 00 02 00 00 00 00 00 00 42 02 00 00 02 00 00 02 00 00 00 00
 02 00 00 00 02 00 00 00 00 00 00 00 00 02 00 00 00 00 00 00 38 02 00 40 02 00 00 02 00 00 00 00
 02 00 00 00 02 53 28 00 00 28 00 40 30 02 00 00 00 38 42 38 53 02 00 27 02 33 00 02 00 00 00 00
 02 00 40 00 26 02 02 02 02 02 02 03 03 03 03 03 02 02 02 02 02 02 00 42 02 00 00 02 26 00 00 26
 02 00 26 00 00 02 40 00 25 00 00 00 00 00 00 00 00 25 00 00 00 00 00 00 02 00 00 02 00 00 00 00
 02 00 00 00 00 02 40 00 00 00 00 00 00 00 00 00 00 00 00 00 00 00 00 00 02 00 00 02 00 00 00 00
 02 26 00 00 00 02 42 00 00 00 00 00 00 00 00 00 00 00 00 00 00 00 00 00 02 00 00 02 00 40 40 00
 02 00 00 00 00 02 00 00 00 00 26 00 00 00 00 26 00 00 00 00 00 00 00 00 04 00 00 02 00 00 00 00
 02 00 26 00 00 02 00 00 00 00 00 00 00 00 00 00 00 00 00 00 00 00 00 00 04 00 00 02 00 00 00 00
 02 00 00 00 00 02 29 00 00 00 00 00 00 00 00 00 00 00 00 00 00 00 00 00 04 00 00 02 00 26 26 00
 02 00 00 00 26 02 53 00 40 00 00 00 26 26 00 00 40 00 29 00 40 00 29 40 04 00 00 02 00 00 00 00
 02 00 40 00 00 02 02 02 02 02 02 02 02 02 02 02 02 02 02 02 02 02 02 02 02 02 02 02 00 00 00 00
 02 00 00 00 40 00 29 00 00 00 00 00 00 00 00 00 00 44 38 00 00 38 00 00 00 00 40 00 00 00 00 00
 02 00 00 00 00 00 00 00 00 00 40 00 00 00 00 00 00 00 38 00 00 00 00 00 40 00 00 00 00 00 00 00
 02 00 00 00 00 00 00 00 00 00 00 40 00 00 40 00 00 00 38 00 00 00 00 40 00 00 00 00 00 00 00 00
 02 00 00 00 00 00 00 00 00 29 00 00 00 40 00 00 00 00 38 00 00 38 00 00 00 00 40 00 00 00 00 00
 02 02 02 02 02 02 02 02 02 02 02 02 02 02 02 02 02 02 02 02 02 02 02 02 02 02 02 02 02 02 02 02
