Gauntlet (rev 1 - 9)
Maze number: 42
Offset for maze 41: 231894 - 0x0389d6
big endian buf: [%!l(uint8=0) %!l(uint8=3) %!l(uint8=137) %!l(uint8=214)]
G:1 Maze real addr: 240089 - 0x03A9D9, bank 1, boff: 0x2000
Maze read from: 0x03a9d9 - 240089
compresssed: 170
 04 06 07 1A 00 50 5D 28 62 04 1B DF C4 03 94 C9
 2A C1 2A C0 2A C0 2A A0 22 84 A0 C0 1B 83 C8 B2
 AF A4 B2 A0 DF D1 51 D1 A8 03 83 A9 C7 0B 87 D6
 0B 81 C0 03 81 C1 19 C1 A8 67 C2 0B 82 A4 C1 35
 67 D2 19 EA CA 42 0B DB 42 E4 C0 B4 68 CA 42 0B
 EF CA 41 56 C0 75 56 75 58 E1 D2 BF A5 03 81 A2
 C2 05 64 CE A4 35 C7 35 D1 06 6D 66 CB 35 C7 35
 C6 BF C6 A5 B4 A9 BB A0 DF D0 22 64 65 C1 BF EB
 F1 CB AF A3 DF DF 6E 64 65 CC B8 AF A7 B8 DF C3
 A3 C0 A4 C0 A3 E0 C0 A2 C0 A7 C0 BE 2C E3 2B 81
 E1 40 E2 41 A0 41 A0 42 C4 00
  Encoded length: 170 bytes
  Wall pattern: 00, Wall color: 13     Floor pattern: 05, Floor color: 05
  Flags: 
 02 02 02 02 02 02 02 02 02 02 02 02 02 02 02 02 02 02 02 02 02 02 02 02 02 02 02 02 02 02 02 02 02
 02 00 00 00 00 00 00 00 00 00 00 00 00 00 00 00 00 00 00 00 00 00 00 00 00 00 00 00 00 00 00 00 02
 02 00 00 00 02 03 03 03 03 03 03 03 03 03 03 03 03 03 03 03 03 03 03 03 03 03 02 00 00 00 00 00 02
 02 00 00 00 02 42 00 00 42 00 42 00 42 02 34 34 34 34 34 34 02 00 27 27 27 27 02 00 00 00 00 00 02
 02 00 00 00 02 02 02 02 02 02 02 02 02 02 02 02 02 02 02 02 02 02 02 02 02 02 02 02 02 00 00 00 02
 02 00 00 00 00 00 00 00 00 00 00 00 00 00 04 00 00 00 00 00 00 00 00 00 00 00 00 00 02 00 00 00 02
 02 00 00 00 00 00 00 00 00 00 00 00 00 00 04 00 00 00 00 00 00 00 00 00 00 00 00 00 02 00 00 00 02
 02 02 02 02 02 02 02 02 02 04 03 03 03 03 03 02 02 02 02 02 02 02 02 02 02 00 00 00 02 00 00 00 02
 02 11 11 11 11 11 11 11 11 04 00 00 00 00 00 00 00 00 00 00 00 00 00 00 02 00 00 00 02 00 00 00 02
 02 11 11 11 04 03 03 04 00 04 25 00 02 02 02 02 02 02 02 02 02 02 00 00 02 00 00 00 02 00 34 00 02
 02 00 11 11 04 11 27 04 27 04 02 00 02 53 00 00 00 00 00 00 00 02 34 00 02 00 00 00 02 00 00 00 02
 02 00 00 00 04 00 27 04 27 04 25 00 02 00 00 00 00 00 00 00 00 02 02 00 02 00 00 00 02 00 00 00 02
 02 00 40 40 04 11 27 04 27 04 00 00 02 00 00 00 00 00 00 00 00 02 00 00 02 00 00 00 02 00 00 00 02
 02 00 40 40 04 00 27 04 27 04 02 00 02 00 00 00 00 00 00 00 00 02 34 00 02 00 00 00 02 00 00 00 02
 02 00 40 40 04 11 27 04 27 04 00 00 00 00 00 00 00 00 00 00 00 02 02 00 02 00 00 00 02 00 00 00 02
 02 00 40 40 04 00 27 04 27 04 00 00 02 00 00 00 00 00 00 00 00 02 00 00 02 00 00 00 02 00 00 00 02
 02 02 02 02 02 02 02 03 03 03 02 02 02 00 00 00 05 00 00 00 00 02 34 00 02 00 00 00 02 00 00 00 02
 02 00 00 00 00 00 02 02 02 02 02 53 00 00 00 00 00 00 00 00 53 02 00 00 02 00 00 00 02 00 00 00 02
 02 00 00 00 00 00 00 06 00 00 02 00 00 00 00 00 00 00 00 00 00 02 34 00 02 00 00 00 02 00 34 00 02
 02 00 00 00 00 00 00 00 00 00 02 53 00 00 00 00 00 00 00 00 53 02 00 00 02 00 00 00 02 00 00 00 02
 02 00 00 02 02 02 02 02 02 02 02 02 02 02 02 02 02 02 02 02 02 02 02 00 02 00 00 00 02 00 00 00 02
 02 00 00 02 00 00 00 00 00 00 00 00 00 00 00 00 00 00 00 00 00 00 00 00 02 00 00 00 02 00 00 00 02
 02 00 00 02 00 00 00 00 34 00 00 00 00 00 34 00 00 00 00 00 00 34 00 00 02 00 00 00 02 00 00 00 02
 02 00 00 02 00 02 00 00 00 00 00 00 00 00 00 00 00 00 00 00 00 00 00 00 02 00 00 00 02 00 00 00 02
 02 00 00 02 00 02 02 02 02 02 02 02 02 02 02 02 02 02 02 02 02 02 02 02 02 00 00 00 02 00 00 00 02
 02 00 00 02 00 00 00 00 00 00 00 00 00 00 00 00 00 00 00 00 00 00 00 00 00 00 00 00 02 00 00 00 02
 02 00 00 02 00 00 00 00 00 00 00 00 00 00 00 00 00 00 00 00 00 00 00 00 00 00 00 00 02 00 00 00 02
 02 00 00 02 00 00 00 00 34 00 00 00 00 00 34 00 00 00 00 00 00 34 00 00 00 00 00 00 02 00 00 00 02
 02 00 00 02 02 02 02 02 02 02 02 02 02 02 02 02 02 02 02 02 02 02 02 02 02 02 02 02 02 00 00 00 02
 02 00 00 00 00 00 00 00 00 00 00 00 00 00 00 00 00 00 00 00 00 00 00 00 00 00 00 00 00 00 00 00 02
 02 02 02 02 02 00 02 02 02 02 02 00 02 02 02 02 00 02 00 02 02 02 00 02 02 02 02 02 02 02 02 00 02
 02 44 00 00 00 00 02 43 43 43 00 00 02 40 00 00 00 02 40 40 02 40 40 02 40 40 40 00 00 00 00 00 02
 02 02 02 02 02 02 02 02 02 02 02 02 02 02 02 02 02 02 02 02 02 02 02 02 02 02 02 02 02 02 02 02 02
