Gauntlet (rev 1 - 9)
Maze number: 36
Offset for maze 35: 237136 - 0x039e50
big endian buf: [%!l(uint8=0) %!l(uint8=3) %!l(uint8=158) %!l(uint8=80)]
G:1 Maze real addr: 253523 - 0x03DE53, bank 2, boff: 0x4000
Maze read from: 0x03de53 - 253523
compresssed: 246
 17 3B 0C 1F 80 10 15 0B A8 39 5D 2E 80 C2 28 A0
 71 C1 42 28 80 2B 42 71 E0 63 2C E2 C7 42 C3 41
 E3 E1 64 A0 C7 42 3A 81 42 C6 A2 C1 2B C2 1B A0
 C4 41 53 C3 41 CB A1 E1 C2 19 C1 41 38 C2 54 41
 E3 1E C2 35 C1 6F 38 E6 C1 A1 DF C6 68 05 DC 53
 C5 19 7C C4 19 C3 38 C2 53 CB 40 D1 38 2E CA 40
 CF 68 1A 80 C1 47 C7 52 C5 19 C4 4A 1A C1 1C C3
 38 CB 45 39 84 38 80 39 84 C2 53 39 80 38 39 82
 38 80 39 82 BF 2B C2 3A D5 3A C1 28 81 C2 3A D5
 3A C1 2B C0 39 83 38 80 39 83 38 39 84 38 39 83
 38 80 39 82 44 1A D4 1B 80 48 D4 45 C8 1C D2 42
 CE 62 1D C9 40 71 C2 65 1D C9 61 1D C2 40 AF AD
 C2 63 1A C1 61 3B C0 19 CC 6F C7 3B C5 1A CE 18
 C4 AB C4 A5 3B A3 C6 3B 18 84 2B CE 18 C0 3B C5
 A7 B5 D6 3B C9 BE 06 B3 06 C1 1A C1 62 B7 61 B4
 2B 1A B2 C9 28 00
  Encoded length: 246 bytes
  Wall pattern: 00, Wall color: 05     Floor pattern: 01, Floor color: 01
  Flags: PLAYER_OFFSCREEN 
  ╚══> while gauntlet has these elements, these flags probably do not operate
 02 02 02 02 02 02 02 02 02 02 02 02 02 02 02 02 02 02 02 02 02 02 02 02 02 02 02 02 02 02 02 02 02
 02 46 00 00 00 40 02 00 00 29 00 00 11 11 57 40 40 43 57 11 11 00 00 29 00 02 40 00 00 00 00 44 02
 02 00 00 02 00 00 00 00 00 00 00 00 11 11 57 00 00 00 57 11 11 00 00 00 00 02 00 00 02 40 00 00 02
 02 00 00 02 00 00 00 00 00 00 00 00 11 11 57 58 58 58 57 11 11 00 00 00 00 00 00 00 02 02 02 00 02
 02 43 00 00 00 27 02 00 00 00 00 00 11 11 57 00 00 00 57 11 11 00 00 00 00 00 00 00 00 00 00 00 02
 02 02 02 00 00 02 00 00 00 25 00 00 11 11 56 00 00 00 57 11 11 00 00 00 00 02 30 00 00 00 53 00 02
 02 40 00 00 00 00 00 00 00 00 00 00 00 00 57 00 00 00 56 00 00 00 00 00 00 00 02 00 00 02 02 00 02
 02 00 00 00 00 00 00 00 00 00 00 00 00 00 57 00 00 00 57 00 00 00 00 00 00 00 00 00 00 00 00 00 02
 02 00 00 00 00 00 40 00 00 00 00 00 00 00 57 00 05 00 57 00 00 00 00 00 00 00 00 00 00 00 00 00 02
 02 00 00 00 00 00 00 00 00 00 00 00 00 00 57 00 00 00 57 00 00 25 00 00 00 00 00 00 00 00 00 00 02
 02 00 00 29 00 00 00 00 00 25 00 00 00 00 56 00 00 00 57 00 00 00 00 00 00 00 00 00 00 00 00 11 02
 02 00 00 00 00 00 00 00 00 00 00 00 00 00 57 00 00 00 56 46 00 00 00 00 00 00 00 00 00 00 00 11 02
 02 00 00 00 00 00 00 00 00 00 00 00 00 00 57 00 40 00 57 00 00 00 00 00 00 00 26 26 00 00 11 11 02
 02 11 11 11 11 11 00 00 00 00 00 00 00 00 57 00 00 00 57 00 00 25 00 00 00 00 00 11 11 11 11 11 02
 02 11 11 11 11 11 26 00 00 28 00 00 00 00 56 00 00 00 57 00 00 00 00 00 00 00 00 11 11 11 11 11 02
 02 57 57 57 57 57 57 56 56 57 57 57 57 57 57 00 00 00 57 57 57 56 57 57 57 57 56 56 57 57 57 57 02
 02 43 00 00 00 58 00 00 00 00 00 00 00 00 00 00 00 00 00 00 00 00 00 00 00 00 00 00 58 00 00 40 02
 02 40 00 00 00 58 00 00 00 00 00 00 00 00 00 00 00 00 00 00 00 00 00 00 00 00 00 00 58 00 00 43 02
 02 57 57 57 57 57 56 56 57 57 57 57 57 56 57 57 57 57 57 57 56 57 57 57 57 57 56 56 57 57 57 57 02
 02 11 11 11 11 26 00 00 00 00 00 00 00 00 00 00 00 00 00 00 00 00 00 00 00 00 00 27 27 11 11 11 02
 02 11 11 11 11 11 00 00 00 00 00 00 00 00 00 00 00 00 00 00 00 00 00 00 00 00 00 11 11 11 11 11 02
 02 00 00 00 00 00 00 00 00 00 28 00 00 00 00 00 00 00 00 00 00 00 00 00 00 00 00 00 00 00 11 11 02
 02 00 00 00 00 00 00 00 00 00 00 00 00 00 00 00 40 00 00 00 29 00 00 00 00 00 00 00 00 00 00 11 02
 02 00 29 00 00 00 40 00 00 00 00 00 00 29 00 00 00 00 00 00 00 00 00 00 40 00 00 29 00 00 00 11 02
 02 02 02 02 02 02 02 02 02 02 02 02 02 02 02 02 02 02 02 02 02 02 02 02 02 02 02 02 02 02 00 00 02
 02 40 00 00 00 00 26 00 00 40 00 00 59 02 25 00 00 00 00 00 00 00 00 00 00 00 00 00 40 02 00 00 02
 02 00 00 00 00 00 00 00 00 00 00 00 00 02 00 00 00 00 00 00 00 59 00 00 00 00 00 00 26 02 00 00 02
 02 00 00 00 00 00 00 00 00 00 00 00 24 02 00 00 00 02 02 02 02 02 02 02 02 02 02 02 02 02 00 00 02
 02 00 02 02 02 02 02 02 02 59 02 02 02 02 00 00 00 02 00 00 00 59 24 24 24 24 24 24 43 02 00 00 02
 02 00 02 00 00 00 00 00 00 00 00 00 24 02 59 00 00 02 00 00 02 02 02 02 02 02 02 02 02 02 00 00 02
 02 00 02 00 00 00 00 00 00 00 00 00 00 02 00 00 00 02 00 00 02 59 00 00 00 00 00 00 00 00 00 00 02
 02 06 02 06 00 00 26 00 00 40 00 00 00 02 40 00 00 02 43 26 02 00 00 00 00 00 00 00 00 00 00 40 02
 02 02 02 02 02 02 02 02 02 02 02 02 02 02 02 02 02 02 02 02 02 02 02 02 02 02 02 02 02 02 02 02 02
