Gauntlet (rev 1 - 9)
Maze number: 22
Offset for maze 21: 235117 - 0x03966d
big endian buf: [%!l(uint8=0) %!l(uint8=3) %!l(uint8=150) %!l(uint8=109)]
G:1 Maze real addr: 235120 - 0x039670, bank 0, boff: 0x0000
Maze read from: 0x039670 - 235120
compresssed: 383
 08 14 07 1B 00 32 0A 5B 68 17 75 74 40 A0 1B 81
 74 C1 21 80 C1 13 A0 1B 81 A0 1E 81 C1 21 A0 46
 80 A7 21 A0 35 80 C8 A6 41 A0 E7 21 A6 0B C2 21
 C7 03 A0 E1 60 A0 E1 C3 17 C1 0E 0B E5 2B C3 2B
 04 A0 2B E0 40 A0 C8 0E 0B E2 C8 04 18 A1 E0 C0
 1E 70 C1 B3 52 0E 82 0B CC 04 C0 05 C6 B2 C1 A3
 0E 0B C6 A1 0B 80 C0 06 04 C8 04 03 04 E9 C3 03
 A3 B2 C7 04 18 04 C3 03 A0 CA B9 C5 03 C1 B4 C0
 03 81 C8 21 7B C1 B4 11 80 A0 EB E1 28 B9 A8 E1
 11 80 A0 C3 58 4B 80 04 C2 12 81 71 A0 11 80 A2
 B8 11 43 60 E2 E2 C1 B2 A1 B7 E3 70 61 11 C0 17
 51 0B 81 43 A0 13 E0 C3 2B 35 28 68 BC C1 BF 0B
 71 BB A0 40 A1 21 A4 1A AA 28 C0 17 C0 0B 62 80
 A0 28 C5 1A 1B A0 E6 C4 A1 0B BF E1 60 A3 21 43
 28 E1 E7 28 40 E3 E4 C0 B3 E0 60 AA 2A C1 0B 63
 81 E2 21 E1 1B A0 C0 11 80 A0 C0 04 C1 04 18 40
 A0 C1 B2 C2 A1 B3 C3 A2 E0 C0 11 A0 C2 04 70 04
 03 E1 C1 04 CE 11 A0 C0 A4 43 E2 35 B5 A4 B3 A7
 45 A1 E1 C1 A1 E1 43 E2 61 72 A0 E0 40 A0 C1 2A
 65 42 A0 1B E4 E2 E0 1B E0 C7 A5 03 A8 E0 E1 2C
 A0 11 A0 E8 C0 13 E5 E3 E1 2D A0 E0 43 C1 B2 E0
 E0 C0 B2 C1 20 71 E6 E7 E6 20 A1 1E A5 E2 C0 A6
 C4 A1 E0 E0 C0 B2 A0 2B C2 0C 80 A0 E3 C4 BB C1
 BE 28 A0 28 CA 0C 81 18 A0 E5 1E C0 04 C1 00
  Encoded length: 383 bytes
  Wall pattern: 02, Wall color: 10     Floor pattern: 03, Floor color: 00
  Flags: 
 02 02 02 02 02 02 02 02 02 02 02 02 02 02 02 02 02 02 02 02 02 02 02 02 02 02 02 02 02 02 02 02 02
 02 00 00 00 00 53 00 27 02 27 27 02 00 00 00 00 00 53 00 00 33 33 00 00 19 02 27 27 27 02 30 30 02
 02 00 00 33 02 00 00 00 00 00 00 02 27 27 02 02 02 02 02 02 02 02 33 02 53 53 00 00 00 00 00 00 02
 02 00 02 02 02 02 02 02 02 02 00 02 27 02 00 00 00 00 00 00 00 00 02 33 02 02 02 02 02 02 02 11 02
 02 00 02 33 00 00 00 00 02 00 00 02 03 02 00 00 02 00 40 02 00 00 02 00 00 02 23 23 23 02 14 11 02
 02 00 02 00 00 02 02 43 02 00 00 02 43 04 02 43 00 02 00 27 02 00 00 02 00 02 23 02 23 02 14 11 02
 02 00 02 02 00 02 00 00 02 00 00 02 00 04 24 02 02 00 02 00 30 02 53 02 00 02 23 02 23 02 14 11 02
 02 00 02 00 00 02 00 00 02 00 00 02 00 04 02 05 00 02 00 02 00 02 00 02 00 00 02 02 23 02 14 11 02
 02 00 02 00 00 02 00 02 02 11 11 02 06 04 02 00 00 02 00 02 00 02 00 04 03 04 00 02 23 02 00 00 02
 02 00 02 00 02 02 00 00 02 03 02 02 02 02 02 00 00 02 00 02 00 02 00 04 24 04 00 02 23 02 03 02 02
 02 00 02 00 00 02 00 00 02 00 00 02 00 00 00 00 00 02 03 02 00 02 00 03 03 03 00 02 23 02 00 00 02
 02 00 02 33 00 02 00 00 02 00 00 00 00 00 00 00 53 02 00 02 17 17 02 00 00 00 00 02 23 02 00 00 02
 02 00 02 02 00 02 02 40 02 02 02 02 02 02 02 02 02 02 00 00 02 17 17 02 00 00 00 02 23 02 00 00 02
 02 00 02 00 00 02 00 00 00 27 27 04 00 00 02 18 18 02 00 00 53 02 17 17 02 02 02 02 17 02 00 23 02
 02 27 02 40 00 02 00 02 00 00 00 02 00 00 02 02 02 02 00 00 00 00 02 00 53 00 00 40 17 02 23 23 02
 02 11 02 00 00 02 00 27 02 19 00 02 00 00 00 00 43 53 40 00 00 00 00 00 00 00 00 00 40 02 00 00 02
 02 11 02 00 53 02 02 00 27 02 02 33 02 02 02 02 02 26 02 02 02 02 02 02 02 02 02 02 02 40 00 23 02
 02 11 02 00 00 40 40 02 40 00 00 00 00 00 02 26 27 02 00 00 00 00 00 00 00 02 00 00 00 00 00 02 02
 02 11 02 00 02 02 00 40 02 02 02 02 33 00 02 00 00 27 40 00 00 02 00 00 00 00 00 00 00 00 02 40 02
 02 27 02 00 02 00 02 00 02 00 00 00 02 00 02 00 02 00 40 02 02 02 02 02 02 02 02 02 02 02 42 00 02
 02 11 02 00 02 00 40 40 02 00 02 00 02 33 00 00 02 27 02 00 17 17 02 00 04 00 00 04 24 02 27 02 02
 02 00 02 00 02 00 02 02 02 00 02 00 00 02 02 02 00 02 00 17 02 00 00 00 04 00 53 04 03 02 00 02 02
 02 00 04 00 02 00 00 00 00 00 02 00 00 00 00 00 00 00 17 02 00 02 02 02 02 02 00 00 00 02 27 00 02
 02 00 02 53 02 02 02 02 02 02 02 02 02 02 02 02 02 02 02 00 00 00 00 00 00 27 02 02 00 02 02 00 02
 02 02 02 00 00 02 00 00 00 00 27 00 00 00 02 00 00 40 00 00 00 53 02 00 02 00 27 02 00 02 42 00 02
 02 00 00 00 00 40 00 00 00 27 02 27 00 00 00 00 00 02 00 00 00 02 00 02 27 00 02 00 00 02 00 00 02
 02 00 02 02 02 02 02 02 02 03 02 02 02 02 02 02 02 02 02 00 02 00 00 02 44 02 17 02 00 02 00 00 02
 02 00 02 00 00 02 00 19 02 00 00 00 00 00 02 00 00 00 00 02 00 00 02 45 02 00 02 00 00 02 00 27 02
 02 00 02 00 02 00 02 00 02 00 02 32 00 00 53 00 00 00 00 00 00 00 02 00 00 00 00 00 00 02 00 02 02
 02 00 00 00 00 00 00 02 32 02 02 30 02 02 02 02 02 02 00 00 00 02 00 02 02 02 02 02 02 02 00 00 02
 02 00 00 02 02 00 02 00 02 00 02 02 43 00 00 00 12 12 02 00 00 00 00 02 00 00 00 00 00 02 00 00 02
 02 40 02 40 00 00 00 00 00 00 00 00 00 00 00 12 12 12 24 02 00 00 00 00 00 00 02 30 00 04 00 00 02
 02 02 02 02 02 02 02 02 02 02 02 02 02 02 02 02 02 02 02 02 02 02 02 02 02 02 02 02 02 02 02 02 02
