Gauntlet (rev 1 - 9)
Maze number: 59
Offset for maze 58: 234547 - 0x039433
big endian buf: [%!l(uint8=0) %!l(uint8=3) %!l(uint8=148) %!l(uint8=51)]
G:1 Maze real addr: 242742 - 0x03B436, bank 1, boff: 0x2000
Maze read from: 0x03b436 - 242742
compresssed: 201
 00 00 00 00 00 11 00 0E 68 6A 9A 48 D5 28 48 E1
 74 1E A0 E5 1B C4 41 18 2A C3 25 60 A0 2C E3 28
 CC 42 E8 E2 E4 C8 42 E9 E0 E9 C4 42 EA CB 1C C3
 42 D5 2A C5 42 C4 20 A1 C2 05 E7 D1 28 A0 E3 C5
 72 A0 EF E1 E7 CE 19 B9 C2 A1 C3 B9 E0 CF A2 69
 CE A2 E4 E4 C6 A2 28 57 A0 E4 E2 E2 C5 26 A0 C7
 1C A0 50 C2 1E A2 21 CD BF C3 A1 E5 EC E8 28 C3
 A1 E9 CC 1A A0 E2 53 C6 1E C0 B4 E2 C4 B6 E2 69
 B7 64 A2 1F E9 E3 C4 1C A0 D2 20 E3 65 A0 E7 C3
 A1 C7 06 A0 E6 E1 E7 E1 E7 1D E6 1F E7 E3 E7 E3
 E2 F5 E8 E2 E4 C4 B5 E5 E8 E8 21 C0 1B A0 E6 72
 B2 E4 C8 A2 E8 E3 56 D0 21 A0 B9 E2 21 FE E3 C2
 BE 28 C9 BB 28 E9 62 C2 00
  Encoded length: 201 bytes
  Wall pattern: 01, Wall color: 00     Floor pattern: 01, Floor color: 00
  Flags: 
 02 02 02 02 02 02 02 02 02 02 02 02 02 02 02 02 02 02 02 02 02 02 02 02 02 02 02 02 02 02 02 02 02
 02 14 14 14 14 14 14 14 14 00 00 00 00 00 00 00 00 00 00 00 00 00 00 00 00 00 00 00 00 00 00 40 02
 02 14 14 14 14 14 14 14 14 00 02 02 26 00 00 00 00 00 30 02 02 00 00 00 00 00 02 27 00 00 00 00 02
 02 14 14 24 42 00 00 00 00 37 02 40 02 44 00 00 00 00 02 40 02 00 00 00 00 00 00 00 00 00 00 00 02
 02 14 14 14 00 00 00 00 00 00 02 00 00 02 00 00 00 02 00 00 02 00 00 02 00 00 00 00 00 00 00 00 02
 02 14 14 14 00 00 00 00 00 00 02 00 00 00 02 00 02 00 00 00 02 00 00 00 00 00 00 02 00 00 00 00 02
 02 14 14 14 00 00 00 00 00 00 02 00 00 00 00 02 00 00 00 00 02 00 00 00 00 00 00 00 28 00 00 00 02
 02 14 14 14 00 00 00 00 00 00 02 00 00 00 00 00 00 00 00 00 02 00 00 00 00 00 42 00 00 00 00 00 02
 02 14 14 14 00 00 00 00 00 32 02 02 00 00 00 05 00 00 00 00 02 00 00 00 02 00 00 00 00 00 00 00 02
 02 00 00 00 00 00 00 00 00 00 02 40 02 00 00 00 00 02 00 00 02 00 00 00 26 00 00 00 02 00 00 00 02
 02 00 00 00 00 00 00 00 00 00 02 00 00 02 00 00 02 00 00 00 02 00 00 00 00 02 00 00 00 00 00 00 02
 02 00 00 00 00 00 00 00 00 25 02 00 00 00 02 02 00 00 00 00 02 00 02 00 00 00 00 00 00 00 00 00 02
 02 00 00 00 00 00 00 02 02 02 00 00 00 00 00 00 00 00 00 02 40 00 00 00 00 00 00 00 00 00 00 00 02
 02 00 00 02 02 02 02 00 00 00 00 00 02 00 00 00 00 00 02 02 00 00 00 00 00 00 02 02 02 40 00 00 02
 02 00 00 02 00 00 42 02 00 00 00 00 00 02 00 00 00 02 00 02 00 02 00 00 00 02 00 00 38 02 00 00 02
 02 00 00 02 00 00 28 02 00 42 00 00 00 30 02 02 02 33 00 02 00 00 00 00 00 02 00 00 00 00 00 00 02
 02 00 00 02 00 02 02 00 00 00 00 00 00 02 00 00 00 00 00 02 00 00 00 00 00 02 00 02 00 00 00 00 02
 02 00 00 02 00 02 40 00 00 00 00 02 02 00 00 00 00 00 00 02 00 00 00 02 00 02 00 00 00 00 00 00 02
 02 00 00 02 00 26 02 00 00 00 02 00 00 00 00 42 00 00 00 02 00 00 00 30 00 02 00 00 00 02 00 00 02
 02 00 00 02 00 00 00 02 00 00 00 00 00 00 00 00 00 00 40 02 00 00 00 00 00 40 02 02 02 31 00 00 02
 02 00 00 00 00 00 00 00 02 00 00 00 02 02 00 00 00 00 02 28 02 00 00 00 00 00 00 00 00 00 00 00 02
 02 00 00 00 00 00 00 00 32 02 00 00 02 02 00 00 00 00 02 00 40 02 00 00 00 00 00 00 00 00 02 00 02
 02 00 00 02 02 00 00 00 00 02 00 00 02 06 02 00 00 00 02 00 00 00 02 00 00 02 00 00 00 00 00 00 02
 02 00 02 00 00 02 00 00 00 02 00 00 02 00 02 29 00 00 02 00 00 00 00 02 31 00 00 00 00 00 00 00 02
 02 02 00 00 00 00 02 00 00 02 00 00 02 00 00 02 00 00 02 00 02 00 00 00 02 00 00 00 00 00 00 00 02
 02 00 00 00 00 00 00 00 00 02 00 00 02 00 00 02 00 00 02 00 00 02 00 00 00 02 00 00 00 02 00 00 02
 02 00 00 02 00 00 00 00 00 02 00 00 02 00 00 00 02 00 02 00 00 02 00 00 00 00 02 00 00 00 00 00 02
 02 00 00 00 02 33 00 27 02 00 00 00 02 00 00 00 02 26 02 00 00 02 00 00 00 00 00 02 00 00 00 00 02
 02 00 00 00 00 02 02 02 00 00 00 00 02 00 00 00 00 02 02 00 00 00 02 00 00 00 00 00 00 00 42 00 02
 02 00 00 00 00 00 00 00 00 00 00 00 02 00 00 00 33 02 02 00 00 00 02 33 00 00 00 00 00 00 00 00 02
 02 00 00 00 00 00 00 00 00 00 00 00 02 00 00 00 00 00 00 00 00 00 00 02 00 00 00 00 02 00 00 00 02
 02 40 00 00 00 00 00 00 00 00 00 00 02 40 00 00 00 00 00 00 00 00 00 00 02 00 00 00 40 00 00 00 02
 02 02 02 02 02 02 02 02 02 02 02 02 02 02 02 02 02 02 02 02 02 02 02 02 02 02 02 02 02 02 02 02 02
