Gauntlet (rev 1 - 9)
Maze number: 98
Offset for maze 97: 233577 - 0x039069
big endian buf: [%!l(uint8=0) %!l(uint8=3) %!l(uint8=144) %!l(uint8=105)]
G:1 Maze real addr: 258156 - 0x03F06C, bank 3, boff: 0x6000
Maze read from: 0x03f06c - 258156
compresssed: 444
 0E 23 02 01 88 34 19 B8 5A C6 5E 1B C0 38 28 A0
 1A C1 28 50 60 C1 28 72 41 1A 60 A0 28 C0 2C 50
 E0 E0 C0 40 A0 39 C0 A1 C0 39 E4 2A C3 38 3A A0
 E2 41 1D C0 2A A0 C0 1D 81 E0 C0 B2 E2 E0 E4 E5
 E2 E0 E2 60 C0 40 42 A0 C2 40 A0 70 E0 E1 1D A0
 C0 1D E0 06 A0 E4 E4 28 A0 E2 E0 1B E2 E4 E4 2A
 A0 70 E2 06 C0 1C E1 62 A0 C0 42 A0 E0 E2 E2 C2
 40 A0 C1 28 A0 C0 41 42 A0 C0 42 A0 E0 E4 E0 E2
 E0 70 C0 A1 C1 1D E1 E4 1A 61 61 A0 C2 1D E0 E5
 C1 1D A0 E0 C0 19 C0 40 A0 E4 C0 42 A0 E0 C2 41
 A0 C0 42 A0 E0 C0 1C E0 E2 C0 1C E0 E0 70 C0 40
 A0 E3 E4 C4 39 C0 39 E4 2B E3 70 C1 40 A0 61 40
 A0 C3 28 39 E4 E0 E2 E0 E1 61 A0 E0 E2 E2 E0 E2
 C2 39 E0 C2 A1 E4 63 A0 C0 42 40 A0 1A E3 E5 28
 E1 E0 E4 C1 05 E1 06 E3 C0 40 1B C0 41 A0 C0 40
 1A E0 1A 80 E0 C0 42 A0 E0 C1 1B A0 E2 E0 60 E1
 C4 40 A0 E2 C0 42 A0 E0 E4 C3 40 A0 61 E1 E4 C3
 1C A0 61 E1 E0 E1 E2 E2 E0 C0 1C E0 E0 C2 40 A0
 E2 C2 38 A0 62 E0 E0 C2 40 A0 E2 E0 C2 40 A0 C4
 2B A0 E4 E4 62 E0 62 E0 62 E0 E1 E2 E0 C0 1D E0
 C0 42 A0 E0 E2 E0 E2 C3 39 E0 E2 C0 40 1A E0 C0
 42 A0 E0 C2 40 A0 61 E2 E4 E4 C2 1B E0 61 E1 06
 E4 C0 40 1D C0 38 28 A0 E2 C0 42 A0 E0 E2 E0 E3
 E2 E0 E2 1A A0 E2 E0 C2 40 A0 C1 28 A0 C0 28 A0
 62 E0 E4 E4 06 C0 1B E1 61 C1 A1 E4 28 A0 C2 40
 40 1E E0 E0 E2 28 44 1A 40 40 41 1A A0 1A A0 E2
 E0 60 C0 40 42 A0 C0 40 A0 E1 3A A0 C3 06 A0 2B
 1A 80 E1 06 70 E1 60 71 50 A0 2C 00
  Encoded length: 444 bytes
  Wall pattern: 04, Wall color: 09     Floor pattern: 03, Floor color: 01
  Flags: PLAYER_OFFSCREEN 
  ╚══> while gauntlet has these elements, these flags probably do not operate
 02 02 02 02 02 02 02 02 02 02 02 02 02 02 02 02 02 02 02 02 02 02 02 02 02 02 02 02 02 02 02 02
 27 00 56 40 02 26 00 00 40 02 06 00 26 00 02 40 00 00 00 30 56 00 00 26 00 26 02 40 00 44 02 06
 00 02 00 02 00 56 00 02 57 00 02 02 00 57 02 00 00 00 00 02 42 00 00 00 00 56 58 02 00 00 00 02
 56 00 00 29 00 42 02 00 29 29 29 00 02 00 02 00 00 00 02 00 02 00 00 00 00 00 02 00 00 00 00 00
 00 02 00 00 00 02 00 02 00 00 00 02 00 26 00 56 00 56 00 00 00 02 00 00 00 56 00 02 00 30 00 02
 00 00 02 29 02 00 29 00 02 06 02 00 00 00 00 00 02 00 00 00 00 00 02 40 02 00 00 00 02 00 02 27
 00 00 00 02 00 00 00 00 00 02 00 00 00 00 00 02 42 02 00 30 00 00 00 02 06 00 28 00 00 02 00 00
 00 26 02 00 56 00 00 00 02 00 02 00 00 00 02 00 00 00 02 00 00 00 56 00 02 00 00 40 02 00 56 00
 00 56 00 00 00 02 00 56 00 00 00 02 00 02 00 00 00 00 00 02 00 02 00 00 00 02 00 02 00 30 00 02
 02 00 00 29 00 00 02 00 00 00 00 00 02 26 00 00 26 00 00 26 02 00 00 00 29 00 02 00 00 00 00 00
 00 02 00 00 29 02 00 02 00 25 00 56 00 02 00 00 00 00 00 02 00 56 00 00 00 02 00 02 00 00 00 56
 00 00 02 00 56 00 00 00 02 00 02 00 28 00 02 00 00 00 02 00 28 00 02 00 02 00 30 00 56 00 02 00
 00 00 00 02 00 00 00 00 00 02 00 00 00 00 00 57 00 57 00 00 00 00 00 02 43 00 00 00 00 02 00 30
 00 00 56 00 02 00 00 26 56 00 02 00 00 00 00 40 57 00 00 00 00 00 02 00 02 00 00 00 02 00 02 00
 00 02 00 00 26 02 00 02 00 00 00 02 00 00 00 02 00 02 00 00 00 02 00 00 00 57 00 02 00 00 00 02
 02 00 00 00 00 00 02 00 00 00 00 26 02 00 56 00 00 00 56 00 02 26 00 00 00 00 02 00 00 00 00 00
 00 02 40 00 00 02 00 02 00 00 00 00 00 02 00 00 05 00 00 02 06 00 00 00 00 02 00 56 00 27 00 56
 00 00 02 00 56 00 26 00 02 26 26 00 02 00 56 00 00 00 02 00 02 00 00 27 02 00 00 00 02 00 02 00
 26 00 00 02 00 00 00 00 00 56 00 02 00 00 00 02 00 56 00 00 00 02 00 02 00 00 00 00 00 02 00 00
 00 00 56 00 02 00 00 26 00 00 02 00 00 00 00 00 02 00 00 00 00 28 02 00 00 26 00 00 02 00 02 00
 00 02 00 00 00 02 00 00 00 02 00 02 00 28 00 02 00 02 00 00 00 56 00 02 00 00 00 02 00 00 00 56
 02 00 00 00 26 00 02 00 02 00 00 00 56 00 02 00 00 00 02 00 02 00 00 00 56 00 02 00 00 00 00 00
 43 02 00 00 00 00 00 02 00 00 00 00 00 02 00 00 00 26 00 02 00 00 00 26 00 02 00 00 00 26 00 02
 00 00 02 00 00 00 02 00 02 00 29 00 02 00 56 00 00 00 02 00 02 00 00 00 02 00 02 00 00 00 02 00
 00 00 00 57 00 02 00 00 00 02 00 56 00 26 00 02 00 56 00 00 00 02 00 02 00 00 00 56 00 02 00 00
 26 00 00 00 02 00 00 00 00 00 02 00 00 00 00 00 02 00 00 00 27 00 02 00 00 26 00 00 02 06 00 00
 00 00 00 02 00 56 00 29 00 56 40 02 00 00 00 02 00 56 00 00 00 02 00 02 00 00 00 02 00 02 00 00
 00 00 02 00 00 00 02 00 02 00 00 00 02 26 02 00 00 00 02 00 02 00 00 00 56 00 02 00 00 40 02 00
 40 02 00 00 00 26 00 02 00 00 00 00 00 02 00 00 00 00 00 02 06 00 27 00 00 02 00 00 26 00 00 02
 02 00 00 00 00 00 02 40 02 00 00 00 56 00 56 00 30 00 02 00 02 00 00 00 02 40 56 00 00 00 00 00
 26 56 00 56 00 56 00 00 26 02 26 02 00 00 00 02 00 02 00 26 00 56 00 56 00 00 00 02 00 56 00 02
 00 00 02 58 02 00 00 00 00 06 02 43 26 26 00 00 02 06 00 30 00 00 02 00 26 00 00 30 02 06 02 44
 02 02 02 02 02 02 02 02 02 02 02 02 02 02 02 02 02 02 02 02 02 02 02 02 02 02 02 02 02 02 02 02
