Gauntlet (rev 1 - 9)
Maze number: 47
Offset for maze 46: 233101 - 0x038e8d
big endian buf: [%!l(uint8=0) %!l(uint8=3) %!l(uint8=142) %!l(uint8=141)]
G:1 Maze real addr: 241296 - 0x03AE90, bank 1, boff: 0x2000
Maze read from: 0x03ae90 - 241296
compresssed: 301
 00 00 00 00 00 51 03 03 68 04 9A C5 35 84 CA 04
 63 C1 2A C2 71 35 84 C0 19 C6 19 C0 41 C1 78 52
 35 83 52 62 C0 75 41 62 C2 46 C0 4A C4 41 C1 7F
 C4 54 C3 19 C0 41 62 C2 05 C2 51 C4 72 19 C0 41
 C5 41 D6 41 C5 41 C2 4F 41 C1 41 C3 19 C0 41 D2
 41 C1 41 C5 42 C1 2A C7 1B C4 1B 41 C1 41 67 62
 60 CB 41 C1 41 C4 19 6E C4 41 C0 1A 41 C5 4F C4
 41 C1 41 D2 35 C4 1B C0 41 C1 41 C0 42 CD 35 C7
 41 C1 42 2A BF CA 71 35 5F 61 C4 41 C2 42 C5 19
 C0 5C C4 35 04 1B 60 C1 2A C2 41 E6 C4 47 61 C0
 2C C2 1B C0 04 C2 1B D2 28 C5 41 C1 42 C1 19 C0
 44 C1 7B 41 C1 41 E1 E1 D2 41 C1 41 CD A1 C6 1B
 C0 41 C1 41 60 C1 70 A0 D1 41 70 41 EE E1 C5 41
 C1 41 60 C0 77 2A C3 19 C4 1B C0 41 C1 41 E7 E6
 E3 C2 41 C0 1A 41 60 C0 79 28 C1 35 C4 58 C0 41
 C1 41 C5 42 C0 1B E0 C1 1B C1 35 C0 A1 C1 42 C1
 41 60 C0 71 41 67 C1 35 C8 41 C5 41 60 C9 35 C0
 73 70 41 60 C0 71 41 C2 BE 28 C2 5A C0 2A C0 5C
 35 81 C2 52 C1 04 C6 04 C0 1B C0 06 00
  Encoded length: 301 bytes
  Wall pattern: 01, Wall color: 03     Floor pattern: 05, Floor color: 00
  Flags: 
 02 02 02 02 02 02 02 02 02 02 02 02 02 02 02 02 02 02 02 02 02 02 02 02 02 02 02 02 02 02 02 02 02
 02 00 00 00 00 04 53 53 53 53 53 04 00 00 00 00 04 00 00 04 00 00 00 04 00 00 00 00 40 00 00 42 02
 02 00 00 26 00 04 53 53 53 53 53 04 00 25 00 00 04 00 00 04 00 25 00 03 03 00 00 26 00 00 00 00 02
 02 00 00 00 00 04 53 53 53 53 53 04 00 00 00 40 04 26 00 04 00 00 00 00 03 03 00 00 00 40 00 00 02
 02 03 03 03 03 03 03 03 00 03 03 03 03 03 03 03 04 03 03 04 00 00 00 00 00 03 03 00 00 26 00 00 02
 02 00 00 00 00 00 00 04 00 04 00 00 00 00 00 00 04 00 00 04 00 00 00 00 25 00 03 03 00 00 00 40 02
 02 00 00 05 00 00 00 04 00 04 00 00 00 26 00 00 04 25 00 03 03 00 00 00 00 00 00 03 03 00 00 00 02
 02 00 00 00 00 00 00 00 00 04 00 00 00 00 00 00 04 00 00 00 03 03 00 00 00 00 00 00 03 03 00 00 02
 02 03 03 03 03 03 03 03 03 04 03 03 03 03 03 03 04 03 03 00 00 03 03 00 00 00 00 25 00 03 03 00 02
 02 00 00 00 00 00 00 00 00 04 00 00 00 00 00 00 04 00 03 03 00 00 03 03 00 00 00 00 00 00 03 03 02
 02 00 00 42 00 00 00 00 00 04 00 00 27 00 00 00 04 00 27 03 03 00 00 03 03 00 00 00 00 00 00 00 02
 02 40 00 00 00 40 00 40 00 04 00 00 00 00 00 00 04 00 00 00 03 03 00 00 03 03 00 00 00 00 00 25 02
 02 00 00 00 00 00 00 00 00 04 00 00 00 00 00 40 04 00 00 00 00 03 03 00 26 03 03 00 00 00 00 00 02
 02 03 03 03 03 03 03 03 03 04 03 03 03 03 03 03 04 00 00 00 00 00 03 03 00 00 03 03 00 00 00 00 02
 02 00 00 00 00 00 00 00 00 04 00 00 00 00 00 53 04 00 00 00 00 27 00 03 03 00 00 03 03 00 03 03 02
 02 00 00 00 00 00 00 00 00 04 00 00 00 00 00 53 04 00 00 00 00 00 00 00 03 03 00 00 03 03 03 42 02
 02 00 00 00 00 00 00 00 00 04 00 00 26 00 00 53 04 00 00 40 00 00 00 00 00 03 03 00 00 00 03 03 02
 02 00 00 00 00 00 00 25 00 04 00 00 00 00 00 53 04 27 00 40 00 00 42 00 00 00 03 03 00 00 00 00 02
 02 00 00 02 00 00 00 00 00 03 03 03 03 03 03 03 03 00 00 40 00 44 00 00 00 27 00 04 00 00 00 27 02
 02 00 00 00 00 00 00 00 00 04 00 00 00 00 00 00 04 00 00 40 00 00 00 00 00 00 03 03 00 00 03 03 02
 02 00 00 25 00 03 03 03 03 04 00 00 26 00 00 00 04 00 00 00 00 00 00 00 00 03 03 00 00 03 03 00 02
 02 02 00 00 02 04 00 00 00 04 00 00 00 00 00 00 04 00 00 00 00 00 00 00 03 03 00 00 03 03 00 00 02
 02 00 00 00 00 04 00 00 00 04 00 00 02 02 00 00 04 00 00 00 00 27 00 03 03 00 00 03 03 00 40 00 02
 02 26 00 02 00 04 00 00 00 04 00 00 00 00 00 00 04 00 00 00 00 00 03 03 26 00 03 03 00 00 00 00 02
 02 00 00 00 00 04 00 00 00 04 00 02 00 00 02 00 04 00 00 00 00 03 03 00 00 03 03 00 40 00 26 00 02
 02 00 00 00 00 04 00 42 00 04 00 00 25 00 00 00 04 00 27 00 03 03 00 00 03 03 00 00 00 00 00 00 02
 02 00 02 00 00 04 00 00 00 04 02 00 00 00 00 02 04 00 00 03 03 00 26 03 03 00 40 00 26 00 00 00 02
 02 00 00 00 00 04 00 40 00 04 53 00 00 00 00 00 04 00 03 03 00 00 03 03 00 00 00 00 00 00 03 03 02
 02 00 27 00 02 04 00 27 00 04 53 00 02 02 00 00 03 03 03 00 00 03 03 00 40 00 26 00 00 03 03 00 02
 02 00 00 00 00 04 00 40 00 04 53 00 00 00 00 00 04 00 00 00 03 03 00 00 00 00 00 00 03 03 00 40 02
 02 00 00 00 00 04 00 00 00 04 53 00 26 00 00 00 04 26 00 03 03 00 40 00 26 00 00 03 03 00 00 00 02
 02 40 00 00 00 04 00 42 00 04 53 53 53 00 00 00 04 00 00 04 00 00 00 00 00 00 00 04 00 27 00 06 02
 02 02 02 02 02 02 02 02 02 02 02 02 02 02 02 02 02 02 02 02 02 02 02 02 02 02 02 02 02 02 02 02 02
