Gauntlet (rev 1 - 9)
Maze number: 77
Offset for maze 76: 232202 - 0x038b0a
big endian buf: [%!l(uint8=0) %!l(uint8=3) %!l(uint8=139) %!l(uint8=10)]
G:1 Maze real addr: 256781 - 0x03EB0D, bank 3, boff: 0x6000
Maze read from: 0x03eb0d - 256781
compresssed: 427
 15 2B 01 02 00 60 B0 78 A1 39 BA 18 81 C5 2A C1
 04 C4 6B 28 C0 39 51 C7 11 04 11 C8 11 80 C1 11
 C2 2A C1 28 C0 39 81 38 39 81 38 A2 38 39 81 38
 39 81 38 39 81 38 A0 C4 39 40 65 72 72 72 72 1E
 44 C2 A1 38 A2 38 39 81 38 39 81 38 39 81 38 39
 81 75 71 A0 1E C2 74 2B C2 73 21 38 75 3A B2 40
 41 39 81 38 A2 38 39 81 38 A2 38 C7 52 40 C3 63
 78 1E C3 B5 43 C4 52 C0 A1 38 39 81 38 39 81 38
 39 81 C2 52 C9 52 3A 38 E0 1B 78 21 38 3A B2 40
 75 3A 52 40 42 C0 39 81 38 39 81 38 A1 42 C2 52
 61 11 52 3A 38 C1 2B 43 27 C4 3A 21 A0 C5 2A 44
 73 52 C1 72 39 81 38 41 C0 52 C2 52 78 B2 40 3A
 52 C1 78 38 C0 52 40 76 52 35 38 35 81 38 35 52
 35 C1 A1 C0 52 C0 51 71 38 C5 BF C0 52 40 46 C0
 53 C0 05 38 3A A0 03 A0 C0 51 C2 51 45 73 52 44
 39 80 A0 40 3A A0 03 A0 C1 03 A0 C0 B5 C0 62 71
 52 40 C0 52 C1 1B 46 E0 03 B2 40 C4 11 C1 52 40
 42 C0 52 38 A2 38 39 51 42 71 39 C4 11 52 40 E4
 1E C7 1E E5 03 44 C4 52 C0 A1 38 39 81 38 A2 38
 B2 C2 52 40 78 52 40 27 CB 27 52 40 C1 3A 54 C4
 3A 52 40 C0 39 81 38 39 81 38 39 81 38 39 81 38
 C1 72 62 52 40 E0 1B C3 2B CA 1B C1 52 45 C2 A1
 38 39 81 38 39 81 38 A2 38 39 81 38 B2 40 C8 27
 C9 78 27 C8 52 38 39 81 38 39 81 38 39 81 38 39
 81 38 39 81 38 39 51 C6 61 3A 80 CA 71 3A 80 C3
 1B A1 C2 53 39 A2 39 81 A4 39 86 A5 B6 68 6D 63
 A0 21 03 80 BE 2A CE 6B 04 06 00
  Encoded length: 427 bytes
  Wall pattern: 00, Wall color: 00     Floor pattern: 06, Floor color: 11
  Flags: 
 02 02 02 02 02 02 02 02 02 02 02 02 02 02 02 02 02 02 02 02 02 02 02 02 02 02 02 02 02 02 02 02 02
 02 24 57 00 00 00 00 00 00 42 00 00 04 00 00 00 00 00 33 00 00 00 00 00 00 00 00 00 00 00 00 40 02
 02 57 57 00 00 00 00 00 00 00 00 17 04 17 00 00 00 00 00 00 00 00 00 17 17 00 00 17 00 00 00 42 02
 02 00 40 00 57 57 57 56 57 57 57 56 02 02 02 56 57 57 57 56 57 57 57 56 57 57 57 56 02 02 00 00 02
 02 00 57 00 56 33 00 00 00 00 00 00 58 00 00 00 58 00 00 00 58 00 00 00 58 00 00 00 30 02 00 00 02
 02 00 56 00 02 00 02 02 56 02 02 02 56 57 57 57 56 57 57 57 56 57 57 57 56 57 57 57 58 02 00 00 02
 02 00 57 58 02 00 02 30 00 00 00 58 00 00 00 00 00 43 00 00 00 58 00 00 00 00 33 56 58 02 00 00 02
 02 00 57 58 02 00 56 00 57 56 57 57 57 56 02 02 02 56 57 57 57 56 02 02 02 56 00 57 00 02 00 00 02
 02 00 57 00 56 00 57 00 57 33 00 00 00 00 58 00 00 00 00 00 00 00 00 00 30 02 00 57 00 02 00 00 02
 02 00 56 00 57 00 57 00 57 00 02 02 56 57 57 57 56 57 57 57 56 57 57 57 00 02 00 57 00 57 00 00 02
 02 00 57 00 57 00 57 58 56 00 02 27 58 00 00 00 00 00 00 00 00 00 33 56 58 02 00 56 58 57 00 00 02
 02 00 57 58 57 00 56 00 57 00 56 00 57 57 57 56 57 57 57 56 02 02 00 57 00 56 00 57 00 57 33 00 02
 02 17 57 58 56 00 02 43 57 00 57 00 56 39 00 00 00 00 00 58 33 02 00 57 00 57 00 57 42 02 00 00 02
 02 00 56 58 57 00 02 00 57 00 57 58 57 00 57 57 57 57 56 57 00 56 00 57 00 57 00 57 58 02 00 00 02
 02 00 57 00 57 00 02 00 56 58 57 00 57 58 57 00 00 00 00 57 00 57 00 56 00 57 00 56 58 02 00 00 02
 02 00 57 00 57 53 56 53 57 53 56 53 57 53 57 00 02 02 00 57 00 57 58 57 00 56 00 57 00 02 00 00 02
 02 00 57 00 56 00 57 00 57 00 57 00 56 00 57 00 05 56 58 02 03 02 00 57 00 02 00 57 00 02 00 00 02
 02 00 56 58 57 00 57 00 57 00 57 00 57 00 56 57 57 02 00 56 58 02 03 02 00 02 03 02 00 02 00 33 02
 02 00 57 58 57 00 57 00 56 00 57 00 57 27 00 00 00 00 00 57 00 56 00 02 03 02 00 56 00 57 00 00 02
 02 17 57 00 57 00 56 00 57 00 56 00 57 56 02 02 02 56 57 57 00 02 00 56 58 57 00 57 00 57 00 00 02
 02 17 57 00 56 00 57 00 57 00 02 30 00 00 00 00 00 00 00 00 30 02 00 57 00 57 00 02 03 57 00 00 02
 02 00 56 00 57 00 57 00 57 00 02 02 56 57 57 57 56 02 02 02 56 02 00 57 00 57 00 56 58 57 00 00 02
 02 00 57 00 57 00 57 00 56 39 00 00 00 00 00 00 00 00 00 00 00 00 39 57 00 56 00 57 58 57 00 00 02
 02 00 57 58 57 00 56 00 57 57 57 56 57 57 57 56 57 57 57 56 57 57 57 56 00 02 58 57 00 02 33 00 02
 02 00 57 00 56 00 02 27 00 00 00 00 43 00 00 00 00 00 00 00 00 00 00 00 27 02 00 57 00 02 00 00 02
 02 00 56 00 57 00 02 02 56 57 57 57 56 57 57 57 56 02 02 02 56 57 57 57 56 02 00 56 00 02 00 00 02
 02 00 57 00 57 39 00 00 00 00 00 00 00 00 00 00 58 00 00 00 00 00 00 00 00 00 39 57 00 02 00 00 02
 02 00 57 00 57 56 57 57 57 56 57 57 57 56 57 57 57 56 57 57 57 56 57 57 57 56 57 57 00 02 00 00 02
 02 00 57 33 00 00 58 58 00 00 00 00 00 00 00 00 00 00 00 58 00 00 58 58 00 00 00 00 27 02 02 00 02
 02 00 57 57 02 02 02 57 57 57 02 02 02 02 02 57 57 57 57 57 57 57 57 02 02 02 02 02 02 02 33 00 02
 02 00 00 00 00 00 00 00 33 00 00 00 00 00 00 00 00 00 00 00 00 00 00 33 00 00 00 00 02 33 03 03 02
 02 42 00 00 00 00 00 00 00 00 00 00 00 00 00 00 00 33 00 00 00 00 00 00 00 00 00 00 00 00 04 06 02
 02 02 02 02 02 02 02 02 02 02 02 02 02 02 02 02 02 02 02 02 02 02 02 02 02 02 02 02 02 02 02 02 02
