Gauntlet (rev 1 - 9)
Maze number: 60
Offset for maze 59: 234751 - 0x0394ff
big endian buf: [%!l(uint8=0) %!l(uint8=3) %!l(uint8=148) %!l(uint8=255)]
G:1 Maze real addr: 242946 - 0x03B502, bank 1, boff: 0x2000
Maze read from: 0x03b502 - 242946
compresssed: 284
 00 00 00 00 00 20 76 0E 4B 11 68 C4 2A F5 27 C4
 1B E0 E8 E8 E7 E0 21 A0 43 E8 E2 1E E9 E1 41 A0
 C0 21 A4 21 C2 11 A0 E0 E2 E4 C1 2A E0 C1 1B A0
 11 80 C0 11 80 A0 C1 11 A0 C1 2E A2 C5 27 C0 A1
 18 1B A0 E0 E6 11 A0 C0 11 80 44 62 E1 C1 A1 E0
 2A C6 2A A0 C3 51 B2 42 62 E1 C5 A2 C2 A2 E4 C4
 A1 0B C2 52 A0 F6 1E 60 E2 E0 71 73 73 C6 A1 C3
 B5 E0 1B D1 B2 E9 E1 F1 E8 C3 B2 CC B2 E2 42 62
 80 E0 F5 41 62 80 E1 73 C3 05 73 C5 2C A0 40 C1
 BF 0B 80 E0 D3 52 2A A0 41 62 80 A0 C1 54 D1 27
 A0 E7 E1 F1 E9 1B C1 B2 CC B2 E0 C1 06 C2 18 E4
 2A A0 71 73 73 C2 1E A7 E0 E2 F0 EB C4 A2 C2 A2
 E4 C0 41 C3 40 E1 C3 A1 E8 E4 41 C3 40 E5 2A 1B
 A0 E6 1B A0 11 E3 40 C3 40 C2 52 11 A0 C2 18 C0
 11 A0 11 82 E2 51 51 51 E0 C4 40 C0 B2 27 C8 1E
 E0 E5 72 41 E5 E3 27 2C B2 C4 B2 E0 C2 A2 28 41
 C6 A3 C0 A1 C0 A4 C8 42 D6 0B 81 C2 42 E3 C6 44
 E5 0B 80 E4 C1 BE C8 44 65 81 C7 00
  Encoded length: 284 bytes
  Wall pattern: 00, Wall color: 06     Floor pattern: 02, Floor color: 07
  Flags: 
 02 02 02 02 02 02 02 02 02 02 02 02 02 02 02 02 02 02 02 02 02 02 02 02 02 02 02 02 02 02 02 02 02
 02 00 00 00 00 42 00 00 00 00 00 00 00 00 00 00 00 00 00 00 00 00 00 00 00 00 00 00 02 39 00 00 02
 02 00 00 27 00 02 00 00 00 00 00 00 00 00 00 02 00 00 00 00 00 00 00 00 00 02 00 00 00 00 00 00 02
 02 00 02 00 02 33 02 14 14 14 14 00 00 00 00 00 00 00 00 00 02 00 00 00 02 30 00 00 00 00 00 00 02
 02 00 00 00 02 00 00 02 14 14 02 00 33 02 02 02 02 02 33 00 00 00 17 02 00 02 00 00 00 02 00 00 02
 02 00 00 02 00 00 42 00 02 00 00 27 02 17 17 00 17 17 02 00 00 17 02 00 00 46 02 02 02 00 00 00 02
 02 00 02 39 00 02 02 24 27 02 00 02 00 00 00 00 00 00 00 02 17 02 00 17 17 17 02 14 14 14 00 00 02
 02 11 02 00 02 17 00 02 02 00 02 42 00 00 00 00 00 00 00 42 02 00 00 00 00 17 02 14 14 14 00 00 02
 02 11 02 00 02 17 00 00 00 00 00 02 02 02 00 00 00 02 02 02 00 00 00 00 00 02 00 00 00 00 00 02 02
 02 11 02 00 00 17 02 00 00 00 00 00 00 00 00 00 00 00 00 00 00 00 00 00 02 00 00 00 00 00 02 30 02
 02 11 02 00 00 02 00 02 00 00 40 00 00 00 00 40 00 00 00 00 40 00 00 00 02 00 00 00 02 02 00 00 02
 02 00 02 00 02 27 00 00 02 00 00 00 00 00 00 00 00 00 00 00 00 00 02 00 02 00 00 00 00 00 00 00 02
 02 00 00 02 00 00 02 00 02 00 00 00 00 00 00 00 00 00 00 00 00 00 02 00 00 02 00 00 00 00 00 00 02
 02 00 00 02 00 00 17 00 02 00 00 00 00 00 00 00 00 00 00 00 00 00 02 00 00 00 02 14 14 14 00 00 02
 02 11 11 00 02 00 17 00 00 00 00 00 00 00 00 00 00 00 00 00 00 00 00 00 00 17 00 02 14 14 00 00 02
 02 11 11 00 00 02 17 00 00 00 40 00 00 00 00 05 00 00 00 00 40 00 00 00 00 17 00 44 02 14 00 00 02
 02 11 11 00 02 00 17 00 00 00 00 00 00 00 00 00 00 00 00 00 00 00 00 00 00 17 42 02 14 14 00 00 02
 02 11 11 02 00 00 17 00 02 00 00 00 00 00 00 00 00 00 00 00 00 00 02 00 00 39 02 00 00 00 00 00 02
 02 00 00 02 00 00 02 00 02 00 00 00 00 00 00 00 00 00 00 00 00 00 02 00 00 02 00 00 00 00 00 00 02
 02 00 00 00 02 27 00 00 02 00 00 00 00 00 00 00 00 00 00 00 00 00 02 00 02 00 00 06 00 00 00 24 02
 02 00 00 00 00 02 42 02 00 00 40 00 00 00 00 40 00 00 00 00 40 00 00 00 30 02 02 02 02 02 02 02 02
 02 00 02 00 00 00 02 00 00 00 00 00 00 00 00 00 00 00 00 00 00 00 00 00 02 00 00 00 00 00 00 00 02
 02 00 00 00 00 02 00 00 00 00 00 02 02 02 00 00 00 02 02 02 00 00 00 00 00 02 00 14 14 00 00 00 02
 02 14 00 00 02 17 00 00 00 02 02 00 00 00 00 00 00 00 00 00 02 00 00 00 00 00 02 14 14 00 00 00 02
 02 14 00 02 00 17 00 00 02 42 27 02 00 00 00 00 00 00 00 02 27 02 17 17 17 17 00 02 14 00 00 00 02
 02 14 00 02 00 17 17 02 00 00 00 24 02 17 02 17 17 17 02 00 00 00 02 17 17 17 00 02 00 00 00 00 02
 02 14 00 02 39 00 00 00 00 00 00 00 02 00 30 00 02 00 02 00 00 00 00 02 00 00 00 40 14 14 00 00 02
 02 00 00 00 02 00 00 00 00 02 39 44 02 00 00 00 00 00 02 00 02 00 00 00 02 02 02 40 14 14 00 00 02
 02 00 00 00 00 02 02 02 02 00 02 02 00 02 02 02 02 02 00 00 00 00 00 00 00 00 00 14 14 14 00 00 02
 02 00 00 00 00 00 00 00 00 00 00 00 00 00 00 00 00 00 00 00 00 11 11 11 00 00 00 14 14 14 00 00 02
 02 00 02 00 00 00 00 00 00 00 14 14 14 14 14 00 00 00 00 00 00 02 11 11 00 00 00 00 00 02 00 00 02
 02 00 00 00 00 00 00 00 00 00 14 14 14 14 14 00 00 00 00 00 00 11 11 11 00 00 00 00 00 00 00 00 02
 02 02 02 02 02 02 02 02 02 02 02 02 02 02 02 02 02 02 02 02 02 02 02 02 02 02 02 02 02 02 02 02 02
