Gauntlet (rev 1 - 9)
Maze number: 53
Offset for maze 52: 229815 - 0x0381b7
big endian buf: [%!l(uint8=0) %!l(uint8=3) %!l(uint8=129) %!l(uint8=183)]
G:1 Maze real addr: 254394 - 0x03E1BA, bank 3, boff: 0x6000
Maze read from: 0x03e1ba - 254394
compresssed: 349
 17 3B 0C 1F 00 71 A3 B8 51 04 59 20 80 61 A0 D8
 35 62 A0 D2 1A C4 1B 62 A0 C1 42 A0 C4 05 E4 C1
 1A 66 A0 C1 42 A0 4A 38 A0 C1 1A C0 53 03 80 E1
 C1 42 A0 41 19 76 C1 38 A0 C9 43 41 19 C1 B5 C2
 B5 71 C1 40 03 81 35 C0 28 79 E1 42 38 A0 71 C2
 18 81 E3 E3 71 E1 44 38 A0 71 68 A0 E7 46 38 A0
 6B A0 E5 48 38 A0 C2 28 2A C1 55 18 62 A0 D4 A2
 C0 03 81 E2 C1 B6 C7 35 C7 B6 35 C0 55 E5 C2 38
 A5 38 A9 41 03 81 C1 20 A0 E2 E3 11 C2 1D C1 1C
 C3 28 C4 51 E1 E2 11 A0 E3 11 CE 28 A0 C0 BF E2
 11 60 A0 E3 C8 B3 43 A0 43 A0 E4 C7 B4 E4 38 13
 E0 45 A0 C0 20 E0 E2 28 E6 E2 38 A0 47 A0 28 42
 A0 13 38 B5 C5 38 A0 E2 42 35 C0 28 E3 E3 13 A0
 E6 40 0A 82 C0 03 81 A1 E4 C4 46 38 A0 C0 0A 81
 C0 35 C0 18 0A 60 A0 E4 C0 21 C1 2A C5 1D A0 40
 0A 82 C0 51 0A 28 61 A0 E4 C4 1D C4 38 A0 C0 0A
 81 53 C0 03 82 61 A0 E4 2A EA 03 82 67 A0 E4 C3
 B5 C4 38 A0 C8 20 E2 E3 12 B5 A0 C4 2A E3 E4 E4
 E3 12 C0 28 38 A0 41 A3 E1 14 E8 E3 E1 40 1A A0
 C3 1D E3 C1 A1 0B 81 E0 E3 C0 2A A0 1A E2 E8 E1
 C3 45 A1 C4 38 A5 42 A0 0B C1 1B C0 BE 28 CD 39
 81 06 2A 80 A0 3A C0 28 38 0B C2 2C 00
  Encoded length: 349 bytes
  Wall pattern: 01, Wall color: 03     Floor pattern: 07, Floor color: 10
  Flags: 
 02 02 02 02 02 02 02 02 02 02 02 02 02 02 02 02 02 02 02 02 02 02 02 02 02 02 02 02 02 02 02 02 02
 02 32 00 00 17 02 00 00 00 00 00 00 00 00 02 00 00 00 02 00 00 00 00 00 00 00 00 00 04 00 00 53 02
 02 00 00 17 02 00 00 00 00 00 00 00 00 00 02 00 00 00 02 00 00 00 00 00 26 00 00 00 04 00 27 00 02
 02 00 17 02 00 00 56 00 00 00 02 00 00 00 02 00 05 00 02 00 00 00 02 00 00 26 00 00 04 00 00 00 02
 02 17 02 00 00 56 00 00 00 02 56 00 00 00 02 00 00 00 02 00 00 00 56 02 00 00 26 00 04 03 03 00 02
 02 02 00 00 56 00 00 00 02 56 00 00 25 00 02 00 00 00 02 00 25 00 00 56 02 00 00 00 00 00 04 00 02
 02 00 00 56 00 00 00 02 56 00 00 25 00 00 02 00 00 00 02 00 00 25 00 00 56 02 03 03 03 53 04 40 02
 02 00 00 00 00 00 00 02 00 00 25 00 00 02 56 00 00 00 56 02 00 00 25 00 00 02 24 24 04 00 04 00 02
 02 02 00 00 00 00 02 02 00 25 00 00 02 56 00 00 00 00 00 56 02 00 00 25 00 02 00 00 04 00 04 00 02
 02 17 02 00 00 00 00 02 00 00 00 02 56 00 00 00 00 00 00 00 56 02 00 00 00 02 00 00 04 00 04 00 02
 02 00 17 02 00 00 00 02 00 00 02 56 00 00 00 00 00 00 00 00 00 56 02 00 00 02 40 42 04 00 04 24 02
 02 00 00 17 02 00 00 02 00 00 00 00 00 00 00 00 00 00 00 00 00 00 00 00 00 02 02 02 04 00 03 03 02
 02 00 00 00 02 00 00 02 00 00 00 00 00 00 00 00 53 00 00 00 00 00 00 00 00 02 53 00 04 00 00 00 02
 02 00 00 02 00 00 00 56 02 02 02 02 02 02 56 02 02 02 02 02 02 02 02 02 02 56 00 00 03 03 04 00 02
 02 32 02 00 00 00 02 00 00 00 00 02 17 00 02 00 29 00 02 28 00 00 00 02 40 00 00 00 00 00 04 00 02
 02 02 00 00 00 02 17 02 00 00 00 00 02 17 02 00 00 00 02 00 00 00 00 02 00 00 00 00 00 40 02 00 02
 02 00 00 00 02 17 00 17 02 00 00 00 00 02 02 00 00 00 02 00 00 00 00 02 56 00 00 00 00 02 56 00 02
 02 00 00 02 00 00 00 00 00 02 00 00 00 00 02 00 00 00 02 00 00 00 00 00 02 56 19 00 02 56 00 00 02
 02 00 00 00 02 00 32 00 02 00 00 00 02 40 02 00 00 00 00 00 00 02 00 00 00 02 56 02 56 00 00 00 02
 02 00 00 00 00 02 40 56 00 00 00 02 19 56 02 00 00 00 00 00 00 56 02 00 00 00 02 56 00 00 00 53 02
 02 40 00 00 00 00 02 00 00 00 00 02 19 02 00 00 02 00 00 00 00 02 56 00 10 10 10 04 00 03 03 03 02
 02 02 00 00 00 00 00 02 00 00 00 00 02 56 00 00 02 00 00 00 00 56 02 00 10 10 10 04 53 04 24 10 02
 02 17 02 00 00 00 00 00 02 00 33 00 02 42 00 00 02 00 00 00 29 02 56 00 10 10 10 04 00 04 10 40 02
 02 00 17 02 00 00 00 00 00 02 00 00 02 00 00 29 02 00 00 00 00 56 02 00 10 10 10 04 00 03 03 03 02
 02 00 00 17 02 00 00 00 00 00 02 42 02 00 00 00 02 00 00 00 00 00 00 02 03 03 03 03 00 00 00 00 02
 02 00 00 00 17 02 00 00 00 00 00 02 02 00 00 00 02 00 00 00 00 00 56 02 00 00 00 00 00 00 00 00 02
 02 32 00 00 00 02 00 00 00 00 02 18 02 02 00 00 00 00 00 42 00 00 00 00 02 00 00 00 00 00 02 00 02
 02 00 00 00 02 00 00 00 00 02 18 00 40 56 02 56 00 00 02 02 02 02 00 00 02 20 00 00 00 00 00 00 02
 02 00 00 02 00 00 00 00 02 00 00 02 56 00 26 02 00 00 00 00 29 00 00 00 00 02 00 00 02 02 11 11 02
 02 00 02 00 00 00 00 02 00 42 02 26 00 00 00 02 00 00 00 00 00 00 00 00 00 02 00 00 02 00 00 00 02
 02 56 00 00 00 00 00 00 02 02 00 00 00 00 00 56 02 02 02 02 02 02 56 00 00 00 02 11 00 00 27 00 02
 02 40 00 00 00 00 00 00 00 00 00 00 00 00 00 00 57 57 57 06 42 42 02 58 00 40 56 11 00 00 00 44 02
 02 02 02 02 02 02 02 02 02 02 02 02 02 02 02 02 02 02 02 02 02 02 02 02 02 02 02 02 02 02 02 02 02
