Gauntlet (rev 1 - 9)
Maze number: 93
Offset for maze 92: 232729 - 0x038d19
big endian buf: [%!l(uint8=0) %!l(uint8=3) %!l(uint8=141) %!l(uint8=25)]
G:1 Maze real addr: 249116 - 0x03CD1C, bank 2, boff: 0x4000
Maze read from: 0x03cd1c - 249116
compresssed: 276
 00 00 00 00 80 20 38 59 75 C3 44 C2 2B C0 1B A0
 1B C0 06 C1 1B A0 19 C0 28 40 A0 06 C1 28 40 A0
 19 C0 2B E7 E5 E4 E5 C5 28 60 71 61 72 61 71 61
 72 61 C0 28 DF C0 1B 4B 42 45 40 42 52 54 55 55
 54 A2 06 C4 1B C5 1A C2 1A C0 1B 45 42 C5 B4 CB
 B4 CC 28 60 71 62 C1 B5 61 71 62 C1 B5 61 C0 28
 7C 7B DF C5 1B C2 1B C5 1B C0 1A C2 1A C5 1B C0
 06 42 52 55 54 54 55 A2 19 44 43 CB 1A C4 1A C5
 B5 C5 B4 61 C1 B5 C5 B4 C4 BF 28 60 71 61 72 C1
 05 71 62 71 61 C0 28 DF C0 06 42 40 43 46 C9 1A
 52 55 54 55 54 A2 1A 44 43 40 42 CB 1A C5 B4 CB
 B4 CC 28 60 71 62 C1 B5 61 71 61 C2 B5 61 C0 28
 7C 7B DF C5 06 42 40 43 C6 1A C3 1A 81 C2 06 52
 54 55 54 55 A2 19 C2 1A C0 1B C5 1A C4 1A C3 1B
 C4 1A C5 B5 C5 B4 C4 B5 C5 B4 C5 2B 60 71 61 72
 61 71 61 72 61 C0 2B E5 E5 E4 E5 C4 BE C1 28 E1
 06 C0 28 C1 1B A0 06 C0 28 C0 1B A0 C1 28 C1 06
 A0 1A C3 00
  Encoded length: 276 bytes
  Wall pattern: 00, Wall color: 08     Floor pattern: 02, Floor color: 03
  Flags: PLAYER_OFFSCREEN 
  ╚══> while gauntlet has these elements, these flags probably do not operate
 02 02 02 02 02 02 02 02 02 02 02 02 02 02 02 02 02 02 02 02 02 02 02 02 02 02 02 02 02 02 02 02 02
 02 00 00 43 00 27 02 27 00 06 00 00 27 02 25 00 40 00 25 02 06 00 00 40 00 25 02 25 00 43 00 00 02
 02 00 00 00 00 00 02 00 00 00 00 00 00 02 00 00 00 00 00 02 00 00 00 00 00 00 02 00 00 00 00 00 02
 02 40 00 53 00 00 04 00 00 53 00 00 00 04 00 00 53 00 00 04 00 00 53 00 00 00 04 00 00 53 00 40 02
 02 00 00 00 00 00 02 00 00 00 00 00 00 02 00 00 00 00 00 02 00 00 00 00 00 00 02 00 00 00 00 00 02
 02 27 00 00 00 00 02 00 00 00 00 00 00 02 25 00 00 00 25 02 00 00 00 00 00 25 02 25 00 00 00 25 02
 02 02 02 03 02 02 02 02 02 03 02 02 02 02 02 02 03 02 02 02 02 02 02 03 02 02 02 02 02 03 02 02 02
 02 06 00 00 00 00 02 27 00 00 00 00 00 02 26 00 00 00 26 02 27 00 00 00 00 00 02 25 00 00 00 25 02
 02 00 00 00 00 00 02 00 00 00 00 00 00 02 00 00 00 00 00 02 00 00 00 00 00 00 02 00 00 00 00 00 02
 02 40 00 53 00 00 04 00 00 00 53 00 00 02 00 00 53 00 00 04 00 00 00 53 00 00 02 00 00 53 00 40 02
 02 00 00 00 00 00 02 00 00 00 00 00 00 04 00 00 00 00 00 02 00 00 00 00 00 00 04 00 00 00 00 00 02
 02 00 00 00 00 00 02 00 00 00 00 00 00 02 00 00 00 00 00 02 00 00 00 00 00 00 02 00 00 00 00 00 02
 02 27 00 00 00 27 02 00 00 00 00 00 27 02 26 00 00 00 26 02 00 00 00 00 00 27 02 06 00 00 00 25 02
 02 02 02 03 02 02 02 02 02 02 03 02 02 02 02 02 03 02 02 02 02 02 03 02 02 02 02 02 02 03 02 02 02
 02 25 00 00 00 00 02 25 00 00 00 00 25 02 00 00 00 00 00 02 00 00 00 00 00 26 02 00 00 00 00 26 02
 02 00 00 00 00 00 02 00 00 00 00 00 00 02 00 00 53 00 00 02 00 00 00 00 00 00 02 00 00 00 00 00 02
 02 40 00 53 00 00 04 00 00 53 00 00 00 04 00 00 05 00 00 04 00 00 00 53 00 00 04 00 00 53 00 40 02
 02 00 00 00 00 00 02 00 00 00 00 00 00 02 00 00 00 00 00 02 00 00 00 00 00 00 02 00 00 00 00 00 02
 02 06 00 00 00 25 02 25 00 00 00 00 25 02 00 00 00 00 00 02 25 00 00 00 00 00 02 00 00 00 00 26 02
 02 02 02 03 02 02 02 02 02 02 03 02 02 02 02 02 03 02 02 02 02 02 02 03 02 02 02 02 02 03 02 02 02
 02 26 00 00 00 00 02 25 00 00 00 00 25 02 25 00 00 00 25 02 00 00 00 00 00 00 02 00 00 00 00 26 02
 02 00 00 00 00 00 02 00 00 00 00 00 00 02 00 00 00 00 00 02 00 00 00 00 00 00 02 00 00 00 00 00 02
 02 40 00 53 00 00 04 00 00 00 53 00 00 02 00 00 53 00 00 04 00 00 53 00 00 00 02 00 00 53 00 40 02
 02 00 00 00 00 00 02 00 00 00 00 00 00 04 00 00 00 00 00 02 00 00 00 00 00 00 04 00 00 00 00 00 02
 02 00 00 00 00 00 02 00 00 00 00 00 00 02 00 00 00 00 00 02 00 00 00 00 00 00 02 00 00 00 00 00 02
 02 06 00 00 00 25 02 25 00 00 00 00 25 02 00 00 00 00 00 02 26 00 00 00 00 26 02 26 00 00 00 06 02
 02 02 02 03 02 02 02 02 02 03 02 02 02 02 02 02 03 02 02 02 02 02 03 02 02 02 02 02 02 03 02 02 02
 02 25 00 00 00 26 02 27 00 00 00 00 00 02 26 00 00 00 00 02 26 00 00 00 00 27 02 00 00 00 00 26 02
 02 00 00 00 00 00 02 00 00 00 00 00 00 02 00 00 00 00 00 02 00 00 00 00 00 00 02 00 00 00 00 00 02
 02 43 00 53 00 00 04 00 00 53 00 00 00 04 00 00 53 00 00 04 00 00 53 00 00 00 04 00 00 53 00 43 02
 02 00 00 00 00 00 02 00 00 00 00 00 00 02 00 00 00 00 00 02 00 00 00 00 00 00 02 00 00 00 00 00 02
 02 00 00 40 00 00 02 06 00 40 00 00 27 02 06 00 40 00 27 02 00 00 40 00 00 06 02 26 00 00 00 00 02
 02 02 02 02 02 02 02 02 02 02 02 02 02 02 02 02 02 02 02 02 02 02 02 02 02 02 02 02 02 02 02 02 02
