Gauntlet (rev 1 - 9)
Maze number: 95
Offset for maze 94: 232904 - 0x038dc8
big endian buf: [%!l(uint8=0) %!l(uint8=3) %!l(uint8=141) %!l(uint8=200)]
G:1 Maze real addr: 257483 - 0x03EDCB, bank 3, boff: 0x6000
Maze read from: 0x03edcb - 257483
compresssed: 238
 17 3B 0C 1F 00 72 01 68 59 91 61 28 80 4F 45 43
 06 D6 1B E5 28 D1 28 C3 35 E5 C5 A9 03 81 A5 B3
 E3 4A A1 E5 C2 0B 1B 38 C3 1E CC 11 A0 E3 28 C2
 0B 80 A1 18 A1 0D C3 27 80 76 11 A0 C2 17 A0 E1
 35 A0 C0 3B A0 1E CE 54 27 17 E2 E1 1E 0D EE 42
 C0 17 A0 E4 1E 0D 81 4B C3 A1 B3 A0 C5 1E 0D 80
 CA 03 80 A2 E1 2A C6 A1 0D 80 4D 35 C3 A2 E3 51
 3B 4D 81 E8 54 11 81 7C 55 A0 55 11 81 C7 2A C9
 17 A0 17 C6 2B 81 C1 BF 70 80 C1 A1 E8 24 A0 D1
 1B E8 17 A0 17 D5 BE 03 80 C0 2A A0 FD D6 2C C5
 B5 CD BF C8 A1 62 A0 DC 19 A0 19 43 C4 BC D0 19
 A0 19 E4 D2 BF 2E E1 19 E6 D0 A4 E9 C5 1B 2B CA
 35 6A A0 C3 B2 A2 21 C7 05 6C A0 44 D5 28 61 A0
 C4 B7 A1 C3 B4 C3 B4 6C A0 CA 04 C3 04 6D A0 C6
 BE C1 04 C3 04 43 B5 2C 43 62 A0 2A 43 00
  Encoded length: 238 bytes
  Wall pattern: 02, Wall color: 01     Floor pattern: 07, Floor color: 00
  Flags: 
 02 02 02 02 02 02 02 02 02 02 02 02 02 02 02 02 02 02 02 02 02 02 02 02 02 02 02 02 02 02 02 02 02
 02 40 00 00 00 00 00 00 00 00 00 00 00 00 00 00 00 00 40 00 00 00 00 00 02 40 00 00 00 00 40 06 02
 02 00 00 00 00 00 00 00 00 00 00 00 00 00 00 00 00 00 00 00 00 00 00 27 02 00 00 00 00 00 02 40 02
 02 00 00 00 00 00 00 00 00 00 00 00 00 00 00 00 00 00 40 00 00 00 00 53 02 00 00 00 00 00 02 00 02
 02 00 00 00 00 02 02 02 02 02 02 02 02 02 02 03 03 03 02 02 02 02 02 02 02 00 00 00 00 02 00 00 02
 02 00 00 00 00 00 00 00 00 40 02 02 00 00 00 00 00 00 02 00 00 00 11 27 56 00 00 00 02 30 00 00 02
 02 00 00 00 00 00 00 00 00 00 02 17 02 00 00 00 00 02 40 00 00 00 11 11 02 02 24 02 02 13 00 00 02
 02 00 39 39 00 00 00 00 00 00 02 33 17 02 00 00 02 23 02 00 00 02 53 02 00 59 02 30 02 00 00 00 02
 02 00 00 00 00 00 00 00 00 00 02 17 00 00 00 00 02 39 23 00 00 00 02 00 00 02 30 13 02 00 00 00 02
 02 00 00 00 00 02 00 00 00 00 02 02 00 00 00 40 02 23 02 00 00 00 00 00 02 30 13 13 02 00 00 00 02
 02 00 00 00 00 02 00 00 00 40 02 00 00 00 02 02 02 02 00 00 00 00 00 02 30 13 13 00 02 00 00 00 02
 02 00 00 00 00 02 03 03 02 02 02 00 00 02 42 00 00 00 00 00 00 00 02 02 13 13 00 00 02 00 00 00 02
 02 00 00 00 00 02 00 00 40 53 02 00 00 00 02 02 02 00 00 00 00 02 17 02 00 59 00 00 02 00 00 00 02
 02 00 00 00 00 02 00 00 40 40 02 00 00 00 00 00 00 00 00 00 02 17 00 02 00 00 00 17 02 17 00 00 02
 02 00 00 00 00 02 00 00 00 00 02 33 17 00 00 00 00 00 00 02 17 00 00 02 00 00 00 17 02 17 00 00 02
 02 00 00 00 00 02 42 00 00 00 02 00 00 02 00 00 00 23 02 23 00 00 00 02 00 00 00 43 02 43 00 00 02
 02 00 33 33 00 02 02 02 00 00 02 00 00 02 00 00 00 02 36 02 00 00 00 02 00 00 00 00 02 00 00 00 02
 02 00 00 00 00 02 27 00 00 00 02 00 00 02 00 00 02 23 02 23 00 00 00 02 00 00 00 00 02 00 00 00 02
 02 00 00 00 00 02 00 00 00 00 02 03 03 02 42 02 00 00 00 00 00 00 00 02 00 00 00 00 02 00 00 00 02
 02 00 00 00 00 02 00 00 00 00 00 00 00 02 02 00 00 00 00 00 00 00 00 02 00 00 00 00 02 00 00 00 02
 02 00 00 00 00 02 44 00 00 00 00 00 00 02 00 00 00 00 00 00 00 00 00 02 00 00 00 00 02 00 00 00 02
 02 00 00 00 00 02 02 02 00 00 00 25 02 00 00 00 00 00 00 00 00 00 00 02 00 00 00 00 02 00 00 00 02
 02 00 00 00 00 02 00 00 00 00 25 02 25 00 00 00 00 40 00 00 00 00 00 02 00 00 00 00 02 00 00 00 02
 02 00 00 00 00 02 00 00 00 25 02 25 00 00 00 00 00 02 00 00 00 00 00 00 00 00 00 00 02 00 00 00 02
 02 00 00 00 00 02 46 00 00 02 25 00 00 00 00 00 00 00 02 00 00 00 00 00 00 02 00 00 02 00 00 00 02
 02 00 00 02 02 02 02 02 02 00 00 00 00 00 00 00 00 00 00 02 00 00 00 00 00 02 27 43 02 00 00 00 02
 02 00 00 02 00 00 00 53 02 00 00 00 00 00 02 00 00 00 00 25 02 00 00 00 00 02 02 02 02 33 00 00 02
 02 00 00 02 00 00 05 00 02 00 00 00 00 00 02 00 00 00 00 00 25 02 00 00 00 00 00 40 02 00 00 00 02
 02 00 00 02 00 00 00 00 02 00 00 00 00 00 02 00 00 00 40 00 00 25 02 00 00 00 00 00 02 02 02 00 02
 02 00 00 02 00 00 00 00 02 00 00 00 00 00 02 00 00 00 00 00 00 00 25 02 00 00 00 00 00 00 00 00 02
 02 00 00 04 00 00 00 00 04 00 00 00 00 00 02 00 00 00 00 00 00 00 00 25 02 00 00 00 00 00 00 00 02
 02 00 00 04 00 00 00 00 04 00 00 00 00 40 02 44 00 00 00 00 40 00 00 00 25 02 42 00 00 00 00 40 02
 02 02 02 02 02 02 02 02 02 02 02 02 02 02 02 02 02 02 02 02 02 02 02 02 02 02 02 02 02 02 02 02 02
