Gauntlet (rev 1 - 9)
Maze number: 64
Offset for maze 63: 235664 - 0x039890
big endian buf: [%!l(uint8=0) %!l(uint8=3) %!l(uint8=152) %!l(uint8=144)]
G:1 Maze real addr: 243859 - 0x03B893, bank 1, boff: 0x2000
Maze read from: 0x03b893 - 243859
compresssed: 254
 00 00 00 00 00 23 66 03 B5 04 68 35 80 C0 25 D4
 16 84 2B CF 05 C7 16 84 C1 25 C2 25 C0 52 69 62
 35 52 16 84 35 44 AA 43 A9 41 70 83 C0 1D C4 1D
 C7 60 1B 77 84 D9 35 28 80 35 28 52 C5 65 1D 52
 C0 63 52 1B 2B 35 42 A6 43 A8 43 A5 C1 18 C0 16
 83 C6 1D C9 1D C3 41 C1 0A 83 D6 2C 04 35 52 0A
 35 0A 35 52 C0 1D C2 63 1D 52 1D C5 62 A3 43 A4
 43 A7 43 A2 70 C0 19 C4 1C C8 1D C1 25 79 D6 26
 C5 2B 28 1B C3 35 52 C5 1E C2 60 52 C2 63 27 BF
 A8 43 A3 42 A2 43 A4 26 28 DB 26 DE 2A 81 C0 62
 26 52 26 C5 26 C2 61 52 C1 26 C3 35 42 AF AD DD
 60 28 DE 20 73 20 52 20 28 73 20 76 20 C4 2A AF
 AC 42 70 7A 1E C4 1E 71 C0 1E C6 1E CA 2A C8 2A
 C1 65 28 C2 1E C3 60 52 28 66 52 28 C6 1E A5 41
 A8 42 A7 42 A1 06 C1 6F 76 6F CD 43 BE C1 52 18
 52 61 52 61 1B C8 1B C2 2A 04 C0 18 28 00
  Encoded length: 254 bytes
  Wall pattern: 03, Wall color: 06     Floor pattern: 02, Floor color: 06
  Flags: 
 02 02 02 02 02 02 02 02 02 02 02 02 02 02 02 02 02 02 02 02 02 02 02 02 02 02 02 02 02 02 02 02 02
 02 53 00 37 00 00 00 04 00 00 00 00 00 00 00 00 00 00 00 00 00 00 00 00 04 22 22 22 22 22 22 43 02
 02 00 00 00 00 00 00 04 00 00 00 00 00 00 00 00 05 00 00 00 00 00 00 00 04 22 22 22 22 22 22 00 02
 02 37 00 00 00 37 00 04 53 00 00 00 00 00 00 00 00 00 00 53 00 00 00 53 04 22 22 22 22 22 22 53 02
 02 03 03 03 03 02 02 02 02 02 02 02 02 02 02 02 03 03 03 03 02 02 02 02 02 02 02 02 02 02 03 03 02
 02 40 40 40 40 40 04 29 00 00 00 00 00 29 00 00 00 00 00 00 00 04 53 00 27 00 00 00 04 00 00 00 02
 02 40 40 40 40 40 04 00 00 00 00 00 00 00 00 00 00 00 00 00 00 04 00 00 00 00 00 00 04 00 00 00 02
 02 53 40 40 53 40 04 00 00 00 00 00 00 53 00 00 00 00 00 00 29 04 00 53 00 00 00 00 04 27 43 53 02
 02 03 03 02 02 02 02 02 02 02 03 03 03 03 02 02 02 02 02 02 02 02 02 03 03 03 03 02 02 02 02 02 02
 02 00 00 24 04 22 22 22 22 04 00 00 00 00 00 00 00 29 00 00 00 04 00 00 00 00 00 00 29 00 00 00 02
 02 03 03 00 04 10 10 10 10 04 00 00 00 00 00 00 00 00 00 00 00 04 00 00 00 00 00 00 00 00 00 00 02
 02 44 04 53 04 10 53 10 53 04 00 29 00 00 00 53 00 00 00 00 29 04 29 00 00 00 00 00 00 53 00 00 02
 02 02 02 02 02 03 03 03 03 02 02 02 02 02 03 03 03 03 02 02 02 02 02 02 02 02 03 03 03 03 02 02 02
 02 00 40 00 25 00 00 00 00 04 28 00 00 00 00 00 00 00 00 00 29 00 04 37 00 00 00 00 00 00 00 00 02
 02 00 40 00 00 00 00 00 00 04 00 00 00 00 00 00 00 00 00 00 00 00 04 00 00 00 38 00 00 00 00 00 02
 02 43 40 27 00 00 00 00 53 04 00 00 00 00 00 00 30 00 00 00 53 00 04 00 00 00 53 00 00 00 00 39 02
 02 02 02 02 02 02 02 02 02 02 03 03 03 03 02 02 02 02 03 03 03 02 02 02 03 03 03 03 02 02 02 02 02
 02 38 40 00 00 00 00 00 04 00 00 00 00 00 00 00 00 00 00 00 00 00 00 04 00 00 00 00 00 00 00 38 02
 02 00 00 00 00 00 00 00 04 00 00 00 00 00 00 00 00 00 00 00 00 00 00 04 00 00 00 00 00 00 00 42 02
 02 42 00 53 00 00 00 38 04 38 00 00 00 00 00 00 38 00 00 00 53 00 00 04 00 00 38 00 00 00 00 53 02
 02 03 03 02 02 02 02 02 02 02 02 02 02 02 02 02 02 02 02 02 02 02 02 02 02 02 02 02 02 02 02 02 02
 02 00 00 00 00 00 00 00 04 00 00 00 00 00 00 00 00 00 00 00 00 00 00 00 00 00 00 00 00 00 00 53 02
 02 40 00 00 00 00 00 00 04 00 00 00 00 00 00 00 00 00 00 00 00 00 00 00 00 00 00 00 00 00 00 00 02
 02 32 00 00 00 00 40 32 04 32 40 00 00 00 00 40 32 00 00 00 00 00 00 00 40 32 00 00 00 00 00 42 02
 02 02 02 02 02 02 02 02 02 02 02 02 02 02 02 02 02 02 02 02 02 02 02 02 02 02 02 02 02 03 03 03 02
 02 40 00 00 00 00 00 00 00 00 00 00 04 40 30 00 00 00 00 00 30 00 04 40 00 30 00 00 00 00 00 00 02
 02 30 00 00 00 00 00 00 00 00 00 00 04 42 00 00 00 00 00 00 00 00 04 42 00 00 53 00 00 00 00 00 02
 02 40 00 00 00 30 00 00 00 00 53 00 04 40 53 00 00 00 00 00 00 00 04 40 00 00 00 00 00 00 00 30 02
 02 02 02 02 02 02 03 03 02 02 02 02 02 02 02 02 02 03 03 03 02 02 02 02 02 02 02 02 03 03 03 02 02
 02 06 00 04 53 04 00 00 00 04 00 00 00 00 00 00 00 00 00 00 00 00 00 00 00 00 00 00 40 53 00 00 02
 02 00 00 04 00 04 00 00 00 04 00 00 00 00 00 00 00 00 00 00 00 00 00 00 00 00 00 00 03 03 03 03 02
 02 00 00 04 24 04 53 00 00 04 53 00 00 27 00 00 00 00 00 00 00 00 00 27 00 00 00 42 04 00 24 40 02
 02 02 02 02 02 02 02 02 02 02 02 02 02 02 02 02 02 02 02 02 02 02 02 02 02 02 02 02 02 02 02 02 02
