Gauntlet (rev 1 - 9)
Maze number: 88
Offset for maze 87: 231804 - 0x03897c
big endian buf: [%!l(uint8=0) %!l(uint8=3) %!l(uint8=137) %!l(uint8=124)]
G:1 Maze real addr: 248191 - 0x03C97F, bank 2, boff: 0x4000
Maze read from: 0x03c97f - 248191
compresssed: 206
 00 00 00 00 00 50 0A 03 68 04 5B 2C 80 62 20 28
 C1 19 65 60 C2 1F 62 A0 C1 06 D2 2B E6 C1 20 F3
 E5 E3 D0 1C 70 A0 E3 E3 28 62 AA C0 A1 B4 E1 E6
 C4 20 60 66 60 E5 E4 65 DA 1F 68 70 E7 6B 64 EA
 19 A0 C8 1F C0 20 68 E7 19 A0 E2 65 F2 19 A0 E2
 7A 60 70 C2 35 E5 E4 D0 57 C0 57 70 61 75 A0 2B
 28 64 C6 A1 E0 C9 A5 C2 BA 47 A0 D0 28 BF 63 C4
 35 C2 05 C0 B2 47 B2 C9 47 A0 C4 35 64 11 69 C6
 A2 E0 48 7B 60 71 6B D5 35 71 71 DF E9 62 65 67
 61 C7 20 C2 A2 F8 62 7C 62 64 80 61 79 67 D9 11
 D2 BA 61 60 63 58 28 58 28 62 61 CA A2 B3 A6 C0
 A8 BA E6 E0 C4 2A 81 C5 2A 60 7B E2 1B 61 C9 2B
 C9 BE C8 2A B3 1E C5 1E B3 28 C5 21 82 00
  Encoded length: 206 bytes
  Wall pattern: 00, Wall color: 10     Floor pattern: 05, Floor color: 00
  Flags: 
 02 02 02 02 02 02 02 02 02 02 02 02 02 02 02 02 02 02 02 02 02 02 02 02 02 02 02 02 02 02 02 02 02
 02 44 00 00 00 40 32 40 00 00 25 00 00 00 00 00 00 40 02 40 00 00 00 31 00 00 00 40 02 00 00 06 02
 02 00 00 00 00 00 00 00 00 00 00 00 00 00 00 00 00 00 02 43 00 00 00 00 00 00 00 02 00 00 32 00 02
 02 00 00 00 00 00 00 00 00 00 00 00 00 00 00 00 00 00 02 02 00 00 00 00 00 00 02 00 00 00 00 02 02
 02 00 00 00 00 00 00 00 00 00 00 00 00 00 00 00 00 28 02 27 02 00 00 00 00 02 00 00 00 00 02 40 02
 02 00 00 40 02 02 02 02 02 02 02 02 02 02 02 00 02 02 02 00 00 02 00 00 00 00 00 00 00 02 00 00 02
 02 00 00 32 02 40 00 00 00 00 00 00 00 40 04 40 04 00 00 00 00 00 02 00 00 00 00 00 02 00 00 00 02
 02 00 00 40 02 00 00 00 00 00 00 00 00 00 04 00 04 00 00 00 00 00 00 00 00 00 00 00 00 00 00 31 02
 02 00 00 00 02 00 00 00 00 40 00 27 00 00 04 00 04 00 00 00 02 00 00 00 00 00 00 00 00 00 00 00 02
 02 40 00 00 02 00 00 40 00 00 00 00 00 00 04 00 04 00 00 02 25 02 00 00 00 00 00 00 00 00 00 31 02
 02 32 00 00 02 00 00 00 00 00 00 40 00 00 04 00 04 00 00 00 02 25 02 00 00 00 02 00 00 00 00 00 02
 02 40 00 00 02 00 00 00 00 00 00 00 00 00 04 00 04 00 00 00 00 02 25 02 00 00 00 02 00 00 00 00 02
 02 00 00 00 02 00 00 27 00 40 00 27 00 00 04 53 04 00 00 00 00 00 02 00 00 00 00 00 02 00 00 00 02
 02 00 00 00 02 00 00 00 00 00 00 00 00 00 04 00 04 00 27 00 00 40 00 00 00 00 00 00 27 02 43 40 02
 02 00 00 00 02 40 00 00 00 00 00 00 00 02 02 00 02 02 00 00 00 00 00 00 00 00 02 02 02 02 02 02 02
 02 00 00 00 02 03 03 03 03 03 03 03 03 02 00 00 00 02 00 00 00 00 00 00 00 00 02 00 00 00 00 40 02
 02 00 00 00 00 40 00 00 00 00 00 53 00 00 00 05 00 02 03 03 03 03 03 03 03 03 02 00 00 00 00 00 02
 02 00 00 00 02 03 03 03 03 03 03 03 03 02 00 00 00 00 00 53 00 00 00 00 00 40 17 00 00 00 00 00 02
 02 00 00 00 02 40 00 00 00 00 00 00 00 02 02 02 00 02 03 03 03 03 03 03 03 03 02 00 00 00 00 00 02
 02 00 00 00 02 00 00 27 00 40 00 00 27 00 00 04 00 04 00 00 00 00 00 00 00 40 02 00 00 00 00 00 02
 02 00 00 00 02 00 00 00 00 00 00 00 00 00 00 04 53 04 00 27 00 00 27 00 00 00 02 00 00 00 00 00 02
 02 00 00 00 02 00 00 00 00 00 00 00 00 00 00 04 00 04 00 00 00 00 00 00 00 00 02 00 00 00 00 00 02
 02 02 00 00 02 40 00 00 00 00 00 00 40 00 00 04 00 04 00 00 00 40 00 00 40 00 02 00 00 00 00 00 02
 02 32 00 00 02 02 02 02 00 00 00 00 00 00 00 04 00 04 00 00 00 00 00 00 00 00 02 00 00 00 00 00 02
 02 02 00 00 02 40 00 00 00 00 00 00 00 00 00 04 00 04 00 27 00 00 00 40 00 00 02 00 00 40 40 00 02
 02 40 00 00 02 00 00 00 02 00 00 00 27 00 00 04 00 04 00 00 00 40 00 00 00 00 02 00 00 00 00 00 02
 02 00 00 00 02 00 00 00 02 00 00 00 00 00 00 04 17 04 00 00 00 00 00 00 00 00 02 00 00 00 00 00 02
 02 00 00 00 02 00 00 40 02 40 00 00 00 00 40 04 40 04 40 00 00 00 40 00 00 40 02 00 00 00 00 00 02
 02 00 00 00 00 02 02 02 02 02 02 02 02 02 02 02 00 02 02 02 02 02 02 02 02 02 02 00 00 00 00 00 02
 02 00 02 00 02 00 00 00 00 00 42 02 42 00 00 00 00 00 00 42 02 40 00 00 00 00 00 00 00 00 00 00 02
 02 00 27 00 00 00 02 27 00 00 40 02 00 00 00 00 00 00 00 00 02 43 00 00 00 00 00 00 00 00 00 00 02
 02 00 00 00 00 00 00 00 00 00 42 02 30 00 00 00 00 00 00 30 02 40 00 00 00 00 00 00 33 33 33 33 02
 02 02 02 02 02 02 02 02 02 02 02 02 02 02 02 02 02 02 02 02 02 02 02 02 02 02 02 02 02 02 02 02 02
