Gauntlet (rev 1 - 9)
Maze number: 112
Offset for maze 111: 235467 - 0x0397cb
big endian buf: [%!l(uint8=0) %!l(uint8=3) %!l(uint8=151) %!l(uint8=203)]
G:1 Maze real addr: 251854 - 0x03D7CE, bank 2, boff: 0x4000
Maze read from: 0x03d7ce - 251854
compresssed: 156
 00 00 00 00 00 42 9D 0B 5A 68 6A 2B 80 4E 2A 4A
 DF DF C1 1F 64 62 71 61 62 62 62 52 DF 5B DF DF
 5F 72 FE E0 E0 E0 E0 E0 E0 E0 E0 1D A0 E0 E0 E0
 E0 E0 52 C6 1C D2 1D C2 A1 E0 E0 E0 E0 E0 E0 E0
 E0 E0 E0 E0 E0 E0 C3 1D DF C0 AF AB CC 11 D2 BF
 CA 11 CF 05 C0 06 CB 11 D0 BF C3 AF AB C1 1D DE
 A1 E0 E0 E0 1C A0 E0 E0 E0 E0 E0 E0 E0 E0 E0 53
 C5 2E F9 E0 E0 E0 E0 E0 E0 E0 E0 E0 1D A0 E0 E0
 E0 DE 2A DF DF 54 5F DF DF 59 62 62 62 62 71 60
 61 62 C2 1F DD BC C0 BE 4F 4B C2 00
  Encoded length: 156 bytes
  Wall pattern: 02, Wall color: 13     Floor pattern: 04, Floor color: 09
  Flags: 
 02 02 02 02 02 02 02 02 02 02 02 02 02 02 02 02 02 02 02 02 02 02 02 02 02 02 02 02 02 02 02 02 02
 02 43 11 11 11 11 11 11 11 11 11 11 11 11 11 11 11 42 11 11 11 11 11 11 11 11 11 11 11 00 00 00 02
 02 00 00 00 00 00 00 00 00 00 00 00 00 00 00 00 00 00 00 00 00 00 00 00 00 00 00 00 00 00 02 00 02
 02 00 00 00 00 00 00 00 00 00 00 00 00 00 00 00 00 00 00 00 00 00 00 00 00 00 00 00 00 00 02 31 02
 02 00 00 00 00 26 00 00 00 26 00 00 42 00 00 26 00 00 00 26 00 00 00 26 00 00 00 26 00 00 02 40 02
 02 00 00 00 00 00 00 00 00 00 00 00 00 00 00 00 00 00 00 00 00 00 00 00 00 00 00 00 00 00 02 00 02
 02 00 00 00 00 00 00 00 00 00 00 00 40 00 00 00 00 00 00 00 00 00 00 00 00 00 00 00 00 00 02 00 02
 02 00 00 00 00 00 00 00 00 00 00 00 00 00 00 00 00 00 00 00 00 00 00 00 00 00 00 00 00 00 02 00 02
 02 00 00 00 00 00 00 00 00 00 00 00 00 00 00 00 00 00 00 00 00 00 00 00 00 00 00 00 00 40 02 00 02
 02 42 00 00 00 00 00 00 00 00 00 00 00 00 00 00 00 00 00 00 00 00 00 00 00 00 00 00 00 00 02 00 02
 02 02 00 02 00 02 00 02 00 02 00 02 00 02 00 02 00 02 29 02 00 02 00 02 00 02 00 02 00 02 02 00 02
 02 40 00 00 00 00 00 00 00 28 00 00 00 00 00 00 00 00 00 00 00 00 00 00 00 00 00 00 00 29 02 00 02
 02 02 02 00 02 00 02 00 02 00 02 00 02 00 02 00 02 00 02 00 02 00 02 00 02 00 02 00 02 00 02 00 02
 02 29 00 00 00 00 00 00 00 00 00 00 00 00 00 00 00 00 00 00 00 00 00 00 00 00 00 00 00 00 02 00 02
 02 00 00 02 02 02 02 02 02 02 02 02 02 02 02 02 02 02 02 02 02 02 02 02 02 02 02 02 02 02 02 00 02
 02 00 00 00 00 00 00 00 00 00 00 00 17 00 00 00 00 00 00 00 00 00 00 00 00 00 00 00 00 00 02 00 02
 02 00 00 00 00 00 00 00 00 00 00 00 17 00 00 00 00 00 00 00 00 00 00 00 00 00 00 00 00 05 02 06 02
 02 00 00 00 00 00 00 00 00 00 00 00 17 00 00 00 00 00 00 00 00 00 00 00 00 00 00 00 00 00 02 00 02
 02 00 00 02 02 02 02 02 02 02 02 02 02 02 02 02 02 02 02 02 02 02 02 02 02 02 02 02 02 02 02 00 02
 02 29 00 00 00 00 00 00 00 00 00 00 00 00 00 00 00 00 00 00 00 00 00 00 00 00 00 00 00 00 02 00 02
 02 02 02 00 02 00 02 00 02 28 02 00 02 00 02 00 02 00 02 00 02 00 02 00 02 00 02 00 02 00 02 00 02
 02 40 00 00 00 00 00 00 46 00 00 00 00 00 00 00 00 00 00 00 00 00 00 00 00 00 00 00 00 00 02 00 02
 02 00 00 02 00 02 00 02 00 02 00 02 00 02 00 02 00 02 00 02 00 02 29 02 00 02 00 02 00 02 02 00 02
 02 00 00 00 00 00 00 00 00 00 00 00 00 00 00 00 00 00 00 00 00 00 00 00 00 00 00 00 00 42 02 00 02
 02 00 00 00 00 00 00 00 00 00 00 00 00 00 00 00 00 00 00 00 00 00 00 00 00 00 00 00 00 00 02 00 02
 02 00 00 00 00 00 00 00 00 00 00 00 00 00 00 00 00 00 00 00 00 00 00 00 00 00 00 00 00 00 02 00 02
 02 00 00 40 00 00 00 00 00 00 00 00 00 00 00 00 00 00 00 00 40 00 00 00 00 00 00 00 00 00 02 00 02
 02 00 00 00 00 00 00 00 00 00 00 00 00 00 00 00 00 00 00 00 00 00 00 00 00 00 00 00 00 00 02 00 02
 02 00 00 00 00 00 00 00 00 00 00 00 00 00 00 00 00 00 00 00 00 00 00 00 00 00 00 00 00 00 02 40 02
 02 00 00 26 00 00 00 26 00 00 00 26 00 00 00 26 00 00 42 00 26 00 00 26 00 00 00 26 00 00 02 31 02
 02 00 00 00 00 00 00 00 00 00 00 00 00 00 00 00 00 00 00 00 00 00 00 00 00 00 00 00 00 00 02 00 02
 02 11 11 11 11 11 11 11 11 11 11 11 11 11 11 11 11 11 11 11 11 11 11 11 11 11 11 11 11 00 00 00 02
 02 02 02 02 02 02 02 02 02 02 02 02 02 02 02 02 02 02 02 02 02 02 02 02 02 02 02 02 02 02 02 02 02
