Gauntlet (rev 1 - 9)
Maze number: 51
Offset for maze 50: 229376 - 0x038000
big endian buf: [%!l(uint8=0) %!l(uint8=3) %!l(uint8=128) %!l(uint8=0)]
G:1 Maze real addr: 245763 - 0x03C003, bank 2, boff: 0x4000
Maze read from: 0x03c003 - 245763
compresssed: 260
 17 3B 0C 1F 00 10 02 09 0C 15 66 C1 06 C5 04 0F
 83 C6 1F C4 1F C1 35 C5 05 C1 AF A4 2A C9 04 16
 83 7C C5 B3 35 C3 04 16 83 76 EA 19 A0 2B C2 AF
 A4 2A E3 19 A2 C0 04 44 CC 1A E4 E0 E2 04 44 C6
 1A EE B2 19 AF A5 28 72 7B C0 35 C2 2C C0 1A CB
 B4 35 E1 C7 1F C2 1F D4 A2 C8 03 87 C6 B2 A0 35
 70 CD 61 43 D9 61 43 CB B3 35 CB 61 43 D9 61 42
 BF 28 AE B8 A2 03 80 65 43 72 77 C5 04 C5 61 43
 77 76 C1 04 C0 35 65 43 C1 AF A1 C5 61 43 C2 20
 C7 20 C5 04 C5 61 43 C7 20 C6 20 C1 04 C5 61 43
 C1 AF A1 C5 61 43 C2 1D C7 1D C5 04 C1 BF 64 43
 C7 1D C6 1D C1 04 C5 61 43 C1 AF A1 C5 61 43 C5
 2A 28 80 C1 18 C0 28 80 2A C2 04 C4 BF 61 BF 42
 C5 2A 28 80 18 C2 28 80 2A C2 04 C2 5F 5F 62 43
 C1 AF A1 CE 1A C7 1A C5 04 C4 B2 C1 B2 D5 04 C1
 B6 C2 28 80 C2 BE C7 1A C6 1A C1 04 C1 28 C1 28
 C1 28 C1 00
  Encoded length: 260 bytes
  Wall pattern: 00, Wall color: 02     Floor pattern: 01, Floor color: 00
  Flags: 
 02 02 02 02 02 02 02 02 02 02 02 02 02 02 02 02 02 02 02 02 02 02 02 02 02 02 02 02 02 02 02 02 02
 02 00 06 02 00 00 00 00 00 04 15 15 15 15 15 00 00 00 00 00 00 00 31 00 00 00 00 00 31 00 00 53 02
 02 00 00 02 00 00 05 00 00 02 02 02 02 02 02 02 02 02 02 02 02 02 02 02 02 02 02 02 02 02 42 00 02
 02 00 00 02 00 00 00 00 00 04 22 22 22 22 22 00 00 00 00 00 00 00 00 00 00 00 00 00 38 00 00 00 02
 02 00 00 02 53 00 00 00 00 04 22 22 22 22 22 00 00 00 00 00 00 00 38 00 00 00 00 00 00 00 00 00 02
 02 00 02 25 02 43 00 00 00 02 02 02 02 02 02 02 02 02 02 02 02 02 02 02 02 02 02 02 02 02 42 00 02
 02 00 00 02 25 02 02 02 00 04 09 09 09 09 09 00 00 00 00 00 00 00 00 00 00 00 00 00 26 00 00 00 02
 02 00 02 00 02 02 00 02 02 04 09 09 09 09 09 00 00 00 00 00 00 00 26 00 00 00 00 00 00 00 00 00 02
 02 00 00 00 00 02 02 02 25 02 02 02 02 02 02 02 02 02 02 02 02 02 02 02 02 02 02 02 02 02 02 40 02
 02 00 00 38 00 02 00 00 00 00 00 00 00 00 00 00 38 02 53 00 00 00 44 02 26 00 00 00 00 00 00 00 02
 02 00 00 00 00 02 53 00 02 02 00 00 00 00 00 00 00 02 31 00 00 00 31 02 00 00 00 00 00 00 00 00 02
 02 00 00 00 00 00 00 00 02 00 00 00 02 02 02 00 00 02 00 00 00 00 00 02 03 03 02 03 03 02 03 03 02
 02 00 00 00 00 00 00 00 02 02 53 00 38 02 00 00 00 02 00 00 00 00 00 02 21 21 02 12 12 02 09 09 02
 02 00 00 00 00 00 00 00 00 00 00 00 00 02 00 00 00 02 00 00 00 00 00 02 21 21 02 12 12 02 09 09 02
 02 00 00 00 00 00 00 00 00 00 00 00 00 02 53 00 00 02 00 00 00 00 00 02 21 21 02 12 12 02 09 09 02
 02 00 00 00 00 00 00 00 00 00 00 00 00 00 00 00 00 02 00 00 00 00 00 02 21 21 02 12 12 02 09 09 02
 02 40 02 02 02 02 02 02 02 02 02 02 02 02 02 02 02 02 02 02 02 03 03 02 21 21 02 12 12 02 09 09 02
 02 00 00 00 38 00 00 00 00 00 00 00 00 38 00 00 00 00 00 00 04 00 00 02 21 21 02 12 12 02 09 09 02
 02 00 00 00 00 00 00 00 00 38 00 00 00 00 00 00 00 38 00 00 04 00 53 02 21 21 02 12 12 02 09 09 02
 02 00 00 02 02 02 02 02 02 02 02 02 02 02 02 02 02 02 02 02 02 00 00 02 21 21 02 12 12 02 09 09 02
 02 00 00 00 32 00 00 00 00 00 00 00 00 32 00 00 00 00 00 00 04 00 00 02 21 21 02 12 12 02 09 09 02
 02 00 00 00 00 00 00 00 00 32 00 00 00 00 00 00 00 32 00 00 04 00 00 02 21 21 02 12 12 02 09 09 02
 02 00 00 02 02 02 02 02 02 02 02 02 02 02 02 02 02 02 02 02 02 00 00 02 21 21 02 12 12 02 09 09 02
 02 00 00 00 29 00 00 00 00 00 00 00 00 29 00 00 00 00 00 00 04 00 00 02 21 21 02 12 12 02 09 09 02
 02 00 00 00 00 00 00 00 00 29 00 00 00 00 00 00 00 29 00 00 04 00 00 02 21 21 02 12 12 02 09 09 02
 02 00 00 02 02 02 02 02 02 02 02 02 02 02 02 02 02 02 02 02 02 00 00 02 21 21 02 12 12 02 09 09 02
 02 00 00 00 00 00 00 42 40 40 00 00 24 00 40 40 42 00 00 00 04 00 00 02 21 21 02 12 12 02 09 09 02
 02 00 00 00 00 00 00 42 40 40 24 00 00 00 40 40 42 00 00 00 04 00 00 02 21 21 02 12 12 02 09 09 02
 02 00 00 02 02 02 02 02 02 02 02 02 02 02 02 02 02 02 02 02 02 00 00 02 00 00 02 00 00 02 00 00 02
 02 00 00 00 26 00 00 00 00 00 00 00 00 26 00 00 00 00 00 00 04 00 00 02 00 00 02 00 00 02 00 00 02
 02 00 00 00 00 00 00 00 00 00 00 00 00 00 00 00 00 00 00 00 04 00 00 02 00 00 00 40 40 00 00 00 02
 02 00 00 00 00 00 00 00 00 26 00 00 00 00 00 00 00 26 00 00 04 00 00 40 00 00 40 00 00 40 00 00 02
 02 02 02 02 02 02 02 02 02 02 02 02 02 02 02 02 02 02 02 02 02 02 02 02 02 02 02 02 02 02 02 02 02
