Gauntlet (rev 1 - 9)
Maze number: 74
Offset for maze 73: 231280 - 0x038770
big endian buf: [%!l(uint8=0) %!l(uint8=3) %!l(uint8=135) %!l(uint8=112)]
G:1 Maze real addr: 255859 - 0x03E773, bank 3, boff: 0x6000
Maze read from: 0x03e773 - 255859
compresssed: 328
 14 21 01 02 80 42 4D 03 51 04 39 06 80 1A C1 06
 C0 35 C1 21 2A C0 35 C6 28 C0 2A C1 21 35 C0 1B
 C0 06 C2 2A CC 05 C4 3A 6D C2 3A 81 CF 2A C2 28
 63 C3 35 CA 35 C1 28 C1 3A C2 3A C2 20 11 C2 A1
 B4 A8 B4 CC 75 3A 82 C0 20 C0 0B C0 28 85 C0 0B
 C7 28 C1 3A 80 28 C6 0B C8 0B D4 0B C8 0B C6 3A
 80 60 20 11 80 73 C1 78 C2 0B C8 0B C3 1A 65 C8
 0B C8 0B C4 79 CE 0B C8 0B C1 7A C0 28 CF 0B C8
 0B C9 35 C9 0B C8 0B D4 0B C8 0B CB 09 81 C5 1B
 C8 1B C5 1A C1 BF C1 09 81 C0 20 C3 A2 5B A2 5B
 A3 C4 40 C4 09 1A C6 28 5C C0 35 A0 5C C1 35 5C
 28 C5 28 C4 09 80 58 C4 BD 35 A2 C0 44 C0 BD C4
 35 C4 09 C0 28 C2 3B C0 28 A0 E8 28 C0 57 C8 09
 C3 5A 47 35 80 46 C0 1A C4 3B C0 09 EB E1 0A 85
 28 5A 6C 84 A0 C1 4B 28 C4 3B C1 20 47 E1 35 0A
 84 C8 56 42 04 40 3B 11 83 A0 C1 4A 58 C5 35 61
 47 E1 28 C7 2A 69 04 3B C1 20 C0 35 A0 C1 4B 68
 47 E1 0A 85 C0 1A 35 04 C1 06 65 04 3B 11 83 A0
 C1 4B 61 81 63 47 E1 C6 28 C2 1A 60 81 63 80 E5
 C1 4B C0 BE 21 11 80 C3 20 11 C4 28 A0 28 80 A0
 0A 85 C0 35 06 04 06 00
  Encoded length: 328 bytes
  Wall pattern: 02, Wall color: 13     Floor pattern: 04, Floor color: 04
  Flags: PLAYER_OFFSCREEN 
  ╚══> while gauntlet has these elements, these flags probably do not operate
 02 02 02 02 02 02 02 02 02 02 02 02 02 02 02 02 02 02 02 02 02 02 02 02 02 02 02 02 02 02 02 02 02
 02 06 26 00 57 06 00 53 57 00 33 42 02 53 00 00 00 00 00 00 00 40 02 42 00 57 33 53 57 27 00 06 02
 02 00 00 42 57 00 00 00 57 00 00 00 02 00 00 00 00 05 00 00 00 00 02 58 00 57 00 00 57 00 00 00 02
 02 00 00 00 57 00 17 00 57 00 58 58 02 00 00 00 00 00 00 00 00 00 02 00 00 57 00 00 57 42 00 00 02
 02 40 00 00 57 00 17 00 57 00 00 53 02 00 00 00 00 00 00 00 00 00 02 53 00 57 40 00 57 58 00 00 02
 02 58 00 00 57 32 17 00 57 00 02 02 02 04 02 04 02 04 02 04 02 04 02 02 00 57 00 00 57 00 00 00 02
 02 00 00 00 57 57 58 58 57 00 32 02 11 04 40 04 40 04 40 04 40 04 11 02 00 57 00 00 57 00 00 40 02
 02 00 58 58 40 57 00 00 57 00 00 02 11 04 00 04 00 04 00 04 00 04 11 02 00 57 00 00 57 00 00 00 02
 02 00 00 00 00 57 00 00 57 00 00 02 11 04 00 04 00 04 00 04 00 04 11 02 00 57 00 00 57 00 58 58 02
 02 17 32 17 17 57 00 00 57 00 00 02 11 04 00 04 00 04 00 04 00 04 11 02 00 57 00 26 57 00 00 00 02
 02 00 17 00 00 04 00 00 04 00 00 02 11 04 00 04 00 04 00 04 00 04 11 02 00 57 00 00 57 00 00 00 02
 02 00 00 00 00 04 00 00 04 00 00 02 11 04 00 04 00 04 00 04 00 04 11 02 00 57 00 40 04 00 00 00 02
 02 00 00 00 00 04 00 00 04 00 00 02 11 04 00 04 00 04 00 04 00 04 11 02 00 04 00 00 04 00 00 00 02
 02 53 00 00 00 04 00 00 04 00 00 02 11 04 00 04 00 04 00 04 00 04 11 02 00 04 00 00 04 00 00 00 02
 02 00 00 00 00 04 00 00 04 00 00 02 11 04 00 04 00 04 00 04 00 04 11 02 00 04 00 00 04 00 00 00 02
 02 00 00 09 09 04 00 00 04 00 00 02 27 04 00 04 00 04 00 04 00 04 27 02 00 04 00 00 04 26 00 00 02
 02 00 00 09 09 04 00 32 04 00 00 02 02 04 02 04 02 04 02 04 02 04 02 02 00 04 00 00 04 03 04 00 02
 02 00 00 09 26 04 00 00 04 00 00 02 40 04 00 53 02 04 00 00 53 04 40 02 00 04 00 00 04 40 04 00 02
 02 00 00 09 04 04 00 00 04 00 00 02 53 02 02 02 00 03 03 03 03 03 00 02 00 04 00 00 04 53 04 00 02
 02 00 00 09 04 40 00 00 04 59 00 40 02 00 00 00 00 00 00 00 00 00 02 40 00 04 00 00 04 00 04 00 02
 02 00 00 09 04 00 00 00 04 03 03 03 03 03 03 03 03 53 53 03 03 03 03 03 03 03 00 26 04 00 04 00 02
 02 59 00 09 04 00 00 00 00 00 00 00 00 00 00 00 02 00 00 02 10 10 10 10 10 10 10 40 04 00 04 00 02
 02 00 00 00 04 00 00 00 00 00 17 17 17 17 17 17 02 00 00 03 03 03 03 03 03 03 03 03 03 03 04 40 02
 02 00 00 00 04 59 00 00 32 03 03 03 03 03 03 03 03 00 00 02 53 10 10 10 10 10 10 00 00 00 04 00 02
 02 00 00 00 04 03 03 03 04 03 59 17 17 17 17 17 02 00 00 03 03 03 03 03 03 03 03 03 03 03 04 00 02
 02 00 00 00 00 53 00 00 17 03 03 03 03 03 03 03 03 00 00 02 40 00 00 00 00 00 00 00 00 42 00 00 02
 02 00 00 00 00 00 00 00 17 04 59 00 00 32 00 53 02 00 00 03 03 03 03 03 03 03 03 03 03 03 03 00 02
 02 00 00 00 00 00 00 00 17 03 03 03 03 03 03 03 03 00 00 02 10 10 10 10 10 10 10 00 26 53 04 00 02
 02 06 00 00 00 00 00 00 17 04 59 17 17 17 17 17 02 00 00 03 03 03 03 03 03 03 03 03 03 03 03 00 02
 02 17 17 17 00 00 00 00 17 03 03 03 03 03 03 03 03 00 00 02 00 00 00 00 00 00 00 40 00 00 00 26 02
 02 17 17 17 00 00 00 00 17 17 00 00 00 00 00 00 02 00 00 03 03 03 03 03 03 03 03 03 03 03 03 00 02
 02 33 17 17 00 00 00 00 32 17 00 00 00 00 00 40 02 40 40 02 10 10 10 10 10 10 10 00 53 06 04 06 02
 02 02 02 02 02 02 02 02 02 02 02 02 02 02 02 02 02 02 02 02 02 02 02 02 02 02 02 02 02 02 02 02 02
