Gauntlet (rev 1 - 9)
Maze number: 89
Offset for maze 88: 232013 - 0x038a4d
big endian buf: [%!l(uint8=0) %!l(uint8=3) %!l(uint8=138) %!l(uint8=77)]
G:1 Maze real addr: 248400 - 0x03CA50, bank 2, boff: 0x4000
Maze read from: 0x03ca50 - 248400
compresssed: 176
 00 00 00 00 02 02 4D 5A A8 04 09 35 80 C3 11 C1
 65 35 C2 63 0C C0 0D C0 0E C0 06 C5 11 D1 0C C0
 0D C0 0E 51 03 C2 2B C1 11 45 CA 0C C0 0D C0 0E
 82 C4 11 CC 1B C3 0C C0 0D 53 03 82 C4 11 D1 0C
 54 0D 84 C4 6F C1 0C 03 84 C0 11 83 65 1A CA 0C
 86 D6 57 03 86 DF DF 41 43 DF C3 2E C5 1B C8 1B
 CF 5C D0 03 8D D0 35 CD 05 5E 03 8C BF 03 8D CE
 35 D0 03 8E DF DF D2 1A C9 60 1A DF E0 E1 E0 E1
 4E DF DF C6 1B E0 C1 1B E1 DF CE A3 C1 65 A2 49
 C4 2C C0 1E C6 2B E6 DF CC 1E C4 35 80 C7 1B E0
 CB B4 C4 BE 35 80 C3 65 7D 5E 35 5D C2 68 35 00
  Encoded length: 176 bytes
  Wall pattern: 02, Wall color: 13     Floor pattern: 00, Floor color: 04
  Flags: SHOTS_HURT 
  ╚══> while gauntlet has these elements, these flags probably do not operate
 02 02 02 02 02 02 02 02 02 02 02 02 02 02 02 02 02 02 02 02 02 02 02 02 02 02 02 02 02 02 02 02 02
 02 53 00 00 00 00 17 00 00 40 00 00 00 00 00 04 53 04 00 00 40 00 00 00 04 12 04 13 04 14 04 06 02
 02 00 00 00 00 00 17 00 00 00 00 00 00 00 00 04 00 04 00 00 00 00 00 00 04 12 04 13 04 14 04 03 02
 02 00 00 43 00 00 17 00 00 00 00 00 00 26 00 04 00 04 00 00 00 00 00 00 04 12 04 13 04 14 14 14 02
 02 00 00 00 00 00 17 00 00 00 00 00 00 00 00 04 00 04 00 00 27 00 00 00 04 12 04 13 04 03 03 03 02
 02 00 00 00 00 00 17 00 00 00 00 00 00 00 00 04 00 04 00 00 00 00 00 00 04 12 04 13 13 13 13 13 02
 02 00 00 00 00 00 40 00 00 00 00 00 00 00 00 04 00 04 00 00 00 00 00 00 04 12 03 03 03 03 03 03 02
 02 17 17 17 17 17 40 00 00 00 00 00 00 26 00 04 00 04 00 00 00 00 00 00 04 12 12 12 12 12 12 12 02
 02 00 00 00 00 00 00 00 00 00 00 00 00 00 00 04 00 04 00 00 00 00 00 00 04 03 03 03 03 03 03 03 02
 02 00 00 00 00 00 00 00 00 00 00 00 00 00 00 04 00 04 00 00 00 00 00 00 00 00 00 00 00 00 00 00 02
 02 00 00 00 00 00 00 00 00 00 00 00 00 00 00 04 00 04 00 00 00 00 00 00 00 00 00 00 00 00 00 00 02
 02 00 00 26 00 00 00 00 26 00 00 00 00 00 00 04 00 04 00 00 00 00 00 00 00 00 00 00 00 00 00 00 02
 02 00 00 00 00 00 00 00 00 00 00 00 00 46 00 04 00 04 00 00 27 00 00 00 00 00 00 00 00 00 27 00 02
 02 00 00 00 00 00 00 00 00 00 00 00 00 00 00 04 00 04 00 00 00 00 00 00 00 00 00 00 00 00 00 00 02
 02 03 03 03 03 03 03 03 03 03 03 03 03 03 03 03 00 04 00 00 00 00 00 00 00 00 00 00 00 00 00 00 02
 02 53 00 00 00 00 00 00 00 00 00 00 00 00 00 00 05 04 03 03 03 03 03 03 03 03 03 03 03 03 03 03 02
 02 03 03 03 03 03 03 03 03 03 03 03 03 03 03 03 00 00 00 00 00 00 00 00 00 00 00 00 00 00 00 53 02
 02 00 00 00 00 00 00 00 00 00 00 00 00 00 00 04 00 03 03 03 03 03 03 03 03 03 03 03 03 03 03 03 02
 02 00 00 00 00 00 00 00 00 00 00 00 00 00 09 04 00 04 00 00 00 00 00 00 00 00 00 00 00 00 00 00 02
 02 00 00 00 00 00 00 00 00 00 00 00 00 00 09 04 00 04 00 00 00 00 00 00 00 00 00 00 00 00 00 00 02
 02 00 00 00 00 00 00 00 00 00 00 00 00 00 09 04 00 04 00 00 26 00 00 00 00 00 00 00 00 00 00 40 02
 02 26 00 00 00 00 00 00 00 00 00 00 00 00 09 04 00 04 00 00 00 00 00 00 00 00 00 00 00 00 00 00 02
 02 00 00 02 00 00 02 00 02 00 00 02 00 00 09 04 00 04 00 00 00 00 00 00 00 00 00 26 00 00 00 00 02
 02 00 00 00 00 00 00 00 00 00 00 00 00 00 09 04 00 04 00 00 00 00 00 00 00 00 00 00 00 00 00 00 02
 02 00 00 00 00 00 00 00 00 00 00 00 00 00 09 04 00 04 00 00 00 00 00 00 00 00 00 00 00 00 00 00 02
 02 00 00 27 00 02 00 00 27 00 00 02 00 00 09 04 00 04 00 00 00 00 00 00 00 00 00 00 00 00 00 00 02
 02 00 00 00 00 00 00 00 00 00 00 00 00 00 09 04 00 04 00 00 00 00 00 00 00 00 02 02 02 02 02 00 02
 02 40 00 00 00 00 00 00 02 02 02 00 00 00 09 04 00 04 00 00 00 26 00 00 00 00 02 44 00 30 00 00 02
 02 00 00 00 00 43 00 00 00 00 00 00 00 02 09 04 00 04 00 00 00 00 00 00 00 00 02 00 00 00 00 00 02
 02 00 00 00 00 00 00 00 00 00 00 00 00 00 09 04 00 04 00 00 00 00 00 00 00 00 02 30 00 00 00 00 02
 02 53 53 00 00 00 00 00 00 00 00 27 00 02 09 04 00 04 00 00 00 00 00 00 00 00 02 00 00 00 00 00 02
 02 53 53 00 00 00 00 40 00 00 00 00 00 00 09 04 53 04 00 00 00 40 00 00 00 00 00 00 00 00 00 53 02
 02 02 02 02 02 02 02 02 02 02 02 02 02 02 02 02 02 02 02 02 02 02 02 02 02 02 02 02 02 02 02 02 02
