Gauntlet (rev 1 - 9)
Maze number: 105
Offset for maze 104: 233988 - 0x039204
big endian buf: [%!l(uint8=0) %!l(uint8=3) %!l(uint8=146) %!l(uint8=4)]
G:1 Maze real addr: 250375 - 0x03D207, bank 2, boff: 0x4000
Maze read from: 0x03d207 - 250375
compresssed: 250
 00 00 00 00 00 30 0A 0E 0D 28 5E C3 A1 70 E0 72
 C0 35 1C 2A CF 05 35 A1 42 A0 DA 04 42 04 E5 C6
 2A E7 C0 A2 43 E5 EF 03 A2 C4 A1 78 75 C2 44 E0
 D8 43 B3 79 C1 35 2C CB 42 72 E1 C1 A1 62 B7 A3
 03 80 A4 75 EA 0C 83 C3 61 0C C3 03 A3 C1 35 E6
 64 C3 63 C2 43 B2 A2 B7 C3 BA 0C 85 C3 0C 82 E2
 CB 67 C3 63 72 CB 03 80 AC B5 CF 0C 81 C1 6D E6
 C0 A1 41 0C 81 C1 6A 1E 60 BF 78 80 0C B5 0C 81
 C3 AB C8 0C 85 C4 2A 41 28 40 28 41 28 42 AD B5
 C0 1C C4 4E 70 CD 52 40 28 40 28 40 51 28 51 46
 C1 B2 C7 A1 B4 03 80 A5 46 1E 40 C2 04 C3 A4 CD
 45 C4 35 A1 CF 1C 46 C2 A3 C3 A4 B3 28 35 A6 D0
 4C 1D 77 C6 1D 42 A5 B2 42 CF A2 B3 42 C5 42 C4
 28 D0 03 83 A3 2A 81 D3 47 A3 45 C1 B7 C5 A3 B4
 49 1E 46 78 48 B3 40 A0 42 BE 42 1E 35 BD 2C C4
 B5 C1 47 B3 42 A0 1E 40 06 00
  Encoded length: 250 bytes
  Wall pattern: 00, Wall color: 10     Floor pattern: 03, Floor color: 00
  Flags: 
 02 02 02 02 02 02 02 02 02 02 02 02 02 02 02 02 02 02 02 02 02 02 02 02 02 02 02 02 02 02 02 02 02
 02 00 00 00 02 02 00 30 00 02 00 00 00 30 02 53 28 42 02 00 00 00 00 00 00 00 00 00 00 00 00 00 02
 02 00 05 53 02 02 14 14 14 02 00 00 00 00 02 00 00 00 02 00 00 00 00 00 00 00 00 00 00 00 00 00 02
 02 00 00 00 00 04 14 14 14 04 00 00 00 00 02 00 02 00 02 00 00 00 00 00 42 00 00 00 00 00 00 00 02
 02 02 00 02 02 02 14 14 14 02 00 00 00 00 02 00 02 00 02 00 00 00 00 00 00 00 00 00 00 00 00 00 02
 02 02 03 02 02 02 00 00 00 02 00 02 02 00 02 00 00 00 02 00 00 00 30 00 00 00 00 00 00 30 00 00 02
 02 14 14 14 14 02 00 02 00 02 00 00 00 00 02 00 00 00 02 00 00 00 00 00 00 00 00 00 00 00 00 00 02
 02 14 14 14 14 02 00 00 00 02 00 00 00 00 02 00 30 00 02 53 44 00 00 00 00 00 00 00 00 00 00 00 02
 02 14 14 14 00 00 00 30 00 02 02 00 00 02 02 13 13 13 02 02 02 02 02 03 03 02 02 02 02 02 00 00 02
 02 00 00 00 30 02 00 00 00 02 00 00 00 00 02 00 02 12 12 12 12 12 00 00 00 00 13 13 12 02 00 00 02
 02 03 02 02 02 02 00 00 53 02 00 00 00 00 02 00 02 13 13 13 13 13 00 00 00 00 13 13 13 02 00 00 02
 02 14 14 14 14 02 02 02 02 02 00 00 00 02 02 12 12 12 12 12 12 12 00 00 00 00 12 12 12 02 00 00 02
 02 02 00 00 00 00 00 00 00 00 00 00 00 02 13 13 13 13 13 13 13 13 00 00 00 00 13 13 13 02 00 00 02
 02 30 00 00 00 00 00 00 00 00 00 00 00 02 03 03 02 02 02 02 02 02 02 02 02 02 02 02 02 02 00 00 02
 02 00 00 00 00 00 00 00 00 00 00 00 00 02 12 12 02 00 00 13 13 13 13 13 13 13 13 13 13 13 13 13 02
 02 00 00 00 00 00 00 00 02 00 02 02 14 02 12 12 02 00 00 13 13 13 13 13 13 13 13 13 13 13 30 13 02
 02 00 00 00 00 00 00 00 00 00 30 30 12 02 12 12 02 00 00 00 02 02 02 02 02 02 02 02 02 02 02 02 02
 02 00 00 00 00 00 00 00 00 00 12 12 12 12 12 12 02 00 00 00 02 00 42 40 14 40 14 40 14 14 40 14 02
 02 14 02 02 02 02 02 02 02 02 02 02 02 02 02 02 02 00 28 00 02 00 00 40 14 14 14 14 14 40 14 40 02
 02 14 14 14 14 14 02 00 30 02 00 00 00 00 00 00 00 00 00 00 02 00 00 40 14 40 14 40 14 40 40 40 02
 02 14 14 14 14 14 02 00 00 02 00 00 00 00 00 00 00 00 02 02 02 03 03 02 02 02 02 02 02 14 14 14 02
 02 14 14 14 30 14 02 00 00 04 00 00 00 00 02 02 02 02 02 00 00 00 00 02 00 00 00 00 00 00 00 00 02
 02 14 14 14 14 14 02 00 00 02 00 00 53 02 02 00 00 00 00 00 00 00 00 02 00 00 00 00 00 00 00 28 02
 02 14 14 14 14 14 02 00 00 02 02 02 02 02 00 00 00 02 02 02 02 02 02 02 40 53 02 02 02 02 02 02 02
 02 00 00 00 00 00 02 00 00 02 00 00 00 00 00 00 00 02 14 14 14 14 14 14 14 14 02 14 14 14 14 29 02
 02 00 00 00 00 00 02 00 30 02 00 00 00 00 00 00 29 02 14 14 02 02 02 02 02 02 02 14 14 14 00 00 02
 02 00 00 00 00 00 02 00 00 02 00 00 00 02 02 02 02 02 14 14 02 00 00 00 00 00 00 14 14 14 00 00 02
 02 00 00 40 00 00 02 00 00 02 00 00 00 02 00 00 00 00 00 00 02 03 03 03 03 03 02 02 02 02 42 42 02
 02 00 00 00 00 00 02 00 00 02 00 00 00 02 00 00 00 00 00 00 02 14 14 14 02 14 02 14 14 02 02 02 02
 02 14 14 14 14 14 02 00 00 02 00 00 00 02 00 00 02 02 02 02 02 14 14 14 02 14 02 14 14 14 14 30 02
 02 14 14 14 14 14 02 00 00 00 00 00 00 02 00 00 30 14 14 14 14 14 14 14 02 14 02 14 02 14 14 14 02
 02 14 14 14 30 53 02 44 00 00 00 00 00 02 00 00 14 14 14 14 14 14 14 14 02 14 14 14 02 30 14 06 02
 02 02 02 02 02 02 02 02 02 02 02 02 02 02 02 02 02 02 02 02 02 02 02 02 02 02 02 02 02 02 02 02 02
