Gauntlet (rev 1 - 9)
Maze number: 41
Offset for maze 40: 231599 - 0x0388af
big endian buf: [%!l(uint8=0) %!l(uint8=3) %!l(uint8=136) %!l(uint8=175)]
G:1 Maze real addr: 239794 - 0x03A8B2, bank 1, boff: 0x2000
Maze read from: 0x03a8b2 - 239794
compresssed: 292
 0D 3B 07 17 08 04 7A 68 B5 04 43 04 C2 1F C2 63
 19 2A C4 19 2A C6 35 1B C5 AF A3 03 C3 1B CC 04
 45 41 E6 C7 A3 03 AA CF 35 82 C6 63 24 C0 63 1B
 C1 21 C3 B2 C0 05 C2 B2 C1 A5 C1 A2 B4 C2 1B C6
 04 C7 1B C1 66 04 E2 73 A4 03 B4 A2 B2 C1 A1 C2
 B4 C1 A1 CE 04 C5 22 C6 21 04 CA 1B C2 A6 C3 1E
 44 74 E3 E2 61 04 41 A1 B5 A2 B3 C2 BA A0 C7 1B
 D5 1B CD A2 C0 B5 A8 B3 A0 C5 BD 43 E3 21 C0 22
 C3 04 D4 53 C2 B3 A3 03 A6 79 C2 6F C5 BF C2 BF
 73 A6 C0 B2 A5 CD 61 B2 D0 B5 CA BB C6 B2 A5 28
 C0 6A 21 C3 51 C0 B3 C2 04 C6 B3 C3 2C 75 80 B8
 A0 C8 A2 C3 21 E3 BA C4 0B 82 C0 20 C6 19 40 C3
 21 C3 65 0B 82 B2 A4 B3 C3 A3 03 A0 03 C3 21 C4
 0B 81 2B C0 20 C0 19 42 C0 19 40 C3 1B E4 C4 0B
 82 C3 A3 B4 A3 CE 0B 82 42 18 64 21 A0 C0 B7 C6
 21 C4 0B 81 40 35 B6 03 8E E2 41 80 B8 0B 82 C1
 1E 28 C3 1E 28 CF 5E 18 C0 0B 81 C4 1E 28 D2 A1
 B2 03 80 B5 AF A1 BF 03 B9 A1 03 BD 06 A0 69 2A
 C5 2A C9 00
  Encoded length: 292 bytes
  Wall pattern: 04, Wall color: 10     Floor pattern: 00, Floor color: 07
  Flags: 
 02 02 02 02 02 02 02 02 02 02 02 02 02 02 02 02 02 02 02 02 02 02 02 02 02 02 02 02 02 02 02 02
 04 00 02 00 31 00 00 00 53 00 00 00 00 25 42 00 00 00 00 00 25 42 00 00 00 00 00 00 02 53 27 00
 02 00 02 00 02 02 02 02 02 02 02 02 02 02 02 02 02 02 02 02 02 02 02 02 02 03 02 00 02 00 27 00
 02 00 02 00 02 00 00 00 00 00 00 00 04 00 00 00 00 00 00 40 00 00 40 00 00 00 02 00 02 00 02 00
 02 00 02 00 02 00 02 02 02 02 02 03 02 02 02 02 02 02 02 02 02 02 02 00 00 00 02 00 02 00 00 00
 02 00 02 00 02 00 02 53 53 53 02 00 02 00 00 00 00 00 53 00 00 00 02 36 00 53 02 00 02 00 27 00
 02 33 02 00 02 00 02 00 05 00 02 00 02 00 02 02 02 02 02 02 02 00 02 02 02 02 02 00 02 00 27 00
 02 00 02 00 02 00 04 00 00 00 02 00 00 00 02 27 00 00 53 00 02 00 02 00 00 00 04 00 02 00 02 00
 02 00 02 03 02 02 02 02 02 03 02 02 02 02 02 00 02 02 02 00 02 00 02 00 02 02 02 00 02 00 00 00
 02 00 02 00 02 00 00 00 02 00 04 00 00 00 00 00 02 34 00 00 02 00 00 00 02 33 04 00 02 00 00 00
 02 00 02 00 02 00 27 00 02 00 02 02 02 02 02 02 02 00 00 00 02 30 00 00 02 00 02 40 02 00 00 00
 02 03 02 00 02 00 02 00 02 00 02 53 00 00 04 00 02 40 02 02 02 02 02 02 02 00 02 00 02 02 02 00
 02 00 02 00 02 00 27 00 02 00 04 00 00 00 02 00 02 00 00 00 00 00 00 00 00 00 02 00 00 27 02 00
 02 00 02 00 02 00 02 00 02 00 04 00 02 02 02 00 02 02 02 02 02 02 02 02 02 02 02 02 02 00 02 00
 02 00 02 00 02 00 02 40 02 00 04 00 02 33 02 34 00 00 00 00 04 00 00 00 00 00 00 00 02 00 02 00
 02 00 04 00 02 00 02 00 02 00 04 00 00 00 02 02 02 02 02 03 02 02 02 02 02 02 02 00 02 00 02 00
 02 00 04 00 02 03 02 00 02 53 02 00 00 00 00 00 00 00 02 00 00 00 00 00 00 00 02 00 02 00 02 00
 02 00 04 00 02 00 02 00 02 03 02 02 02 02 02 02 02 00 02 02 02 02 02 02 02 00 02 00 02 00 02 00
 02 00 04 00 00 00 02 53 02 00 02 00 02 00 00 00 02 00 00 00 00 00 00 00 02 00 02 00 02 00 02 00
 02 00 04 00 00 00 02 00 02 00 04 00 02 00 00 00 02 02 02 02 02 02 02 40 02 53 02 00 00 00 02 00
 02 00 04 02 00 33 02 00 00 00 04 00 02 00 02 00 04 00 00 00 00 00 02 00 02 00 02 00 00 44 02 00
 02 00 04 02 03 03 02 02 02 00 02 00 00 00 02 00 02 02 02 02 00 00 02 00 33 00 02 00 02 02 02 00
 02 00 04 02 11 11 11 11 02 32 02 00 00 00 02 00 02 25 00 40 00 00 02 00 33 00 02 00 02 53 00 00
 02 00 04 02 11 11 11 11 02 02 02 02 02 02 02 00 02 00 00 02 02 02 02 03 02 03 02 00 02 00 33 00
 02 00 04 02 11 11 11 43 00 32 02 25 00 00 00 40 02 25 00 40 00 00 02 00 27 00 02 00 02 00 02 00
 02 00 04 02 11 11 11 02 00 00 02 00 02 02 02 02 02 02 02 02 02 00 02 00 00 00 02 00 02 00 00 00
 02 00 04 02 11 11 11 02 00 00 02 40 24 53 00 00 00 00 00 33 02 00 02 00 00 00 02 00 02 00 33 00
 02 00 04 02 11 11 11 02 40 53 02 03 03 03 03 03 03 03 03 03 03 03 03 03 03 03 02 00 02 00 02 00
 02 40 04 02 02 11 11 02 00 00 30 40 00 00 00 00 30 40 00 00 00 00 00 00 00 00 02 00 02 00 00 00
 02 00 04 24 02 11 11 02 00 00 00 00 00 30 40 00 00 00 00 00 00 00 00 00 00 00 02 00 02 00 00 00
 02 00 02 02 02 03 03 02 02 02 02 02 02 02 02 02 02 02 02 02 02 02 02 02 02 02 02 03 02 02 02 03
 02 06 02 53 00 00 00 00 00 00 00 00 00 00 42 00 00 00 00 00 00 42 00 00 00 00 00 00 00 00 00 00
 02 02 02 02 02 02 02 02 02 02 02 02 02 02 02 02 02 02 02 02 02 02 02 02 02 02 02 02 02 02 02 02
