Gauntlet (rev 1 - 9)
Maze number: 79
Offset for maze 78: 229863 - 0x0381e7
big endian buf: [%!l(uint8=0) %!l(uint8=3) %!l(uint8=129) %!l(uint8=231)]
G:1 Maze real addr: 246250 - 0x03C1EA, bank 2, boff: 0x4000
Maze read from: 0x03c1ea - 246250
compresssed: 184
 17 1A 00 01 00 40 05 68 67 04 AA 18 80 27 60 60
 35 C2 21 2A 35 C0 1E 65 62 2C C0 11 82 D9 35 CC
 21 73 28 6A C4 70 70 70 78 1E D8 28 2C CA 1A C7
 1E C0 1E C0 1E C0 1E 49 C0 26 D3 1A D4 2B 41 40
 40 D3 27 DF D0 26 DF DF 43 C0 26 D5 28 6E CC 1A
 7F C6 05 DB 18 BF C6 5F 41 C0 26 5F C5 5F C1 1A
 C2 5F C1 06 D3 26 C9 18 DF DA 27 CC 1A DF 47 C0
 26 4B 40 40 40 C4 26 DF D3 1B C0 1B C0 1B D3 27
 D7 26 C9 2B C0 21 C0 21 C0 21 C0 21 C0 1A 7C 1A
 D7 1E CE 70 70 70 72 28 2C 1D 43 DF C0 21 65 44
 DD BE 18 1B C0 1B C0 1B 35 5E 61 70 5E 1E C3 35
 5E 27 62 2C 5E 11 81 00
  Encoded length: 184 bytes
  Wall pattern: 00, Wall color: 05     Floor pattern: 04, Floor color: 00
  Flags: 
 02 02 02 02 02 02 02 02 02 02 02 02 02 02 02 02 02 02 02 02 02 02 02 02 02 02 02 02 02 02 02 02 02
 02 24 39 00 39 00 39 53 04 00 00 33 42 53 04 30 00 00 00 00 00 04 39 00 00 00 39 44 04 17 17 17 02
 02 00 00 00 00 00 00 00 04 00 00 00 00 00 04 00 00 00 00 00 00 04 00 00 00 00 00 53 04 00 00 00 02
 02 00 00 00 00 00 00 00 04 33 42 00 00 00 04 40 00 00 00 00 00 04 00 00 00 00 00 39 04 00 00 00 02
 02 42 00 42 00 42 00 42 04 00 00 00 00 00 04 00 00 30 00 00 00 04 00 00 00 00 00 00 04 00 00 00 02
 02 00 00 00 00 00 00 00 04 00 00 40 44 00 04 00 00 00 00 00 00 04 00 00 26 00 00 00 04 00 00 00 02
 02 30 00 30 00 30 00 30 04 00 00 00 00 00 04 00 00 00 40 00 38 04 00 00 00 00 00 00 04 00 00 00 02
 02 00 00 00 00 00 00 00 04 26 00 00 00 00 04 00 00 00 00 00 00 04 00 00 00 00 00 00 04 00 00 43 02
 02 00 40 00 40 00 40 00 04 00 00 00 00 00 04 00 00 00 00 00 00 04 00 00 00 00 00 39 04 00 00 00 02
 02 00 00 00 00 00 00 00 04 00 00 00 00 00 04 00 00 00 00 00 00 04 00 00 00 00 00 00 04 00 00 00 02
 02 00 00 00 00 00 00 00 04 00 00 00 00 38 04 00 00 00 00 00 00 04 00 00 00 00 00 00 04 00 00 00 02
 02 00 00 00 00 00 00 00 04 00 00 00 00 00 04 00 00 00 00 00 00 04 00 00 00 00 00 00 04 00 00 00 02
 02 00 00 00 00 00 00 00 04 00 00 00 00 00 04 00 00 00 40 00 38 04 00 00 00 00 00 00 04 00 00 00 02
 02 00 00 00 00 00 00 00 04 00 00 40 00 00 04 00 00 00 00 00 00 04 00 00 00 00 00 39 04 00 00 00 02
 02 00 00 00 00 00 00 00 04 26 42 00 00 00 04 00 00 00 00 00 00 04 00 00 00 00 00 00 04 00 00 00 02
 02 00 05 00 00 00 00 00 04 00 00 00 00 00 04 00 00 00 00 00 00 04 00 00 00 00 00 00 04 00 00 24 02
 02 00 00 00 00 00 00 00 04 00 00 40 00 38 04 00 00 00 00 00 00 04 00 00 26 00 00 00 04 00 00 06 02
 02 00 00 00 00 00 00 00 04 00 00 00 00 00 04 00 00 00 00 00 38 04 00 00 00 00 00 00 04 00 00 24 02
 02 00 00 00 00 00 00 00 04 00 00 00 00 00 04 00 00 00 00 00 00 04 00 00 00 00 00 00 04 00 00 00 02
 02 00 00 00 00 00 00 00 04 00 00 00 00 00 04 00 00 00 00 00 00 04 00 00 00 00 00 39 04 00 00 00 02
 02 00 00 00 00 00 00 00 04 26 00 00 00 00 04 00 00 00 00 00 00 04 00 00 00 00 00 00 04 00 00 00 02
 02 00 00 00 00 00 00 00 04 00 00 00 00 00 04 00 00 00 40 00 38 04 00 00 00 00 00 00 04 00 00 00 02
 02 40 00 40 00 40 00 40 04 00 00 00 00 38 04 00 00 00 00 00 00 04 00 00 00 00 00 00 04 00 00 00 02
 02 00 00 00 00 00 00 00 04 00 00 00 00 00 04 00 00 00 00 00 00 04 00 00 00 00 00 00 04 00 00 00 02
 02 00 27 00 27 00 27 00 04 00 00 00 00 00 04 00 00 00 00 00 00 04 00 00 00 00 00 39 04 00 00 00 02
 02 00 00 00 00 00 00 00 04 00 00 00 00 00 04 00 00 00 00 00 38 04 00 00 00 00 00 00 04 00 00 43 02
 02 33 00 33 00 33 00 33 04 26 42 00 00 00 04 00 00 00 00 00 00 04 00 00 26 00 00 00 04 00 00 00 02
 02 00 00 00 00 00 00 00 04 00 00 00 00 00 04 00 00 30 00 00 00 04 00 00 00 00 00 00 04 00 00 00 02
 02 42 00 42 00 42 00 42 04 00 00 40 44 29 04 00 00 00 40 00 00 04 00 00 00 00 00 00 04 00 00 00 02
 02 00 00 00 00 00 00 00 04 00 00 00 00 00 04 00 00 00 00 00 33 04 00 00 00 00 00 39 04 00 00 00 02
 02 40 00 00 00 00 00 00 04 00 00 00 00 00 04 00 00 00 00 00 00 04 00 00 00 00 00 00 04 00 00 00 02
 02 24 27 00 27 00 27 53 04 00 00 39 42 00 04 30 00 00 00 00 53 04 39 00 00 00 39 44 04 17 17 17 02
 02 02 02 02 02 02 02 02 02 02 02 02 02 02 02 02 02 02 02 02 02 02 02 02 02 02 02 02 02 02 02 02 02
