Gauntlet (rev 1 - 9)
Maze number: 54
Offset for maze 53: 230167 - 0x038317
big endian buf: [%!l(uint8=0) %!l(uint8=3) %!l(uint8=131) %!l(uint8=23)]
G:1 Maze real addr: 254746 - 0x03E31A, bank 3, boff: 0x6000
Maze read from: 0x03e31a - 254746
compresssed: 317
 0A 21 02 01 08 33 FB 0D 78 5A A8 28 80 CA 06 C0
 78 A0 1A A0 19 38 2A 1A C6 1D F1 60 19 1A 81 F5
 E2 60 19 A0 C3 1D C0 B3 EE 1A E3 60 19 C9 1D C3
 43 E1 1A E5 60 C8 B3 C4 42 50 A0 E0 E6 1A C2 B4
 CA 42 B3 A0 E0 19 38 66 62 A0 38 64 A2 C2 70 A0
 60 E0 74 73 1B A6 C5 28 A0 1A A0 60 19 A0 C6 7A
 3B E5 60 E0 E0 C5 AD E3 60 E0 60 19 A0 C4 2A 1A
 C5 78 1A A0 60 19 38 60 E0 C3 35 C3 18 C5 3B 55
 A0 60 E0 60 19 A0 C2 AD 55 38 50 E0 60 E0 70 18
 CA 18 57 A0 E0 50 E0 19 A0 BF 35 C4 18 C4 3B BF
 C0 05 C1 3B 52 A0 60 E0 E0 C1 AD 58 A0 E0 E0 C0
 A1 2A C6 7C 1A A0 60 E0 E0 51 C3 18 C5 3B 57 A0
 19 38 50 E0 19 AF C3 2A 50 A0 60 E0 E0 E0 28 81
 D1 1A A0 60 E0 60 E0 CE 3B C3 BC 1A A0 60 50 60
 19 38 C7 A5 38 A2 C2 28 A0 60 19 A0 60 E0 C5 1C
 C1 73 71 2C E5 60 60 E0 7F 03 80 43 A1 E0 60 19
 A0 C4 74 1D C2 1D C0 B2 C2 42 50 A0 1A A0 E0 E5
 CE 43 E1 1A A0 65 1A F5 E5 60 C3 B6 C2 B4 C2 1D
 C4 B5 E3 E3 60 1A CB 03 81 6B 60 1A A0 BE C8 28
 B2 C0 2C BE 78 28 A0 1A 38 1A 38 2A 00
  Encoded length: 317 bytes
  Wall pattern: 03, Wall color: 11     Floor pattern: 03, Floor color: 15
  Flags: 
 02 02 02 02 02 02 02 02 02 02 02 02 02 02 02 02 02 02 02 02 02 02 02 02 02 02 02 02 02 02 02 02 02
 02 40 00 00 00 00 02 00 00 00 00 00 00 06 02 40 00 00 00 00 00 00 00 00 00 02 26 02 25 56 42 26 02
 02 00 00 00 00 00 02 29 00 00 00 00 00 00 02 00 00 00 00 00 00 00 00 00 00 00 02 00 56 25 26 26 02
 02 00 00 02 00 00 02 00 00 02 00 00 00 00 02 00 00 00 00 00 00 00 00 02 00 00 00 02 00 56 25 02 02
 02 00 00 02 29 00 02 00 00 02 00 00 00 00 02 00 00 00 02 00 00 00 02 26 00 00 00 00 02 00 56 25 02
 02 00 00 02 00 00 00 00 00 02 29 00 00 00 02 13 13 13 02 00 00 02 26 00 00 00 00 00 00 02 00 56 02
 02 00 00 02 00 00 00 00 00 02 00 00 00 00 02 13 13 13 02 26 02 00 02 00 00 00 00 00 00 00 02 26 02
 02 00 00 02 00 00 00 00 00 00 00 00 00 00 02 13 13 13 02 02 00 02 25 56 00 00 00 00 00 00 00 56 02
 02 00 00 56 02 56 00 00 00 00 00 56 02 02 02 00 00 00 40 00 02 00 56 00 02 40 00 00 00 00 00 40 02
 02 00 00 00 27 02 02 02 02 02 02 02 00 00 02 00 00 00 40 02 26 02 00 56 25 02 00 00 00 00 00 00 02
 02 40 00 00 00 00 00 00 00 00 00 00 00 59 02 00 00 00 02 00 02 00 56 00 02 00 02 00 00 00 00 00 02
 02 02 02 02 02 02 02 02 02 02 02 02 02 02 02 00 00 00 02 02 00 56 00 02 00 56 25 02 00 00 00 00 02
 02 42 26 00 00 00 00 00 00 40 00 00 00 00 02 00 00 00 02 26 02 00 56 25 56 00 56 00 02 00 00 00 02
 02 53 00 00 00 00 24 00 00 00 00 00 00 59 02 00 00 00 02 00 26 02 00 56 00 02 00 56 25 02 00 00 02
 02 02 02 02 02 02 02 02 02 02 02 02 02 02 02 00 00 00 02 00 00 26 56 00 26 00 02 00 56 00 02 40 02
 02 24 00 00 00 00 00 00 00 00 00 00 00 24 02 00 00 00 02 00 00 00 26 02 00 02 00 26 00 02 25 02 02
 02 53 00 00 00 00 00 24 00 00 00 00 00 59 02 00 05 00 02 59 00 00 00 26 02 00 56 00 02 00 02 00 02
 02 02 02 02 02 02 02 02 02 02 02 02 02 02 02 00 00 00 02 00 00 00 00 00 26 02 00 02 00 02 00 02 02
 02 42 00 00 00 00 00 00 00 40 00 00 00 00 02 00 00 00 02 00 00 00 00 26 02 00 56 00 02 00 02 00 02
 02 26 00 00 00 00 24 00 00 00 00 00 00 59 02 00 00 00 02 00 00 00 26 02 25 56 00 26 00 02 25 02 02
 02 02 02 02 02 02 02 02 02 02 02 02 02 02 02 00 00 00 02 42 00 26 02 00 56 00 02 00 02 00 02 40 02
 02 40 00 00 00 00 00 00 00 00 00 00 00 00 02 00 00 00 02 00 26 02 00 56 00 02 00 56 00 02 00 00 02
 02 00 00 00 00 00 00 00 00 00 00 00 00 59 02 00 00 00 02 26 02 00 56 00 26 00 56 25 56 00 00 00 02
 02 00 00 00 02 02 02 02 02 02 02 56 02 02 02 00 00 00 40 02 00 56 25 02 00 56 00 02 00 00 00 00 02
 02 00 28 00 02 40 00 00 00 00 40 02 00 44 02 00 00 00 02 00 02 00 56 00 56 00 02 40 00 00 00 00 02
 02 00 00 00 02 00 00 00 02 00 00 02 03 03 02 13 13 13 02 02 00 02 00 56 25 02 00 00 00 00 00 40 02
 02 00 00 00 02 29 00 00 02 29 00 02 00 00 02 13 13 13 02 26 02 26 02 00 02 00 00 00 00 00 00 02 02
 02 00 00 00 02 00 00 00 02 00 00 00 00 00 02 13 13 13 02 00 00 02 26 02 00 00 00 00 00 00 56 26 02
 02 00 00 00 02 00 00 00 02 00 00 00 00 00 02 00 00 00 02 00 00 00 02 00 00 00 00 00 00 02 00 56 02
 02 00 00 00 02 00 00 00 02 00 00 02 29 00 02 00 00 00 02 00 00 00 00 02 00 00 00 00 02 00 56 26 02
 02 00 00 00 00 00 00 00 00 00 00 02 03 03 02 00 00 00 00 00 00 00 00 00 00 00 00 56 00 56 26 02 02
 02 00 00 00 00 00 00 00 00 00 40 02 00 44 02 40 00 00 00 00 00 00 00 00 00 40 02 26 56 26 56 42 02
 02 02 02 02 02 02 02 02 02 02 02 02 02 02 02 02 02 02 02 02 02 02 02 02 02 02 02 02 02 02 02 02 02
