Gauntlet (rev 1 - 9)
Maze number: 65
Offset for maze 64: 235921 - 0x039991
big endian buf: [%!l(uint8=0) %!l(uint8=3) %!l(uint8=153) %!l(uint8=145)]
G:1 Maze real addr: 244116 - 0x03B994, bank 1, boff: 0x2000
Maze read from: 0x03b994 - 244116
compresssed: 204
 00 00 00 00 00 03 69 A8 66 A0 6A 35 80 C7 47 26
 63 44 26 C0 52 A0 F5 E3 E3 5A 2B E6 E5 2B E2 C5
 5A A0 E7 E3 EF E3 E4 E3 68 E3 E3 E6 E3 EB E3 C3
 42 04 53 A0 E9 E3 C8 03 80 A0 E3 C2 03 80 B8 E1
 E3 63 C3 18 E2 E3 74 A0 E3 C3 41 0E 81 E4 C5 40
 A1 E3 C7 0E 81 E5 C2 50 45 A0 C8 06 0E 80 C1 42
 2A A3 BB A2 C7 42 26 AD CA A7 CA 04 D2 BF CA 04
 C2 05 C5 49 AB 35 C3 35 A1 B4 A7 03 7B A7 5F 26
 E2 77 CA 58 A0 E8 E3 EE C3 B4 C1 03 81 E0 E3 69
 E1 E3 E7 E3 C5 43 A0 E3 C6 35 E1 E3 E8 E3 C7 52
 A0 E3 E6 E3 ED E3 E4 E3 EF E3 2A 70 A0 E3 F1 C3
 A2 E3 66 C2 BF E7 C2 44 A0 EB C5 51 A0 E6 EC C8
 2B A0 C1 BE 26 66 C0 41 35 BA 4E 00
  Encoded length: 204 bytes
  Wall pattern: 03, Wall color: 09     Floor pattern: 00, Floor color: 06
  Flags: 
 02 02 02 02 02 02 02 02 02 02 02 02 02 02 02 02 02 02 02 02 02 02 02 02 02 02 02 02 02 02 02 02 02
 02 53 00 00 00 00 00 00 00 00 40 00 00 00 00 00 00 00 02 38 00 00 00 00 38 40 00 00 00 00 00 38 02
 02 32 00 00 00 02 00 00 00 00 00 00 00 00 00 02 00 00 02 00 00 00 00 00 00 00 00 00 02 00 00 00 02
 02 02 00 00 00 00 02 32 00 00 00 00 00 00 00 02 00 00 02 43 00 00 00 00 00 00 00 02 00 00 00 00 02
 02 00 02 43 00 00 00 02 00 00 00 00 00 00 32 02 00 00 02 00 00 00 00 00 00 00 02 00 00 00 00 00 02
 02 00 00 02 00 00 00 00 02 00 00 00 00 00 00 02 00 00 02 00 00 00 00 00 00 02 00 00 00 00 02 00 02
 02 00 00 00 02 00 00 00 00 02 00 00 00 00 00 02 00 00 02 38 00 00 00 00 02 00 00 00 00 02 00 00 02
 02 00 00 00 00 02 00 00 00 00 02 00 00 00 00 02 00 00 02 00 00 00 00 02 00 00 00 00 02 00 00 00 02
 02 40 00 00 00 04 32 00 00 00 00 02 00 00 00 02 00 00 02 00 00 00 02 00 00 00 00 02 00 00 00 00 02
 02 00 00 00 00 03 03 02 00 00 00 00 02 00 00 02 03 03 02 00 00 02 00 00 00 00 02 00 00 00 00 38 02
 02 00 00 00 24 00 00 00 02 00 00 00 00 02 00 02 00 00 00 42 02 00 00 00 00 02 00 00 00 00 40 00 02
 02 14 14 14 00 00 00 00 00 02 00 00 00 00 00 02 40 00 02 02 00 00 00 00 02 00 00 00 00 00 00 00 02
 02 14 14 14 00 00 00 00 00 00 02 00 00 00 32 02 40 00 00 00 00 00 00 02 00 00 00 00 00 00 00 00 02
 02 06 14 14 00 00 40 00 00 00 42 02 02 02 02 02 02 02 02 00 00 00 02 00 00 00 00 40 00 00 00 38 02
 02 02 02 02 02 02 02 02 02 02 02 02 02 02 00 00 00 00 02 00 00 00 02 00 00 02 02 02 02 02 02 02 02
 02 00 00 00 00 00 00 00 00 00 00 00 04 00 00 00 00 00 02 00 00 00 02 00 00 00 00 00 00 00 00 00 02
 02 00 00 00 00 00 00 00 00 00 00 00 04 00 00 00 05 00 02 00 00 00 02 40 00 00 00 00 00 00 00 00 02
 02 00 02 02 02 02 02 02 02 02 02 02 02 02 53 00 00 00 02 53 02 02 02 02 02 02 02 02 02 02 02 03 02
 02 00 00 00 00 00 00 00 00 00 00 00 42 02 02 02 02 02 02 02 02 32 00 00 00 00 00 00 00 00 00 00 02
 02 00 00 00 00 00 38 00 00 00 02 00 00 02 00 00 00 00 02 42 00 00 00 00 00 00 00 00 00 00 00 32 02
 02 00 00 00 00 00 00 00 00 02 00 00 00 02 00 00 00 00 02 02 00 00 00 00 02 00 00 00 00 00 00 00 02
 02 00 00 00 00 00 00 00 02 00 00 00 00 02 00 02 03 03 02 00 02 00 00 00 00 02 00 00 00 00 00 00 02
 02 00 00 00 38 00 00 02 00 00 00 00 02 00 00 02 00 00 02 00 00 02 00 00 00 00 02 00 00 00 00 00 02
 02 40 00 00 00 00 02 00 00 00 00 02 00 00 00 02 00 00 02 53 00 00 02 00 00 00 00 02 00 00 00 00 02
 02 00 00 00 00 02 00 00 00 00 02 00 00 00 00 02 00 00 02 32 00 00 00 02 00 00 00 00 02 00 00 00 02
 02 00 00 00 02 00 00 00 00 02 00 00 00 00 00 02 00 00 02 00 00 00 00 00 02 00 00 00 00 02 00 00 02
 02 00 00 02 00 00 00 00 02 00 00 00 00 00 00 02 00 00 02 00 00 00 00 00 00 02 00 00 00 00 02 42 02
 02 42 02 00 00 00 00 02 00 00 00 00 00 00 00 02 00 00 02 00 00 00 00 00 00 00 02 00 00 00 00 02 02
 02 02 00 00 00 00 02 00 00 00 00 00 00 00 38 02 00 00 02 00 00 00 00 00 00 00 00 02 00 00 00 40 02
 02 00 00 00 00 02 00 00 00 00 00 00 00 00 00 02 00 00 02 00 00 00 00 00 00 32 00 00 02 00 00 00 02
 02 00 00 00 02 00 00 00 00 00 00 00 00 00 00 02 00 00 02 00 00 00 00 00 00 00 00 00 43 02 00 00 02
 02 38 00 00 00 00 00 00 00 38 00 40 00 00 53 02 40 00 00 00 00 00 00 00 00 00 00 00 00 00 00 00 02
 02 02 02 02 02 02 02 02 02 02 02 02 02 02 02 02 02 02 02 02 02 02 02 02 02 02 02 02 02 02 02 02 02
