Gauntlet (rev 1 - 9)
Maze number: 97
Offset for maze 96: 233390 - 0x038fae
big endian buf: [%!l(uint8=0) %!l(uint8=3) %!l(uint8=143) %!l(uint8=174)]
G:1 Maze real addr: 257969 - 0x03EFB1, bank 3, boff: 0x6000
Maze read from: 0x03efb1 - 257969
compresssed: 184
 09 0C 0C 00 80 00 00 4D 5A 39 78 E3 E1 28 C0 3A
 04 35 C0 18 3B 18 E9 2B 28 C0 06 C1 05 70 71 14
 C0 2A C2 18 82 E8 C1 51 39 73 71 C1 2A C2 18 82
 C8 04 3A 80 C0 16 A4 C1 A3 B2 C0 53 39 81 53 C8
 A1 03 A2 CD 3B 46 ED E0 E0 EA E0 E0 DF EA 60 E0
 EA 60 E0 DF EA E0 E0 EA E0 E0 4D C3 A2 DF FB E2
 DC B8 D0 14 AC 20 AE 14 BF C9 B2 C6 B2 F8 E2 D4
 2B DF C5 A2 CA 35 D8 0D 80 ED E0 E0 EA E0 E0 DF
 48 80 A0 60 E0 EA 60 E0 48 DF E0 E0 E0 EA E0 E0
 DF D7 2D CC 39 80 03 39 80 F5 03 A2 28 C0 3A 80
 04 D5 04 3A C0 16 CE BE EB C1 39 BE 06 C0 18 35
 51 C8 14 EB 28 51 06 00
  Encoded length: 184 bytes
  Wall pattern: 00, Wall color: 00     Floor pattern: 00, Floor color: 00
  Flags: PLAYER_OFFSCREEN 
  ╚══> while gauntlet has these elements, these flags probably do not operate
 02 02 02 02 02 02 02 02 02 02 02 02 02 02 02 02 02 02 02 02 02 02 02 02 02 02 02 02 02 02 02 02 02
 02 00 00 00 02 00 00 02 40 00 58 04 53 57 24 59 24 57 00 00 00 00 00 00 00 00 00 02 43 40 57 06 02
 02 00 05 00 56 00 00 56 20 00 42 02 00 57 24 24 24 57 00 00 00 00 00 00 00 00 00 02 00 00 57 57 02
 02 00 00 00 56 00 00 56 00 00 42 02 00 57 24 24 24 57 00 00 00 00 00 00 00 00 00 04 58 58 00 22 02
 02 02 02 02 02 00 00 02 02 02 02 02 00 57 57 57 57 57 00 00 00 00 00 00 00 00 00 02 02 03 02 02 02
 02 00 00 00 00 00 00 00 00 00 00 00 00 00 00 59 00 00 00 00 00 00 00 13 00 00 00 00 00 00 00 00 02
 02 00 00 00 00 00 02 00 02 00 02 00 00 00 00 02 00 00 00 00 00 00 02 00 02 00 02 00 00 00 00 00 02
 02 00 00 00 00 00 00 00 00 00 00 00 00 00 00 02 00 00 00 00 00 00 00 00 00 00 00 00 00 00 00 00 02
 02 00 00 00 00 00 02 00 26 00 02 00 00 00 00 02 00 00 00 00 00 00 02 00 26 00 02 00 00 00 00 00 02
 02 00 00 00 00 00 00 00 00 00 00 00 00 00 00 02 00 00 00 00 00 00 00 00 00 00 00 00 00 00 00 00 02
 02 00 00 00 00 00 02 00 02 00 02 00 00 00 00 02 00 00 00 00 00 00 02 00 02 00 02 00 00 00 00 00 02
 02 00 00 00 00 00 00 00 00 13 00 00 00 00 02 02 02 00 00 00 00 00 00 00 00 00 00 00 00 00 00 00 02
 02 00 00 00 00 00 00 00 00 00 00 00 00 00 00 02 00 00 00 00 00 00 00 00 00 00 00 00 00 00 00 00 02
 02 00 00 00 00 00 00 00 00 00 00 00 00 02 00 02 00 02 00 00 00 00 00 00 00 00 00 00 00 00 00 00 02
 02 00 00 00 00 00 00 00 00 00 00 02 00 00 00 02 00 00 00 02 00 00 00 00 00 00 00 00 00 00 00 00 02
 02 20 02 02 02 02 02 02 02 02 02 02 02 02 02 32 02 02 02 02 02 02 02 02 02 02 02 02 02 02 02 20 02
 02 00 00 00 00 00 00 00 00 00 00 02 00 00 00 02 00 00 00 02 00 00 00 00 00 00 00 00 00 00 00 00 02
 02 00 00 00 00 00 00 00 00 00 00 00 00 02 00 02 00 02 00 00 00 00 00 00 00 00 00 00 00 00 00 00 02
 02 00 00 00 00 00 00 43 00 00 00 00 00 00 00 02 00 00 00 00 00 00 00 00 00 00 00 00 00 00 00 00 02
 02 00 00 00 00 00 00 00 00 00 00 00 00 00 02 02 02 00 00 00 00 00 00 00 00 00 00 00 53 00 00 00 02
 02 00 00 00 00 00 00 00 00 00 00 00 00 00 00 02 00 00 00 00 00 00 13 13 00 00 00 00 00 00 00 00 02
 02 00 00 00 00 00 02 00 02 00 02 00 00 00 00 02 00 00 00 00 00 00 02 00 02 00 02 00 00 00 00 00 02
 02 00 00 00 00 00 00 00 00 00 00 00 00 00 00 02 00 00 00 00 00 00 00 00 00 00 00 00 00 00 00 00 02
 02 00 00 00 13 13 02 00 26 00 02 00 00 00 00 02 00 00 00 00 00 00 02 00 26 00 02 00 00 00 00 00 02
 02 00 00 00 13 00 00 00 00 00 00 00 00 00 00 02 00 00 00 00 00 00 00 00 00 00 00 00 00 00 00 00 02
 02 00 00 00 00 00 02 00 02 00 02 00 00 00 00 02 00 00 00 00 00 00 02 00 02 00 02 00 00 00 00 00 02
 02 00 00 00 00 00 00 00 00 00 00 00 00 00 00 02 00 00 00 00 00 00 00 00 00 00 00 00 00 00 00 00 02
 02 00 00 00 00 00 00 00 00 00 00 00 00 00 00 02 00 00 00 45 00 00 00 00 00 00 00 00 00 00 00 00 02
 02 57 57 03 57 57 00 00 00 00 00 00 00 00 00 02 00 00 00 00 00 00 00 00 00 00 00 00 02 03 02 02 02
 02 40 00 58 58 04 00 00 00 00 00 00 00 00 00 02 00 00 00 00 00 00 00 00 00 00 00 00 04 58 00 22 02
 02 00 00 00 00 57 00 00 00 00 00 00 00 00 00 02 00 00 00 00 00 00 00 00 00 00 00 00 02 00 57 57 02
 02 06 00 24 53 57 00 00 00 00 00 00 00 00 00 20 00 00 00 00 00 00 00 00 00 00 00 00 02 40 57 06 02
 02 02 02 02 02 02 02 02 02 02 02 02 02 02 02 02 02 02 02 02 02 02 02 02 02 02 02 02 02 02 02 02 02
