Gauntlet (rev 1 - 9)
Maze number: 73
Offset for maze 72: 231046 - 0x038686
big endian buf: [%!l(uint8=0) %!l(uint8=3) %!l(uint8=134) %!l(uint8=134)]
G:1 Maze real addr: 255625 - 0x03E689, bank 3, boff: 0x6000
Maze read from: 0x03e689 - 255625
compresssed: 231
 10 38 01 02 80 20 AE 0D 68 9C 4E 06 80 70 80 CA
 42 64 1B C4 06 73 C1 1B C1 2A E3 42 C5 42 C5 1E
 70 C1 A5 61 A1 52 A5 1D 42 70 80 B2 0E 64 C6 A1
 C2 42 76 82 C6 55 28 C2 42 C6 A3 D1 43 C1 1E 62
 D4 1C 42 C0 A2 CC B2 C6 B3 C5 45 63 45 1C 42 60
 C8 45 DB 28 C3 43 C2 A4 C4 A4 28 C7 1C 43 CA 42
 C6 40 E4 CE 42 C6 40 1D 63 C8 A1 52 42 A0 53 B8
 C5 0C 82 C0 50 0C 83 A0 C1 B6 C2 1A A0 55 B4 C1
 BF 0C 82 B6 C1 0C 83 A0 C4 2C A0 2A A0 C0 42 6E
 E7 E2 42 C0 1D 61 D7 42 A5 D6 42 63 C1 A4 C7 57
 42 C0 41 65 C7 A4 C3 1D C4 41 DA A4 1D CA B5 64
 C2 56 41 DD 41 D6 B6 68 C7 A3 C6 42 C6 A3 D1 42
 C1 2A 71 82 28 D1 B2 C0 41 A4 0E 82 1B C2 05 CF
 41 74 82 D4 41 74 82 C0 BE 6B B5 2A 62 A0 51 A0
 28 C1 1E A0 C0 06 00
  Encoded length: 231 bytes
  Wall pattern: 00, Wall color: 14     Floor pattern: 02, Floor color: 10
  Flags: PLAYER_OFFSCREEN 
  ╚══> while gauntlet has these elements, these flags probably do not operate
 02 02 02 02 02 02 02 02 02 02 02 02 02 02 02 02 02 02 02 02 02 02 02 02 02 02 02 02 02 02 02 02 02
 02 06 00 14 14 00 00 00 00 00 00 00 00 00 00 00 13 13 13 00 00 00 00 00 40 27 00 00 00 00 00 06 02
 02 00 00 02 14 00 00 27 00 00 42 00 00 00 00 02 13 13 13 00 00 00 00 00 00 13 13 13 00 00 00 00 02
 02 00 30 02 14 00 00 02 02 02 02 02 02 00 00 40 02 02 28 00 00 00 02 02 02 02 02 02 29 13 13 13 02
 02 14 14 02 14 00 00 00 00 00 40 00 00 00 00 00 00 00 02 02 00 00 00 13 13 13 00 00 00 00 00 00 02
 02 14 14 14 14 00 00 00 00 00 00 00 28 00 00 00 00 00 00 40 02 00 00 13 13 13 00 00 00 00 00 00 02
 02 02 02 02 02 00 00 00 00 00 00 00 02 00 00 00 00 00 00 00 02 00 00 13 13 13 02 00 00 30 00 00 02
 02 40 00 00 00 00 00 00 00 00 00 00 02 00 00 00 00 00 00 00 02 00 00 28 13 13 02 00 02 02 02 00 02
 02 00 00 00 00 00 00 00 00 00 00 00 02 00 00 00 00 00 00 00 02 00 00 00 00 00 02 13 13 13 13 13 02
 02 00 00 00 00 40 13 13 13 13 13 13 28 13 13 13 02 40 00 00 00 00 00 00 00 00 02 13 13 13 13 13 02
 02 00 00 00 00 02 00 00 00 00 00 00 00 00 00 00 02 00 00 00 00 00 00 00 00 00 02 00 00 40 00 00 02
 02 00 13 13 13 02 00 00 00 02 02 02 02 02 00 00 02 00 00 02 02 02 02 02 40 00 02 00 00 02 00 00 02
 02 28 13 13 13 02 00 00 00 00 00 00 00 00 00 00 02 13 13 13 00 00 00 00 00 00 02 13 00 02 00 00 02
 02 02 00 00 00 02 00 00 00 00 00 00 00 00 00 00 02 13 13 13 00 00 00 00 00 00 02 13 29 02 00 00 02
 02 40 00 00 00 02 00 00 00 00 00 02 02 28 00 00 02 13 13 13 02 28 00 00 00 00 02 00 00 02 00 00 02
 02 12 12 12 12 02 28 00 12 12 12 12 12 02 00 00 02 00 00 00 26 02 28 00 00 00 00 00 00 02 00 00 02
 02 12 12 12 12 02 00 00 12 12 12 12 12 02 00 00 00 00 00 44 02 42 02 00 13 13 13 00 00 00 00 00 02
 02 00 00 00 00 00 00 00 00 00 40 00 00 00 00 00 00 00 00 02 00 00 00 02 13 13 13 00 29 00 00 40 02
 02 00 00 00 00 00 00 00 00 00 02 00 00 00 00 00 00 00 00 00 00 00 00 00 13 13 13 02 02 02 02 02 02
 02 00 00 00 00 00 00 00 00 00 02 00 00 00 00 00 00 00 00 00 00 02 00 00 13 13 13 00 00 00 00 40 02
 02 00 02 02 02 02 02 00 00 00 02 00 00 00 00 28 00 00 00 00 00 02 00 00 13 13 13 00 13 13 00 00 02
 02 00 00 00 40 00 00 00 00 00 02 00 00 02 02 02 02 02 00 00 00 02 29 00 00 00 00 00 13 13 00 00 02
 02 00 00 00 00 00 00 00 00 00 02 00 00 00 00 00 00 00 00 00 00 02 00 00 00 02 02 02 02 02 29 00 02
 02 00 00 00 00 00 00 00 00 00 02 00 00 00 00 00 40 00 00 00 28 02 00 00 00 00 00 00 13 13 00 00 02
 02 00 00 00 00 00 00 00 00 00 00 00 00 00 00 00 00 00 00 00 00 02 00 00 00 00 00 00 13 13 00 00 02
 02 00 00 00 00 00 00 00 00 00 00 00 00 00 00 00 00 00 00 00 00 02 00 00 00 00 00 00 00 00 00 40 02
 02 00 00 00 00 00 00 00 02 02 02 02 00 00 02 00 00 00 02 13 13 13 00 00 00 00 00 00 00 02 02 02 02
 02 00 00 00 00 00 00 00 00 00 00 00 00 00 02 00 00 00 02 13 13 13 00 00 42 00 00 14 14 14 14 40 02
 02 00 00 00 00 00 00 00 00 00 00 00 00 00 02 00 00 00 02 00 13 13 02 02 02 02 02 14 14 14 14 27 02
 02 00 00 05 00 00 00 00 00 00 00 00 00 00 02 00 00 00 00 00 13 13 00 00 00 00 00 14 14 14 14 00 02
 02 00 00 00 00 00 00 00 00 00 00 00 00 00 02 00 00 00 00 00 13 13 00 00 00 00 00 14 14 14 14 00 02
 02 00 00 00 00 00 00 00 00 00 00 00 00 40 02 42 00 00 00 40 02 28 00 00 02 40 00 00 30 02 00 06 02
 02 02 02 02 02 02 02 02 02 02 02 02 02 02 02 02 02 02 02 02 02 02 02 02 02 02 02 02 02 02 02 02 02
