Gauntlet (rev 1 - 9)
Maze number: 14
Offset for maze 13: 232685 - 0x038ced
big endian buf: [%!l(uint8=0) %!l(uint8=3) %!l(uint8=140) %!l(uint8=237)]
G:1 Maze real addr: 232688 - 0x038CF0, bank 0, boff: 0x0000
Maze read from: 0x038cf0 - 232688
compresssed: 209
 07 00 07 1B 00 14 27 68 51 4B 58 DE 18 DA A2 C0
 06 70 D6 2C C1 05 A3 5F A8 62 2A C2 1B CB 1B 81
 0B C3 35 12 63 12 C2 AB 52 80 C3 A1 B4 C1 B4 03
 81 C1 1B 42 DF DF 62 CD A6 68 21 A8 C5 35 C1 2A
 35 6B C2 2C C0 19 69 21 11 70 40 C1 2A 4A C6 0E
 D5 B8 A2 C4 1D 0E D4 11 C6 B5 0E 4C 66 21 11 45
 62 21 11 BF 6F 46 C1 B7 DB 28 41 C4 BF D3 A7 03
 C9 17 B8 17 49 1C 11 81 74 C7 17 27 A6 C3 A7 CA
 17 81 52 1B C4 35 28 11 21 11 48 59 81 C2 BC A9
 DD 28 DF D2 28 5E 80 CD A6 C8 1B 0B 40 49 C0 35
 2C 0E 80 C2 0E B3 C6 A9 C0 A3 B8 A7 1E 0E 73 40
 2A 40 24 C0 1B 0B 80 04 35 CC 0E 80 43 71 B2 52
 81 04 35 CE 0E 81 BE 28 BC 55 81 04 35 CF 0E 1D
 00
  Encoded length: 209 bytes
  Wall pattern: 04, Wall color: 07     Floor pattern: 01, Floor color: 02
  Flags: 
 02 02 02 02 02 02 02 02 02 02 02 02 02 02 02 02 02 02 02 02 02 02 02 02 02 02 02 02 02 02 02 02 02
 02 00 00 00 00 00 00 00 00 00 00 00 00 00 00 00 00 00 00 00 00 00 00 00 00 00 00 00 00 00 00 24 02
 02 00 00 00 00 00 00 00 00 00 00 00 00 00 00 00 00 00 00 00 00 00 00 00 00 00 02 02 02 02 00 06 02
 02 24 02 00 00 00 00 00 00 00 00 00 00 00 00 00 00 00 00 00 00 00 00 00 00 44 02 00 05 02 02 02 02
 02 00 02 00 00 00 00 00 00 00 00 00 00 00 00 00 00 11 02 02 02 02 02 02 02 02 02 00 00 02 17 42 02
 02 00 02 27 00 00 00 00 00 00 00 00 00 00 00 00 27 02 27 11 00 00 00 00 53 18 02 00 00 02 17 18 02
 02 00 02 02 02 02 02 02 02 02 02 02 02 02 02 00 00 02 11 11 00 00 00 00 02 02 02 00 00 02 03 03 02
 02 00 02 27 00 00 00 40 00 00 00 00 00 00 00 00 00 02 00 00 00 00 00 00 00 00 00 00 00 00 00 00 02
 02 00 02 00 00 00 00 00 00 00 00 00 00 00 00 00 00 02 00 00 00 00 00 00 00 00 00 00 00 00 00 00 02
 02 00 02 00 00 00 00 00 00 00 00 17 00 00 00 00 00 02 00 00 00 00 00 00 00 02 02 02 02 02 02 02 02
 02 00 02 00 00 00 00 00 00 00 17 33 02 02 02 02 02 02 02 02 02 00 02 00 00 02 00 53 02 00 42 53 02
 02 00 02 00 00 00 00 00 00 00 00 02 17 00 00 00 44 02 25 00 00 00 02 00 00 02 00 00 02 17 33 17 02
 02 24 02 40 00 00 42 00 00 00 00 02 00 00 00 00 00 02 40 00 00 00 02 00 00 02 14 00 02 00 00 00 02
 02 00 02 00 00 00 00 00 00 00 00 02 00 00 00 00 00 02 02 02 02 00 02 00 00 02 29 14 02 00 00 00 02
 02 00 02 00 00 00 00 00 00 00 00 02 00 00 00 00 00 17 00 00 00 00 02 00 00 02 14 00 02 00 00 00 02
 02 00 02 00 00 00 00 00 40 00 00 02 00 00 00 00 17 33 17 00 00 00 02 00 00 40 00 00 02 17 33 17 02
 02 00 02 00 00 00 00 00 00 00 00 02 00 00 00 00 00 17 00 00 00 00 02 00 00 40 00 00 02 00 00 00 02
 02 00 02 00 00 00 00 00 00 00 00 02 00 00 00 00 00 00 00 00 00 00 02 00 00 40 00 00 40 00 00 00 02
 02 00 02 00 00 00 00 00 00 00 00 02 00 00 00 00 00 00 00 00 00 00 02 02 02 02 02 02 02 02 02 03 02
 02 00 02 00 00 00 00 00 00 00 23 02 23 00 00 00 00 00 00 00 00 00 02 40 28 17 17 17 00 00 00 00 02
 02 24 02 00 00 00 00 00 00 00 23 39 02 02 02 02 02 02 02 00 00 00 02 02 02 02 02 02 02 02 02 00 02
 02 00 02 00 00 00 00 00 00 00 23 23 23 00 00 00 11 27 02 00 00 00 02 53 40 17 33 17 00 00 00 00 02
 02 00 02 00 00 40 00 00 00 00 00 00 00 00 00 00 11 11 02 00 00 00 02 02 02 02 02 02 02 02 02 02 02
 02 00 02 00 00 00 00 00 00 00 00 00 00 00 00 00 00 00 02 00 00 00 00 00 00 00 00 00 00 00 00 40 02
 02 00 02 00 00 00 00 00 00 00 00 00 00 00 00 00 00 00 02 00 00 00 00 00 00 00 00 02 00 00 00 00 02
 02 00 02 00 00 00 00 00 00 00 00 00 00 00 00 00 00 00 02 40 00 00 00 00 00 00 00 02 00 00 00 00 02
 02 00 02 11 11 00 00 00 00 00 00 00 00 00 00 00 00 00 02 02 02 02 02 02 02 02 00 02 00 00 00 00 02
 02 00 02 27 11 00 40 00 00 00 00 00 00 00 00 00 00 40 02 53 44 14 14 00 00 00 14 02 00 00 00 00 02
 02 00 02 02 02 02 02 02 02 02 02 02 02 00 02 02 02 02 02 02 02 02 02 02 02 02 02 30 14 00 00 00 02
 02 24 02 40 42 02 40 36 00 27 11 11 04 53 00 00 00 00 00 00 00 00 00 00 00 00 00 14 14 00 00 00 02
 02 40 02 00 24 02 00 00 00 11 11 11 04 53 00 00 00 00 00 00 00 00 00 00 00 00 00 00 00 14 14 14 02
 02 40 02 00 00 00 00 00 00 11 11 11 04 53 00 00 00 00 00 00 00 00 00 00 00 00 00 00 00 00 14 29 02
 02 02 02 02 02 02 02 02 02 02 02 02 02 02 02 02 02 02 02 02 02 02 02 02 02 02 02 02 02 02 02 02 02
