Gauntlet (rev 1 - 9)
Maze number: 17
Offset for maze 16: 233666 - 0x0390c2
big endian buf: [%!l(uint8=0) %!l(uint8=3) %!l(uint8=144) %!l(uint8=194)]
G:1 Maze real addr: 233669 - 0x0390C5, bank 0, boff: 0x0000
Maze read from: 0x0390c5 - 233669
compresssed: 384
 0E 2D 07 1A 00 00 17 68 D1 5B 4E 2C 80 C0 21 28
 44 C1 21 A0 CB 2A A0 1B 50 43 44 E2 E2 E4 1B 80
 C7 11 A6 1B E2 28 A0 12 A1 C0 A1 C0 A3 43 81 C2
 0A E5 E2 E1 44 21 A1 03 C8 0A E3 C0 1E E0 C1 21
 C1 35 42 50 45 2A 28 43 A0 E1 C0 21 A0 7C 81 43
 C0 0A E2 C3 11 C1 A4 C1 B3 1B 71 81 C1 05 41 E3
 C0 1E 28 60 51 2A 1B 80 A0 E2 71 80 B5 C7 03 A0
 E1 C0 B2 11 C0 B3 51 54 71 60 A0 C5 B6 21 41 41
 E0 40 56 2A 70 C0 21 11 A1 E2 11 80 E5 42 A1 C0
 A2 72 B2 11 A0 0E C0 35 E0 11 E1 B2 A3 C2 A1 C0
 21 A0 E2 C1 35 11 A0 C2 11 60 E1 E7 C3 04 C2 1E
 E5 E0 11 E1 C1 A1 E9 C2 1E C5 11 60 C0 A3 28 C1
 A1 C5 A1 40 C3 BF C0 B2 E3 E1 11 24 A1 C2 A2 46
 C4 11 A0 E0 E1 E1 11 A0 21 A1 CB B8 E0 C2 11 60
 C1 A1 E1 41 C0 A1 55 A2 C1 1E E6 40 E0 42 49 C3
 1E A1 E3 E2 C3 A2 C2 06 80 50 C0 2A C3 A1 2A A0
 E1 E2 C0 21 E1 11 C1 A1 B7 A1 B5 A4 E0 11 C0 20
 C0 A1 E2 20 41 A0 C1 20 49 E0 11 23 C2 04 40 E0
 35 A0 40 C3 A1 47 E2 11 C2 04 E1 C0 20 E0 C4 20
 C3 B3 C0 27 80 A2 C2 A1 28 81 42 40 C1 03 80 B2
 C0 20 E4 E4 EA C5 A1 C5 A3 EB 1B 80 C1 20 E7 41
 1E C1 1E 54 B3 E1 1B 51 B3 C6 2A 60 A0 40 C3 B2
 74 A1 18 A0 03 80 A0 1B A5 B5 60 1C 11 A5 18 74
 81 35 CC A2 1B C7 BE 2C 28 0E 82 35 D0 2A C5 00
  Encoded length: 384 bytes
  Wall pattern: 00, Wall color: 07     Floor pattern: 00, Floor color: 01
  Flags: 
 02 02 02 02 02 02 02 02 02 02 02 02 02 02 02 02 02 02 02 02 02 02 02 02 02 02 02 02 02 02 02 02 02
 02 44 00 33 40 00 00 00 00 00 40 00 00 33 02 00 00 00 00 00 00 00 00 00 00 00 00 42 02 27 00 27 02
 02 00 00 00 40 00 00 00 00 00 40 00 00 00 02 00 00 00 02 00 00 00 00 00 02 27 27 00 00 00 00 00 02
 02 00 00 17 02 02 02 02 02 02 02 27 00 00 00 02 40 02 18 02 02 00 02 02 00 02 02 02 02 00 00 00 02
 02 40 40 02 00 00 00 10 00 00 00 02 00 00 02 00 00 00 02 00 00 02 00 00 00 00 00 40 33 02 02 03 02
 02 00 00 02 00 00 00 00 00 10 00 02 00 00 02 00 30 00 02 00 00 33 00 00 53 00 00 00 40 02 27 00 02
 02 00 00 02 00 40 42 40 00 00 00 02 40 02 00 00 02 00 33 02 00 02 00 00 00 00 00 00 00 02 00 00 02
 02 14 14 02 00 00 00 00 40 00 10 02 00 00 02 00 00 00 02 17 00 02 02 02 02 02 02 00 00 02 27 00 02
 02 14 14 02 00 00 05 00 00 40 00 02 00 00 02 00 30 40 02 17 00 02 27 42 27 27 02 00 00 00 02 00 02
 02 14 14 02 00 00 00 00 00 00 00 02 03 02 00 00 02 00 02 17 00 02 00 00 27 00 00 00 00 02 27 00 02
 02 14 02 17 02 00 00 00 00 00 00 02 33 00 02 40 00 00 40 00 02 00 40 00 00 00 00 00 00 02 27 42 02
 02 14 02 33 17 02 02 00 00 00 02 17 17 00 02 00 00 00 00 02 00 00 00 40 02 02 00 02 02 02 00 00 02
 02 14 02 17 02 14 00 53 00 02 17 00 00 02 02 02 02 02 02 00 00 00 02 02 00 33 02 00 00 02 02 00 02
 02 53 17 02 00 00 00 17 02 17 00 00 02 00 00 00 00 00 00 00 00 02 00 00 00 00 04 00 00 02 30 00 02
 02 00 02 00 00 02 00 02 17 00 00 02 00 00 02 02 00 00 00 00 02 00 00 00 00 00 02 00 00 02 30 00 02
 02 00 02 00 00 17 02 17 00 02 02 02 02 40 00 00 02 02 00 00 02 00 00 00 02 02 00 40 00 02 00 00 02
 02 00 02 00 00 00 00 02 00 00 02 17 36 02 02 00 00 00 02 02 02 00 00 02 00 00 00 00 40 02 00 00 02
 02 00 17 02 00 02 00 00 02 00 00 02 17 02 33 02 02 00 00 00 02 00 00 02 00 00 00 00 00 02 00 02 02
 02 00 00 17 02 17 00 00 02 02 00 00 02 00 00 40 00 02 02 00 02 00 00 02 00 27 02 02 02 00 00 30 02
 02 00 00 00 00 00 00 02 00 40 00 02 00 00 00 40 00 00 00 00 02 00 00 02 00 00 40 00 00 00 00 30 02
 02 02 00 00 00 00 02 00 00 00 02 00 00 00 00 02 02 02 00 00 02 06 06 02 27 00 42 00 00 00 00 02 02
 02 42 02 00 00 02 00 00 00 02 00 33 00 00 02 17 00 00 02 02 02 02 02 02 02 02 02 02 02 00 02 17 02
 02 32 00 02 02 00 00 00 02 32 00 00 40 02 00 00 32 00 00 00 00 02 00 00 00 00 00 40 00 02 17 35 02
 02 00 00 04 00 40 00 02 53 02 00 40 00 00 02 00 02 02 00 00 00 02 00 00 00 00 40 00 00 00 02 17 02
 02 00 00 04 00 00 02 00 32 00 02 00 00 00 02 00 32 00 02 00 00 02 00 39 39 02 02 02 00 00 00 02 02
 02 40 40 02 00 00 00 40 00 40 00 02 03 03 02 00 32 00 02 00 00 00 02 00 00 00 00 00 02 00 00 00 02
 02 00 00 02 00 00 00 00 02 00 00 02 00 00 00 02 02 00 02 00 00 00 00 02 02 02 02 00 00 02 00 00 02
 02 00 00 02 00 00 00 02 27 27 00 02 32 00 00 00 00 00 02 00 00 02 00 00 40 30 00 00 30 02 00 00 02
 02 00 27 02 00 00 02 27 00 00 27 02 00 00 00 00 00 00 02 42 02 17 02 00 40 00 00 00 00 02 00 00 02
 02 00 00 14 02 02 24 02 03 03 02 27 02 02 02 02 02 02 02 02 17 28 17 02 02 02 02 02 02 24 00 00 02
 02 00 00 14 14 14 53 00 00 00 00 00 00 00 00 00 00 00 00 00 02 02 02 27 00 00 00 00 00 00 00 00 02
 02 44 40 14 14 14 14 53 00 00 00 00 00 00 00 00 00 00 00 00 00 00 00 00 00 42 00 00 00 00 00 00 02
 02 02 02 02 02 02 02 02 02 02 02 02 02 02 02 02 02 02 02 02 02 02 02 02 02 02 02 02 02 02 02 02 02
