Gauntlet (rev 1 - 9)
Maze number: 3
Offset for maze 2: 230304 - 0x0383a0
big endian buf: [%!l(uint8=0) %!l(uint8=3) %!l(uint8=131) %!l(uint8=160)]
G:1 Maze real addr: 230307 - 0x0383A3, bank 0, boff: 0x0000
Maze read from: 0x0383a3 - 230307
compresssed: 101
 00 00 00 00 00 10 13 59 5A 68 6A DE 35 DF C4 05
 57 41 E1 41 DF DF E2 60 D7 2A FA 55 E0 60 DF D2
 28 41 DF E7 F9 DF D9 2A D0 A1 E8 E4 40 D3 28 D1
 BF F5 4C E5 42 EB E9 DF 71 57 61 4D F3 60 EB 41
 EA EA DF E8 EC 56 EF 61 EF DF E0 61 E6 6C 53 DF
 D0 A4 F1 50 C0 1B C3 04 EA 60 D0 04 E0 03 BE 35
 D9 04 E0 06 00
  Encoded length: 101 bytes
  Wall pattern: 00, Wall color: 03     Floor pattern: 01, Floor color: 01
  Flags: 
 02 02 02 02 02 02 02 02 02 02 02 02 02 02 02 02 02 02 02 02 02 02 02 02 02 02 02 02 02 02 02 02 02
 02 00 00 00 00 00 00 00 00 00 00 00 00 00 00 00 00 00 00 00 00 00 00 00 00 00 00 00 00 00 00 53 02
 02 00 00 00 00 00 00 00 00 00 00 00 00 00 00 00 00 00 00 00 00 00 00 00 00 00 00 00 00 00 00 00 02
 02 00 00 00 00 05 00 00 00 00 00 00 00 00 40 00 00 25 00 00 02 00 00 25 00 00 00 00 00 00 00 00 02
 02 00 00 00 00 00 00 00 00 00 00 00 00 00 00 00 00 00 00 00 00 00 00 00 00 00 00 00 00 00 00 00 02
 02 00 00 00 00 00 00 00 00 00 00 00 00 00 00 00 00 00 00 00 00 00 00 00 00 00 00 02 00 26 00 00 02
 02 00 00 00 00 00 00 00 00 00 00 00 00 00 00 00 00 00 00 00 00 00 42 00 00 00 00 00 00 00 00 00 02
 02 00 00 00 00 00 00 00 00 00 00 00 00 00 00 00 00 00 02 00 00 00 00 00 00 40 00 02 00 26 00 00 02
 02 00 00 00 00 00 00 00 00 00 00 00 00 00 00 00 00 00 00 00 00 00 00 00 00 00 00 00 00 00 00 00 02
 02 00 00 00 00 00 00 00 00 00 00 00 00 00 00 00 00 40 00 00 25 00 00 00 00 00 00 00 00 00 00 00 02
 02 00 00 00 00 00 00 00 00 00 00 00 00 00 00 00 00 00 00 00 00 00 00 00 00 00 00 00 00 02 00 00 02
 02 00 00 00 00 00 00 00 00 00 00 00 00 00 00 00 00 00 00 00 00 00 00 00 02 00 00 00 00 00 00 00 02
 02 00 00 00 00 00 00 00 00 00 00 00 00 00 00 00 00 00 00 00 00 00 00 00 00 00 00 00 00 00 00 00 02
 02 00 00 00 00 00 00 00 00 00 00 00 00 00 00 00 00 00 00 42 00 00 00 00 00 00 00 00 00 00 00 00 02
 02 00 00 00 00 02 02 00 00 00 00 00 00 00 00 00 02 00 00 00 00 00 02 00 25 00 00 00 00 00 00 00 02
 02 00 00 00 00 00 00 00 00 00 00 00 00 40 00 00 00 00 00 00 00 00 00 00 00 00 00 00 00 00 00 00 02
 02 00 00 00 00 00 00 00 00 00 00 00 00 00 00 00 00 00 00 00 00 00 00 02 00 00 00 00 00 00 00 00 02
 02 00 00 00 00 25 00 00 00 00 00 00 02 00 00 00 25 00 00 00 00 00 00 00 00 00 00 00 00 02 00 00 02
 02 00 00 00 00 00 00 00 02 00 00 00 00 00 00 00 00 00 00 00 00 00 00 00 00 00 00 00 00 00 00 00 02
 02 00 00 00 00 00 00 00 00 00 00 42 00 00 00 00 00 00 00 00 40 00 00 26 00 00 00 00 00 00 00 00 02
 02 00 00 00 00 00 25 00 00 00 00 00 00 00 00 00 00 00 00 00 00 00 00 00 00 00 00 02 00 26 00 00 02
 02 00 00 00 00 00 00 00 00 00 02 00 00 25 00 00 00 00 00 00 00 00 00 00 00 02 00 00 00 00 00 00 02
 02 00 00 00 00 02 00 00 00 00 00 00 00 00 00 00 00 00 00 00 00 00 00 00 00 00 00 00 00 00 00 00 02
 02 00 00 00 00 00 00 00 00 00 00 00 00 00 00 02 00 00 00 00 00 00 00 00 00 00 00 00 00 02 00 00 02
 02 00 00 00 00 40 00 00 00 00 00 00 00 00 00 00 00 00 00 00 00 00 02 00 00 26 00 00 00 00 00 00 02
 02 00 00 00 00 00 00 00 00 00 02 00 00 00 00 00 00 00 00 00 00 00 00 00 00 00 00 00 00 00 00 00 02
 02 00 00 00 00 00 00 00 00 00 00 00 02 00 00 26 00 00 00 00 00 00 00 02 00 00 00 00 00 00 00 00 02
 02 00 00 00 00 26 00 00 00 00 40 00 00 00 00 00 00 00 00 00 00 00 00 00 00 00 00 00 00 00 00 00 02
 02 00 00 00 00 00 00 00 00 00 00 00 00 00 00 00 00 00 00 00 00 00 00 00 00 00 00 00 02 02 02 02 02
 02 00 00 00 00 00 00 00 00 00 00 00 00 00 00 00 00 00 00 02 00 40 00 27 00 00 00 00 04 00 00 00 02
 02 00 00 00 00 00 00 00 02 00 26 00 00 00 00 00 00 00 00 00 00 00 00 00 00 00 00 00 04 00 02 03 02
 02 53 00 00 00 00 00 00 00 00 00 00 00 00 00 00 00 00 00 00 00 00 00 00 00 00 00 00 04 00 02 06 02
 02 02 02 02 02 02 02 02 02 02 02 02 02 02 02 02 02 02 02 02 02 02 02 02 02 02 02 02 02 02 02 02 02
