Gauntlet (rev 1 - 9)
Maze number: 63
Offset for maze 62: 235451 - 0x0397bb
big endian buf: [%!l(uint8=0) %!l(uint8=3) %!l(uint8=151) %!l(uint8=187)]
G:1 Maze real addr: 243646 - 0x03B7BE, bank 1, boff: 0x2000
Maze read from: 0x03b7be - 243646
compresssed: 210
 00 00 00 00 00 30 06 68 60 D9 5D 20 80 28 2A 69
 C0 06 60 C7 18 62 C5 18 E2 2C E3 E4 E3 E9 E3 E2
 E0 C1 2C A0 E3 19 A0 E7 19 A0 E3 2A A0 35 C0 35
 A0 2A A0 E3 E2 E5 E2 C2 19 A0 E4 19 D5 19 A0 E6
 19 C4 B2 44 C3 B2 E3 E8 4A E7 EA 47 40 E6 61 E2
 62 E1 46 E7 E5 28 A0 E5 2A 44 E6 41 E2 E2 42 E1
 CA 19 A0 E5 E4 E5 19 C7 19 A0 61 E2 E6 62 E1 19
 E6 E5 E8 E5 E5 41 E2 EA 42 E1 C1 BF 03 A0 E5 C5
 05 E5 E5 03 41 43 A0 28 4C A0 28 43 42 C3 A8 C1
 A7 43 CE 26 C2 26 DF DF D2 1D E0 EE 70 EB 4C E2
 79 E0 F2 70 E7 C7 A1 28 A1 E7 75 E0 E7 19 40 50
 A0 E7 70 E3 E7 C0 19 B9 C0 B9 19 2A A0 E7 E3 EA
 E2 46 E2 ED E4 4C A0 E8 E6 CA BE 28 A0 69 64 49
 C0 00
  Encoded length: 210 bytes
  Wall pattern: 00, Wall color: 06     Floor pattern: 03, Floor color: 00
  Flags: 
 02 02 02 02 02 02 02 02 02 02 02 02 02 02 02 02 02 02 02 02 02 02 02 02 02 02 02 02 02 02 02 02 02
 02 32 40 42 00 00 00 00 00 00 00 00 00 00 32 00 06 00 32 00 00 00 00 00 00 00 00 24 00 00 00 32 02
 02 00 00 00 00 00 24 00 00 00 02 44 00 00 00 00 02 00 00 00 00 00 02 00 00 00 00 02 00 00 00 00 02
 02 00 00 00 00 00 02 00 00 00 00 02 00 00 00 02 00 02 00 00 44 02 00 00 00 00 02 25 02 00 00 00 02
 02 00 00 00 00 02 25 02 00 00 00 00 02 42 02 53 00 53 02 42 02 00 00 00 00 02 00 02 00 02 00 00 02
 02 00 00 00 02 00 02 00 02 00 00 00 25 02 00 00 00 00 00 02 25 00 00 00 00 00 00 02 00 00 00 00 02
 02 00 00 00 00 00 02 00 00 00 00 25 02 00 00 00 00 00 00 00 02 25 00 00 00 00 00 02 00 00 00 00 02
 02 40 00 00 00 00 02 00 00 00 00 02 00 00 00 00 00 00 00 00 00 02 00 00 00 00 00 00 00 00 00 00 02
 02 40 00 00 00 00 00 00 00 00 02 00 00 00 00 00 00 00 00 00 00 00 02 00 00 00 00 00 00 00 00 40 02
 02 40 00 00 00 00 00 00 00 02 00 00 32 00 00 00 02 00 00 00 32 00 00 02 00 00 00 00 00 00 00 40 02
 02 00 00 00 00 00 00 00 02 00 00 00 00 00 00 02 40 02 00 00 00 00 00 00 02 42 00 00 00 00 00 40 02
 02 00 00 00 00 00 00 02 00 00 40 00 00 00 02 00 00 00 02 00 00 00 40 00 00 02 00 00 00 00 00 00 02
 02 00 00 00 00 25 02 00 00 00 00 00 00 02 00 00 00 00 00 02 00 00 00 00 00 00 02 25 00 00 00 00 02
 02 00 00 00 25 02 00 00 32 00 00 00 02 00 00 00 00 00 00 00 02 00 00 00 32 00 00 02 25 00 00 00 02
 02 00 00 00 02 00 00 00 00 00 00 02 00 00 00 00 00 00 00 00 00 02 00 00 00 00 00 00 02 00 00 00 02
 02 00 00 02 00 00 40 00 00 00 02 00 00 00 00 00 00 00 00 00 00 00 02 00 00 00 40 00 00 02 00 00 02
 02 03 02 00 00 00 00 00 00 02 00 00 00 00 00 00 05 00 00 00 00 00 00 02 00 00 00 00 00 00 02 03 02
 02 00 40 00 00 00 00 40 02 40 00 00 00 00 00 00 00 00 00 00 00 00 00 40 02 40 00 00 00 00 40 00 02
 02 00 40 00 00 00 00 02 02 02 02 02 02 02 02 02 00 02 02 02 02 02 02 02 02 02 00 00 00 00 40 00 02
 02 00 00 00 00 00 00 00 00 00 00 00 00 00 38 02 00 02 38 00 00 00 00 00 00 00 00 00 00 00 00 00 02
 02 00 00 00 00 00 00 00 00 00 00 00 00 00 00 02 00 02 00 00 00 00 00 00 00 00 00 00 00 00 00 00 02
 02 00 00 00 00 00 00 00 00 00 00 00 00 00 00 02 00 02 00 00 00 00 00 00 00 00 00 00 00 00 00 00 02
 02 00 00 00 00 00 29 00 02 00 00 00 00 00 00 02 00 02 00 00 00 00 00 00 02 00 29 00 00 00 00 00 02
 02 00 00 00 00 00 00 02 00 00 00 00 00 00 00 02 00 02 00 00 00 40 00 00 00 02 00 00 00 00 00 00 02
 02 00 00 00 29 00 02 00 00 00 00 00 00 00 00 02 00 02 00 00 00 00 00 00 00 00 02 00 29 00 00 00 02
 02 00 00 00 00 02 00 00 00 00 00 00 00 00 02 02 40 02 02 00 00 00 00 00 00 00 00 02 00 00 00 00 02
 02 00 29 00 02 00 00 00 00 00 00 00 00 02 25 02 40 02 25 02 00 00 00 00 00 00 00 00 02 00 29 00 02
 02 00 00 02 00 00 00 00 00 00 00 00 02 00 25 02 00 02 25 42 02 00 00 00 00 00 00 00 00 02 00 00 02
 02 00 02 00 00 00 00 00 00 00 00 00 00 00 02 00 00 00 02 00 00 00 00 00 00 00 40 00 00 00 02 00 02
 02 00 00 00 00 00 00 00 00 00 00 00 00 02 00 00 00 00 00 02 00 00 00 00 00 00 00 00 00 00 00 00 02
 02 40 02 00 00 00 00 00 00 00 00 00 02 00 00 00 00 00 00 00 02 00 00 00 00 00 00 00 00 00 00 00 02
 02 40 02 00 00 00 00 00 00 00 00 00 00 32 00 00 00 00 00 32 00 00 00 00 00 00 00 00 00 00 40 00 02
 02 02 02 02 02 02 02 02 02 02 02 02 02 02 02 02 02 02 02 02 02 02 02 02 02 02 02 02 02 02 02 02 02
