Gauntlet (rev 1 - 9)
Maze number: 70
Offset for maze 69: 237001 - 0x039dc9
big endian buf: [%!l(uint8=0) %!l(uint8=3) %!l(uint8=157) %!l(uint8=201)]
G:1 Maze real addr: 245196 - 0x03BDCC, bank 1, boff: 0x2000
Maze read from: 0x03bdcc - 245196
compresssed: 178
 00 00 00 00 80 21 13 03 68 04 5D 1D 80 73 C7 2A
 7A 80 C0 2A 06 DF C3 4F 48 71 C0 2A C2 19 CD 19
 79 C4 35 C4 19 62 67 C1 19 74 DF C4 4F 42 CA 2B
 C1 1F 35 C5 1F C0 2C C4 1F 61 DF 62 C9 4C 69 C8
 25 C8 25 CE 19 D1 28 C1 19 6B C4 45 CC 2C CB 35
 DF D0 BF 63 C4 2B C3 05 69 CB 1F CE 1F D3 55 D5
 5F C7 45 55 C7 5F C7 19 D1 2B 67 C7 5A 25 61 C4
 35 25 5A C3 19 C2 2A C9 4C 77 C6 5F D0 5F 60 C2
 2A 64 C0 04 1F C2 2E C2 1F 62 C2 1F CD 4F 41 51
 DF 76 C2 19 63 C0 19 63 C2 19 C3 35 19 57 73 C1
 58 4F 47 DF DF C2 BE 06 71 80 61 C3 2C 76 C7 2A
 1D 00
  Encoded length: 178 bytes
  Wall pattern: 01, Wall color: 03     Floor pattern: 02, Floor color: 01
  Flags: PLAYER_OFFSCREEN 
  ╚══> while gauntlet has these elements, these flags probably do not operate
 02 02 02 02 02 02 02 02 02 02 02 02 02 02 02 02 02 02 02 02 02 02 02 02 02 02 02 02 02 02 02 02 02
 02 29 00 00 00 00 29 00 00 00 00 00 00 00 00 42 00 00 00 00 00 00 00 00 00 00 00 29 29 00 42 06 02
 02 00 00 00 00 00 00 00 00 00 00 00 00 00 00 00 00 00 00 00 00 00 00 00 00 00 00 00 00 00 00 00 02
 02 00 00 00 03 03 03 03 03 03 03 03 03 03 03 03 03 03 03 03 03 03 03 03 03 03 03 03 03 00 00 29 02
 02 42 00 00 04 25 00 00 00 00 00 00 00 00 00 00 00 00 00 00 25 00 00 00 00 00 00 00 04 00 00 29 02
 02 00 00 00 04 53 00 00 00 00 00 25 00 00 00 40 00 00 00 00 00 00 00 00 40 00 00 25 04 00 00 00 02
 02 29 00 00 04 00 00 00 00 00 00 00 00 00 00 00 00 00 00 00 00 00 00 00 00 00 00 00 04 00 00 00 02
 02 00 00 00 04 00 00 03 03 03 03 03 03 03 03 03 03 03 03 03 03 03 03 03 03 03 00 00 04 00 00 00 02
 02 00 00 00 04 43 00 04 31 53 00 00 00 00 00 00 31 00 44 00 00 00 00 00 31 04 00 40 04 00 00 00 02
 02 00 00 00 04 00 00 04 00 00 00 00 00 00 00 00 00 00 00 00 00 00 00 00 00 04 00 00 04 00 00 40 02
 02 00 00 00 04 00 00 04 00 00 03 03 03 03 03 03 03 03 03 03 03 03 03 00 00 04 00 00 04 00 00 00 02
 02 40 00 00 04 00 00 04 00 00 04 37 00 00 00 00 00 00 00 00 00 37 04 00 00 04 00 00 04 00 00 00 02
 02 00 00 00 04 25 00 04 00 00 04 00 00 00 00 00 00 00 00 00 00 00 04 00 40 04 00 25 04 00 00 00 02
 02 00 00 00 04 00 00 04 40 00 04 00 00 04 03 03 03 03 03 03 00 00 04 00 00 04 00 00 04 00 00 00 02
 02 44 00 00 04 00 00 04 00 00 04 00 00 04 53 00 00 00 00 04 00 00 04 00 00 04 00 00 04 00 00 00 02
 02 00 00 00 04 00 00 04 00 00 04 00 00 04 00 00 00 00 00 04 00 00 04 00 00 04 00 00 04 00 00 00 02
 02 00 00 00 04 40 00 04 00 00 04 43 00 04 00 00 05 00 00 04 00 00 04 00 00 04 00 40 04 00 00 00 02
 02 00 00 00 04 00 00 04 31 00 04 00 00 04 00 00 00 00 00 04 00 00 04 00 31 04 00 00 04 00 00 00 02
 02 00 00 00 04 00 00 04 00 00 04 00 00 04 00 00 00 00 00 04 00 00 04 00 00 04 00 00 04 00 00 00 02
 02 00 00 00 04 00 00 04 00 00 04 00 00 03 03 03 03 03 03 04 00 00 04 00 00 04 00 00 04 00 00 00 02
 02 00 00 00 04 25 00 04 00 00 04 00 00 00 00 00 00 00 00 00 00 00 04 00 43 04 00 00 04 00 00 00 02
 02 40 00 00 04 00 00 04 00 00 04 37 00 00 40 00 00 00 00 00 53 37 04 00 00 04 00 25 04 00 00 42 02
 02 00 00 00 04 00 00 04 00 00 03 03 03 03 03 03 03 03 03 03 03 03 03 00 00 04 00 00 04 00 00 29 02
 02 00 00 00 04 00 00 04 00 00 00 00 00 00 00 00 00 00 00 00 00 00 00 00 00 04 00 40 04 00 00 42 02
 02 00 00 00 04 40 00 04 31 00 00 00 46 00 00 00 31 00 00 00 40 00 00 00 31 04 00 00 04 00 00 00 02
 02 00 00 00 04 00 00 03 03 03 03 03 03 03 03 03 03 03 03 03 03 03 03 03 03 04 00 00 04 00 00 00 02
 02 00 00 00 04 00 00 00 00 00 00 00 00 00 00 00 00 00 00 00 00 00 00 00 00 00 00 00 04 00 00 00 02
 02 29 00 00 04 25 00 00 00 00 40 00 25 00 00 00 00 40 00 00 00 25 00 00 00 00 53 25 04 00 00 00 02
 02 29 00 00 04 03 03 03 03 03 03 03 03 03 03 03 03 03 03 03 03 03 03 03 03 03 03 03 03 00 00 00 02
 02 00 00 00 00 00 00 00 00 00 00 00 00 00 00 00 00 00 00 00 00 00 00 00 00 00 00 00 00 00 00 00 02
 02 00 00 00 00 00 00 00 00 00 00 00 00 00 00 00 00 00 00 00 00 00 00 00 00 00 00 00 00 00 00 00 02
 02 06 00 00 29 29 00 00 40 00 00 00 00 44 00 00 00 00 00 00 00 29 00 00 00 00 00 00 00 00 42 29 02
 02 02 02 02 02 02 02 02 02 02 02 02 02 02 02 02 02 02 02 02 02 02 02 02 02 02 02 02 02 02 02 02 02
