Gauntlet (rev 1 - 9)
Maze number: 108
Offset for maze 107: 234763 - 0x03950b
big endian buf: [%!l(uint8=0) %!l(uint8=3) %!l(uint8=149) %!l(uint8=11)]
G:1 Maze real addr: 251150 - 0x03D50E, bank 2, boff: 0x4000
Maze read from: 0x03d50e - 251150
compresssed: 149
 00 00 00 00 00 52 6F 5E AA 04 28 1E 80 DC 1E DF
 45 6F C0 2A 1E CA 6F C2 6F D7 1E D8 1E C4 6F C8
 69 1E 4E CF 03 8D D2 35 C1 1D C3 19 E1 F3 E8 35
 D4 A1 E5 D4 19 C1 03 85 A0 C0 1B D6 35 C2 35 C9
 1A C4 1A D7 72 C2 BF C2 72 CA 05 DB 53 35 C2 35
 53 D5 1D E1 03 84 C1 19 CB 1A C7 A1 C4 A1 C7 1A
 C5 72 C4 35 A0 E8 C0 5A C3 72 EC C1 1B C4 1C C0
 35 A1 D0 5C 03 8A A1 4F 4E DF C9 28 D8 28 C4 1A
 28 D6 28 1A DA 28 DD 28 1A CA 1A 6F DF C6 28 C0
 BE 06 DC 1E 00
  Encoded length: 149 bytes
  Wall pattern: 02, Wall color: 15     Floor pattern: 05, Floor color: 06
  Flags: 
 02 02 02 02 02 02 02 02 02 02 02 02 02 02 02 02 02 02 02 02 02 02 02 02 02 02 02 02 02 02 02 02 02
 02 30 00 00 00 00 00 00 00 00 00 00 00 00 00 00 00 00 00 00 00 00 00 00 00 00 00 00 00 00 00 30 02
 02 00 00 00 00 00 00 00 00 00 00 00 00 00 00 00 00 00 00 00 00 00 00 00 00 00 00 00 00 00 00 00 02
 02 00 00 00 00 00 30 42 00 00 00 00 00 00 00 00 00 00 00 00 00 00 00 00 00 42 30 00 00 00 00 00 02
 02 00 00 00 00 00 42 00 00 00 00 00 00 00 00 00 00 00 00 00 00 00 00 00 00 00 42 00 00 00 00 00 02
 02 00 00 00 00 00 00 00 00 00 00 00 00 00 00 00 00 00 00 00 00 00 00 00 00 00 00 00 00 00 00 00 02
 02 00 00 30 00 00 00 00 00 00 00 00 00 00 00 00 00 00 00 00 00 00 00 00 00 00 00 00 00 30 00 00 02
 02 00 00 42 00 00 00 00 00 00 00 00 00 00 00 00 00 00 00 00 00 00 00 00 00 00 00 00 00 42 00 00 02
 02 00 00 00 00 00 00 00 30 00 00 00 00 00 00 00 00 00 00 00 00 00 00 00 30 00 00 00 00 00 00 00 02
 02 00 00 00 00 00 00 00 00 03 03 03 03 03 03 03 03 03 03 03 03 03 03 03 00 00 00 00 00 00 00 00 02
 02 00 00 00 00 00 00 00 00 04 00 53 00 00 29 00 00 00 00 25 00 00 02 04 00 00 00 00 00 00 00 00 02
 02 00 00 00 00 00 00 00 00 04 00 02 00 00 00 00 00 00 00 00 00 02 53 04 00 00 00 00 00 00 00 00 02
 02 00 00 00 00 00 00 00 00 04 00 00 02 02 00 00 00 00 00 00 02 00 00 04 00 00 00 00 00 00 00 00 02
 02 00 00 00 00 00 00 00 00 04 25 00 00 03 03 03 03 03 03 03 02 00 27 04 00 00 00 00 40 00 00 00 02
 02 00 00 00 40 00 00 00 00 04 00 00 00 04 53 00 00 00 53 04 00 00 00 04 00 00 00 00 40 26 00 00 02
 02 00 00 26 40 00 00 00 00 04 00 00 00 04 00 00 00 00 00 04 00 00 00 04 00 00 00 00 40 00 00 00 02
 02 00 00 00 40 00 00 00 00 04 00 00 00 04 00 00 05 00 00 04 00 00 00 04 00 00 00 00 00 00 00 00 02
 02 00 00 00 00 00 00 00 00 04 00 00 00 04 53 00 00 00 53 04 00 00 00 04 00 00 00 00 00 00 00 00 02
 02 00 00 00 40 00 00 00 00 04 29 00 00 02 03 03 03 03 03 03 00 00 25 04 00 00 00 00 40 00 00 00 02
 02 00 00 26 40 00 00 00 00 04 00 00 02 02 00 00 00 00 00 02 02 00 00 04 00 00 00 00 40 26 00 00 02
 02 00 00 00 40 00 00 00 00 04 53 02 00 00 00 00 00 00 00 00 00 02 00 04 00 00 00 00 40 00 00 00 02
 02 00 00 00 00 00 00 00 00 04 02 00 00 27 00 00 00 00 00 28 00 53 02 02 00 00 00 00 00 00 00 00 02
 02 00 00 00 00 00 00 00 00 04 03 03 03 03 03 03 03 03 03 03 03 03 02 02 00 00 00 00 00 00 00 00 02
 02 00 00 00 00 00 00 00 30 00 00 00 00 00 00 00 00 00 00 00 00 00 00 00 30 00 00 00 00 00 00 00 02
 02 00 00 00 00 00 00 00 00 00 00 00 00 00 00 00 00 00 00 00 00 00 00 00 00 00 00 00 00 00 00 00 02
 02 00 00 40 00 00 00 00 00 00 00 00 00 00 00 00 00 00 00 00 00 00 00 00 00 00 00 00 00 40 00 00 02
 02 00 00 26 40 00 00 00 00 00 00 00 00 00 00 00 00 00 00 00 00 00 00 00 00 00 00 00 40 26 00 00 02
 02 00 00 00 00 00 00 00 00 00 00 00 00 00 00 00 00 00 00 00 00 00 00 00 00 40 00 00 00 00 00 00 02
 02 00 00 00 00 00 00 00 00 00 00 00 00 00 00 00 00 00 00 00 00 00 00 00 40 26 00 00 00 00 00 00 02
 02 00 00 00 00 26 42 00 00 00 00 00 00 00 00 00 00 00 00 00 00 00 00 00 00 00 00 00 00 00 00 00 02
 02 00 00 00 00 00 00 00 00 00 00 00 00 00 00 00 00 00 00 00 00 00 00 00 00 00 00 00 00 00 40 00 02
 02 06 00 00 00 00 00 00 00 00 00 00 00 00 00 00 00 00 00 00 00 00 00 00 00 00 00 00 00 00 00 30 02
 02 02 02 02 02 02 02 02 02 02 02 02 02 02 02 02 02 02 02 02 02 02 02 02 02 02 02 02 02 02 02 02 02
