Gauntlet (rev 1 - 9)
Maze number: 11
Offset for maze 10: 231708 - 0x03891c
big endian buf: [%!l(uint8=0) %!l(uint8=3) %!l(uint8=137) %!l(uint8=28)]
G:1 Maze real addr: 231711 - 0x03891F, bank 0, boff: 0x0000
Maze read from: 0x03891f - 231711
compresssed: 422
 02 1F 00 00 00 11 38 78 B5 28 43 38 86 2A 38 28
 A0 20 A0 1A A0 20 A0 1A A0 20 A0 25 A2 25 45 A7
 41 40 40 E0 E0 C0 19 84 EC E0 E0 E0 E0 E0 40 1C
 C0 1F C0 25 C2 06 C3 A3 42 E0 40 40 40 40 C0 19
 85 E5 17 0E A0 E3 E0 E0 E0 E0 40 25 54 1F 54 1C
 54 46 80 0B 3B A1 E2 E0 40 E0 E0 E5 B3 46 A1 B2
 A1 CF A1 EC C1 A1 CA A1 E9 18 28 E3 1D C6 53 C1
 A1 2A C5 18 E1 38 A0 38 28 C2 3B C0 A1 C1 A6 1A
 C0 28 C2 2E 70 E2 2A A0 E5 26 C0 A1 C0 10 E3 C0
 20 51 C1 A1 35 04 C0 28 38 A0 38 A0 C6 A1 E1 E4
 C1 2A C0 A1 03 35 04 C0 28 E0 C6 A1 C8 10 A0 1A
 A1 1A C0 35 04 35 04 C3 39 B6 A0 C1 A1 03 80 A0
 E1 C5 A1 10 A1 03 35 03 35 04 C2 39 18 A1 E0 61
 A1 E2 42 A0 E1 BF 2A 04 35 04 35 04 C1 39 81 A1
 C1 05 C1 A1 E4 38 C0 A1 2B 70 35 03 35 03 65 A1
 E2 28 A1 44 A0 C0 B2 A1 35 04 35 04 66 2D A1 C0
 A1 E1 C5 A1 10 A1 03 35 03 6A A1 C2 2A C1 10 C1
 28 C0 A1 1A C0 35 04 6A A1 C6 A1 03 80 28 C1 A1
 03 67 3B C1 A1 C0 20 A0 C5 B2 13 C3 A1 65 A6 C1
 A1 C4 28 03 80 A1 C3 13 C1 3B C1 A1 1A C0 3B 18
 39 E0 C2 1A A0 C3 28 C0 B2 63 28 51 E3 2A 39 83
 C4 A1 C0 B6 A0 CA 28 C0 A1 2C 3A CD A1 C9 1A 2A
 A0 B2 A0 C3 A9 C1 A1 E9 C0 3B C4 18 88 C2 A1 C3
 60 1D C1 04 C0 13 C4 18 A6 18 C4 A3 E5 C0 3B C0
 B3 C2 18 88 CC 10 C0 A2 C2 B4 0A B2 0D A2 10 B2
 16 B4 C9 BE C1 A1 C3 3B C0 04 35 04 35 04 35 04
 35 04 35 04 68 00
  Encoded length: 422 bytes
  Wall pattern: 01, Wall color: 08     Floor pattern: 01, Floor color: 03
  Flags: 
 02 02 02 02 02 02 02 02 02 02 02 02 02 02 02 02 02 02 02 02 02 02 02 02 02 02 02 02 02 02 02 02 02
 02 56 56 56 56 56 56 56 42 56 40 02 32 02 26 02 32 02 26 02 32 02 37 40 02 40 37 40 00 00 00 00 02
 02 56 02 02 02 02 02 02 02 02 00 00 56 00 56 00 56 00 02 00 02 00 25 40 25 40 25 40 00 00 00 00 02
 02 00 00 00 00 00 00 00 00 02 00 02 00 02 00 02 00 02 00 02 00 56 28 40 31 40 37 40 02 00 06 00 02
 02 00 00 02 02 02 02 00 00 00 56 00 02 00 56 00 56 00 56 00 56 00 25 40 25 40 25 40 02 00 00 00 02
 02 00 00 02 23 14 02 02 00 00 00 02 00 02 00 02 00 02 00 02 00 56 37 40 31 40 28 40 02 00 00 00 02
 02 00 00 56 56 11 59 02 02 00 00 00 02 00 02 00 56 00 02 00 02 40 00 00 00 00 00 02 02 00 00 00 02
 02 00 00 00 56 02 02 02 02 02 00 00 00 00 00 00 00 00 00 00 00 40 00 00 00 00 02 02 00 00 00 00 02
 02 00 00 00 00 00 00 00 00 02 02 00 02 02 00 00 00 00 00 00 00 40 00 00 00 02 02 00 00 00 00 00 02
 02 00 00 00 00 02 24 40 00 00 02 00 02 29 00 00 00 00 00 00 00 40 00 00 02 02 42 00 00 00 00 00 02
 02 24 00 00 02 56 02 56 40 00 02 00 59 00 02 02 00 00 02 02 02 02 02 02 02 26 00 40 40 00 00 46 02
 02 03 00 00 00 02 42 02 00 00 02 00 00 00 02 38 00 02 02 00 16 00 00 00 00 02 00 32 40 00 00 02 02
 02 53 04 00 40 56 02 56 02 00 02 00 00 00 00 00 02 02 00 00 02 00 00 00 00 00 02 00 00 42 00 02 02
 02 03 53 04 00 40 00 02 00 00 02 00 00 00 00 02 02 00 00 00 00 00 00 00 00 00 16 02 26 02 02 26 02
 02 53 04 53 04 00 00 00 00 57 02 02 00 00 02 02 03 03 02 00 00 02 00 00 00 00 00 00 02 02 16 02 02
 02 03 53 03 53 04 00 00 00 57 24 02 02 00 02 53 00 00 02 02 00 00 00 02 00 00 00 56 02 00 02 02 02
 02 42 04 53 04 53 04 00 00 57 57 57 02 02 00 00 05 00 00 02 02 00 00 00 00 00 02 56 00 02 02 43 02
 02 03 53 03 53 03 53 00 00 00 00 00 00 02 02 00 00 00 02 40 02 02 00 00 00 00 00 56 02 00 02 02 02
 02 53 04 53 04 53 00 00 00 00 00 00 00 45 02 02 00 02 02 00 00 02 02 00 00 00 00 00 02 02 16 02 02
 02 03 53 03 53 00 00 00 00 00 00 00 00 00 00 00 02 02 00 00 00 42 02 00 16 02 00 40 00 02 02 26 02
 02 53 04 53 00 00 00 00 00 00 00 00 00 00 00 02 02 00 00 00 00 00 02 00 02 02 03 03 40 00 00 02 02
 02 03 53 00 00 00 00 00 00 00 00 59 00 00 02 02 00 32 02 00 00 00 02 00 00 02 19 02 00 00 00 02 02
 02 53 00 00 00 00 00 00 02 02 02 02 02 02 02 00 00 02 02 00 00 00 02 00 40 03 03 02 02 00 00 00 02
 02 19 40 00 59 00 00 02 02 26 00 59 24 57 00 02 00 00 00 26 02 00 02 00 00 40 00 02 53 00 00 00 02
 02 40 40 00 00 00 02 02 42 57 57 57 57 57 00 00 00 00 00 02 02 00 02 02 00 00 00 00 00 00 00 00 02
 02 00 00 40 00 02 02 44 58 00 00 00 00 00 00 00 00 00 00 00 00 00 00 02 02 00 00 00 00 00 00 00 02
 02 00 00 26 42 02 02 02 02 00 00 02 02 02 02 02 02 02 02 02 02 02 00 00 02 02 00 00 00 00 00 00 02
 02 00 00 00 02 00 59 00 02 00 00 02 24 24 24 24 24 24 24 24 24 02 00 00 00 02 02 00 00 00 00 53 02
 02 29 00 00 04 00 19 00 02 00 00 02 24 02 02 02 02 02 02 02 24 02 00 00 00 00 02 02 02 02 00 00 02
 02 00 00 00 02 00 59 00 02 00 00 02 24 02 24 24 24 24 24 02 24 02 00 00 00 00 00 00 00 00 00 00 02
 02 00 00 16 00 02 02 02 00 00 00 02 10 02 13 02 02 02 16 02 22 02 00 00 00 00 00 00 00 00 00 00 02
 02 00 00 02 02 00 00 00 00 59 00 04 53 04 53 04 53 04 53 04 53 04 53 00 00 00 00 00 00 00 00 00 02
 02 02 02 02 02 02 02 02 02 02 02 02 02 02 02 02 02 02 02 02 02 02 02 02 02 02 02 02 02 02 02 02 02
