Gauntlet II
Maze number: 45
Offset for maze 44: 232461 - 0x038c0d
big endian buf: [%!l(uint8=0) %!l(uint8=3) %!l(uint8=140) %!l(uint8=13)]
G:2 Maze real addr: 240653 - 0x03AC0D, bank 1, boff: 0x2000
Maze read from: 0x03ac0d - 240653
compresssed: 351
 0D 00 00 00 20 52 7D 9D 6E 05 B5 C1 33 C2 20 32
 C0 4B 70 45 1E C3 20 C9 41 A0 C2 29 C9 48 2E EF
 0D A2 0D A0 B3 A2 0D A6 C1 40 A4 E3 63 C0 1F C0
 72 24 A0 31 B2 24 EE C0 22 C5 B2 E1 E2 B2 A4 E7
 C3 31 C0 1E C1 0E C0 B6 E1 C3 15 82 C4 1C E2 C9
 0E C1 1E EF C3 1F 62 C8 B3 0D 80 A0 B3 C2 B8 E4
 C0 22 A6 E3 CA 0E E3 C1 32 C0 20 C2 72 A0 E2 E1
 C1 A2 C6 A3 C4 B4 C1 24 A0 70 24 C0 27 C3 0A 68
 C1 21 C3 0E C1 A8 B2 3E C6 1C C4 0D A4 C1 12 C0
 12 C0 3E C4 A1 B8 C4 A1 C3 33 C2 32 C1 B6 C2 B3
 C2 0F C9 1C C3 BF A1 B2 B2 A0 C1 0E C1 12 80 C4
 52 A4 C5 70 31 C3 2A E2 B2 A3 08 04 80 A0 3E C0
 18 C1 41 2E C0 A2 C5 B4 C5 38 C1 05 A1 C1 18 C3
 BF C2 0B C0 28 C6 B2 C7 10 07 C7 1C C5 B6 C4 0E
 18 81 E5 18 C0 33 C4 A1 C2 28 D0 A3 B5 C3 1C C3
 A6 C5 2F 67 EB B5 B2 B2 C0 B2 A4 BE C0 B4 C4 73
 2E C0 A2 1E C1 05 8A 56 C0 B4 C2 B3 C7 31 C5 A4
 51 A0 51 A0 51 C6 41 1E C0 43 70 1C A5 C9 B3 A2
 BF C2 A1 C1 BF A4 33 C9 53 52 05 81 A2 C6 A3 B3
 B3 A0 C8 B3 A1 52 51 C5 B9 49 B4 56 C1 1F C0 25
 C3 2F C9 43 7D B2 CE B4 2E 24 C3 24 B6 1D 21 C0
 27 C0 1D 18 05 51 B2 B2 18 32 2E B4 45 2E 00
  Encoded length: 351 bytes
  Wall pattern: 02, Wall color: 13     Floor pattern: 05, Floor color: 07
  Flags: WRAP_H 
  Random food adds: 0
  Secret trick: 13 - Don't Be Greedy (no treasure)
 02 02 02 02 02 02 02 02 02 02 02 02 02 02 02 02 02 02 02 02 02 02 02 02 02 02 02 02 02 02 02 02
 02 00 51 02 00 00 32 50 02 29 00 00 00 00 00 00 00 00 00 00 00 00 53 02 29 00 00 00 00 00 00 30
 02 00 00 02 32 00 00 00 02 00 00 00 00 00 00 29 00 00 02 00 00 00 41 02 00 00 00 00 00 00 00 00
 02 29 00 02 00 00 00 00 02 00 00 46 02 00 00 00 00 00 00 00 00 00 00 02 00 00 02 00 02 13 02 02
 02 13 02 02 02 02 02 13 02 02 02 02 02 02 02 00 00 29 00 02 02 02 02 02 00 00 02 00 02 00 00 00
 02 46 00 31 00 53 02 00 02 36 02 49 02 36 02 00 00 00 00 00 00 00 00 02 00 00 02 00 00 02 00 34
 02 00 00 00 00 00 02 00 02 02 00 00 00 02 02 02 02 02 02 02 00 02 00 02 00 00 02 00 02 00 00 00
 02 49 00 30 00 00 14 00 02 00 00 02 00 00 00 02 21 21 21 02 00 02 00 02 00 28 02 00 00 02 00 00
 02 00 00 00 00 00 02 00 14 00 00 30 00 00 00 02 00 00 00 02 00 02 00 02 00 00 02 00 02 00 00 00
 02 31 00 00 00 46 02 00 02 00 00 00 00 00 02 02 13 13 02 02 00 02 00 02 00 00 02 00 00 02 00 34
 02 02 02 02 02 02 02 00 02 00 00 02 00 00 02 00 00 00 00 00 00 02 00 14 00 00 02 00 02 00 00 50
 02 32 00 00 00 53 02 00 02 02 00 00 00 02 02 00 02 00 02 02 02 02 00 02 00 00 02 00 00 02 02 02
 02 00 00 00 00 00 02 00 02 36 02 53 02 36 02 39 00 00 02 00 10 02 00 02 00 00 02 00 00 00 46 02
 02 33 00 00 00 00 14 00 02 02 02 02 02 02 02 02 02 02 02 62 00 02 00 02 00 00 02 28 00 00 00 02
 02 13 02 02 02 02 02 00 02 18 00 18 02 62 02 00 00 00 05 02 02 02 00 02 00 00 02 02 02 00 00 02
 02 51 02 02 02 50 02 00 02 00 02 00 02 00 02 00 15 00 05 00 00 00 00 02 00 00 02 28 00 00 00 02
 02 02 02 02 02 02 02 00 14 00 02 18 18 00 02 00 00 00 05 02 02 02 02 02 00 00 02 00 00 00 53 02
 49 00 02 00 00 42 02 00 02 02 02 02 02 02 02 08 04 04 02 62 00 24 02 02 29 00 02 46 00 02 02 02
 00 00 02 00 02 00 02 00 02 00 00 00 00 56 02 05 05 02 02 00 00 24 02 02 00 00 02 00 00 00 11 02
 40 00 02 00 02 00 00 00 02 00 00 00 00 00 02 05 02 16 07 00 00 00 02 02 00 00 02 28 00 00 00 02
 00 00 02 00 02 00 00 00 14 24 24 24 00 00 02 05 02 02 02 24 00 51 02 02 00 00 02 02 02 00 00 02
 40 00 00 00 02 02 02 00 02 00 00 00 00 00 02 05 02 02 02 02 02 02 02 02 00 00 02 28 00 00 00 02
 02 02 02 02 02 02 02 00 02 00 00 00 00 47 02 05 02 02 00 00 00 02 46 02 00 00 02 00 00 00 00 02
 00 00 00 02 02 02 02 05 02 02 02 02 02 02 02 05 02 02 00 02 00 02 53 02 00 00 02 46 00 02 02 02
 30 00 00 05 05 05 05 05 05 05 05 05 05 05 05 05 05 02 00 02 00 02 00 02 00 00 02 00 00 00 49 02
 00 00 00 02 02 02 02 05 02 02 05 02 05 02 05 02 05 05 00 02 00 00 29 02 00 30 02 29 00 00 00 02
 53 00 28 02 02 02 02 05 02 00 00 00 00 00 00 02 05 05 05 02 02 02 02 02 00 00 02 02 02 00 00 02
 02 02 02 02 02 51 02 05 02 00 00 00 00 00 00 02 05 05 05 05 05 02 02 02 00 00 02 00 00 00 00 02
 02 02 02 02 02 02 02 05 02 00 00 00 00 00 00 02 02 02 05 05 00 00 00 02 00 00 02 29 00 00 00 00
 02 00 00 00 00 00 02 05 02 00 31 00 37 00 00 00 02 47 02 02 00 00 00 02 00 00 00 00 29 00 00 00
 02 53 00 00 00 00 00 00 02 00 00 00 00 00 00 00 02 05 02 02 00 00 00 02 00 00 00 00 00 00 00 00
 02 46 36 00 00 00 00 36 02 29 33 00 39 00 29 24 05 05 02 02 24 50 46 02 29 00 00 00 00 00 00 46
 02 02 02 02 02 02 02 02 02 02 02 02 02 02 02 02 02 02 02 02 02 02 02 02 02 02 02 02 02 02 02 02
