Gauntlet II
Maze number: 91
Offset for maze 90: 229678 - 0x03812e
big endian buf: [%!l(uint8=0) %!l(uint8=3) %!l(uint8=129) %!l(uint8=46)]
G:2 Maze real addr: 254254 - 0x03E12E, bank 3, boff: 0x6000
Maze read from: 0x03e12e - 254254
compresssed: 355
 09 00 00 20 00 41 7A 47 75 0E 88 C1 23 E0 43 40
 C0 31 C2 24 60 C7 0E 12 82 63 09 40 08 09 40 08
 33 C3 A9 12 82 C5 09 70 23 09 71 52 C2 18 19 C7
 12 82 C3 AA C3 0D 82 A0 0D 80 A3 0D C1 2E D9 31
 C4 2E 54 C1 23 7B A0 2E 51 23 A0 35 C3 23 60 E1
 35 EE 19 E1 E3 C1 A7 0D 81 A0 0D 81 C0 2E C3 A2
 C5 A1 35 46 C1 77 22 C0 2E 10 C3 23 C8 2E 29 40
 C0 75 56 0D 84 C0 56 60 A0 61 48 70 1D C1 15 C0
 2E A0 19 81 18 60 A2 E2 0D 81 A4 0D 80 A0 40 C3
 A4 04 B3 C4 23 C0 31 C4 20 C3 09 C4 BB C2 31 A0
 2E 80 A0 E2 35 CA 09 08 23 C2 2E CC A1 08 1D 74
 52 09 C4 BA 14 C0 14 A0 14 C3 3C C1 23 C1 BF C0
 73 35 C0 A6 C0 A2 35 A2 2E 80 A1 BE 35 A0 62 67
 C4 33 C4 A3 E1 C4 09 23 09 C5 09 23 C5 09 23 CD
 09 C1 2F C0 52 32 CC 51 CD A8 C0 AF 07 20 07 C2
 38 C2 38 C2 2E A0 4A 24 43 C8 51 C4 2E 1F C4 21
 60 07 D1 22 CA 08 07 E3 0D 81 A0 BC 35 0F C3 AA
 08 81 07 08 09 82 E2 15 04 C4 B2 C2 22 2E C6 2E
 07 2F 09 08 07 C2 21 C0 A2 CD 2E 21 62 09 40 71
 07 C1 09 1D C0 38 C2 38 51 CC 09 40 44 09 C1 B2
 AF A1 07 81 C5 09 07 74 35 E4 2E D4 23 2E C4 23
 C2 1E C0 B2 CA BE 35 72 52 62 E4 C0 31 C0 0E C8
 23 C0 00
  Encoded length: 355 bytes
  Wall pattern: 01, Wall color: 10     Floor pattern: 04, Floor color: 07
  Flags: WALLS_DELETABLE2 
  Random food adds: 0
  Secret trick:  9 - Don't Get Hit (while killing a dragon)
 02 02 02 02 02 02 02 02 02 02 02 02 02 02 02 02 02 02 02 02 02 02 02 02 02 02 02 02 02 02 02 02 02
 02 00 35 00 02 00 00 00 00 07 00 07 00 49 00 14 00 36 00 53 00 00 00 00 00 00 00 00 14 18 18 18 02
 02 00 00 00 14 53 09 00 07 08 09 00 07 08 51 14 00 00 02 02 02 02 02 02 02 02 02 02 02 18 18 18 02
 02 00 00 00 14 00 00 09 08 00 35 09 08 00 00 14 00 00 02 24 25 00 00 00 00 00 00 00 02 18 18 18 02
 02 00 00 00 14 02 02 02 02 02 02 02 02 02 02 02 00 00 02 14 13 13 13 13 02 13 13 14 02 02 02 13 02
 02 00 46 00 14 00 00 00 00 00 00 00 00 00 00 00 02 00 02 14 00 00 00 14 00 00 00 14 02 49 00 00 02
 02 00 00 46 14 00 00 35 08 00 00 00 00 00 00 00 02 00 02 14 00 02 46 14 35 02 53 14 02 00 00 35 02
 02 53 00 00 02 53 00 00 00 00 00 00 00 00 00 00 02 00 02 14 00 02 25 00 00 02 00 14 02 00 02 00 02
 02 02 02 02 02 02 02 02 02 13 13 13 02 13 13 13 02 46 02 14 00 00 02 02 02 00 00 14 02 00 00 02 02
 02 53 00 00 00 00 00 00 00 07 00 00 08 00 00 00 02 00 02 14 00 34 00 46 16 02 00 14 02 35 00 00 02
 02 00 00 00 00 00 00 46 41 00 07 00 08 00 00 00 02 00 02 14 13 13 13 13 13 02 00 14 02 53 02 00 02
 02 53 00 00 00 00 00 00 00 00 00 07 08 00 29 00 02 21 02 46 02 25 25 25 24 02 53 02 02 02 00 00 02
 02 02 13 13 13 02 02 02 02 02 13 13 02 00 07 00 02 00 02 02 02 02 02 02 04 02 00 00 02 00 00 35 02
 02 49 00 00 00 00 02 32 00 14 00 00 09 00 00 00 02 00 02 00 00 00 49 02 46 46 02 00 02 00 02 53 02
 02 00 00 00 00 00 02 00 00 14 00 09 08 35 00 00 02 46 00 00 00 00 00 00 00 00 00 00 02 00 00 02 02
 02 08 29 08 00 00 02 00 00 14 09 00 00 00 00 00 02 20 00 20 02 20 00 00 00 00 60 00 02 35 00 00 02
 02 00 08 00 00 00 02 53 00 02 02 02 02 02 02 02 00 02 02 02 53 02 02 02 46 46 02 02 02 53 02 00 02
 02 00 53 00 00 00 02 00 00 14 00 53 00 00 00 00 00 51 00 00 00 00 00 02 02 02 02 00 00 02 00 00 02
 02 00 00 09 35 09 02 00 00 14 00 00 09 35 00 00 00 00 00 00 09 35 00 00 14 00 00 00 00 00 00 00 02
 02 00 00 00 09 00 02 47 00 14 50 00 00 00 00 00 00 00 00 00 00 00 00 00 14 00 00 00 00 00 00 00 02
 02 00 00 00 00 00 02 02 02 02 02 02 02 02 02 02 00 02 02 02 02 02 02 02 02 02 02 02 02 02 02 02 02
 02 07 32 07 00 00 02 56 00 00 00 56 14 00 00 46 02 00 00 00 00 00 00 00 00 00 00 00 07 36 00 00 02
 02 00 07 00 00 00 02 00 00 00 00 00 14 00 00 00 00 00 46 31 00 00 00 00 00 33 00 53 07 00 00 00 02
 02 00 00 00 00 00 02 00 00 00 00 00 02 00 00 34 00 00 00 00 00 00 00 00 00 00 00 08 07 00 00 00 02
 02 02 13 13 13 02 02 53 15 00 00 00 02 02 02 02 02 02 02 02 02 02 02 02 08 08 08 07 08 09 09 09 02
 02 00 00 00 02 21 04 00 00 00 00 00 02 00 00 00 34 46 00 00 00 00 00 00 00 46 07 47 09 08 07 00 02
 02 00 33 00 02 02 02 00 00 00 00 00 14 00 00 00 00 00 00 00 00 46 33 00 00 00 53 09 00 07 08 00 02
 02 07 00 00 09 29 02 56 00 00 00 56 14 00 00 00 00 00 00 00 00 00 00 00 00 00 09 00 07 00 00 00 02
 02 00 07 09 00 00 02 02 02 02 02 02 02 02 02 02 02 02 02 02 02 02 02 02 02 07 07 07 00 00 00 00 02
 02 00 09 07 08 00 14 00 00 00 53 00 00 00 00 00 02 46 00 00 02 00 00 00 00 00 00 00 00 00 00 00 02
 02 00 00 00 00 00 14 35 46 00 00 00 00 00 35 00 00 00 30 00 02 00 00 00 00 00 00 00 00 00 00 00 02
 02 53 08 00 00 00 14 00 00 00 53 00 00 00 00 00 02 00 49 00 14 00 00 00 00 00 00 00 00 00 35 00 02
 02 02 02 02 02 02 02 02 02 02 02 02 02 02 02 02 02 02 02 02 02 02 02 02 02 02 02 02 02 02 02 02 02
