Gauntlet II
Maze number: 80
Offset for maze 79: 234331 - 0x03935b
big endian buf: [%!l(uint8=0) %!l(uint8=3) %!l(uint8=147) %!l(uint8=91)]
G:2 Maze real addr: 250715 - 0x03D35B, bank 2, boff: 0x4000
Maze read from: 0x03d35b - 250715
compresssed: 273
 0A 00 00 00 28 56 00 5C 43 6E 5F A0 1A C4 2B C3
 1A A0 C5 0E 1A 23 C8 23 A0 E1 E6 C6 0E E6 E4 E1
 E4 31 C6 A2 E3 C6 05 E1 E2 1D A0 64 23 A0 23 A0
 E0 23 A0 E5 C0 05 E0 E2 1D C0 1D A0 E4 C3 23 A0
 19 E4 35 A0 E0 E2 E4 C1 23 A0 E6 E7 E2 C5 0E A0
 10 A0 E8 E2 C3 05 E0 C6 0E E0 18 A0 19 A0 E6 E0
 E5 C7 0E 08 38 09 18 09 35 A0 E6 C6 2B A0 2F C4
 2F A0 C2 09 E2 E4 E9 E4 E8 2E 19 2E A0 C8 2B E1
 2F C0 2F A0 C4 18 E4 32 A0 19 C3 AC 07 81 08 83
 07 81 A1 04 A1 09 81 DD 0A C0 13 85 C8 0F C8 13
 84 DF 13 85 D2 13 84 A4 0D 80 AB 05 A0 05 A0 05
 A4 07 81 CD 31 50 5A 66 60 60 D4 1D 63 60 60 CC
 35 DF DF D7 2E CD B5 01 B5 A0 C4 3A C8 31 42 40
 E4 1E C0 1E 62 64 F2 E0 72 74 46 40 40 40 41 C0
 33 A0 01 A1 FA 1E C0 1E 35 70 72 72 52 42 42 42
 E1 01 A1 62 62 C4 21 40 42 42 E2 1E C0 1E 35 31
 C1 20 C2 20 C3 35 0B BD 2E 53 0C 2E 53 A0 32 A0
 00
  Encoded length: 273 bytes
  Wall pattern: 06, Wall color: 00     Floor pattern: 05, Floor color: 00
  Flags: TRAPS_RANDOM WRAP_H 
  Random food adds: 0
  Secret trick: 10 - Try Pushing a Wall
 02 02 02 02 02 02 02 02 02 02 02 02 02 02 02 02 02 02 02 02 02 02 02 02 02 02 02 02 02 02 02 02
 02 26 00 00 00 00 00 43 00 00 00 00 26 02 00 00 00 00 00 00 14 26 35 00 00 00 00 00 00 00 00 00
 35 02 00 00 02 00 00 00 00 00 00 00 02 00 00 00 00 00 00 00 14 00 00 00 00 00 00 00 02 00 00 00
 00 00 02 00 00 02 00 00 00 00 00 02 49 00 00 00 00 00 00 00 02 02 02 00 00 00 00 02 00 00 00 00
 00 00 00 05 00 00 02 00 00 00 02 29 02 00 00 00 00 00 03 35 02 35 02 00 02 35 02 00 00 00 00 00
 00 02 00 05 00 02 00 00 00 02 29 00 29 02 00 00 00 00 00 02 00 00 00 00 35 02 25 00 00 00 00 00
 02 53 02 00 02 00 00 00 02 00 00 00 00 00 02 00 00 35 02 00 00 00 00 00 00 00 02 00 00 00 00 00
 00 00 00 02 00 00 00 02 00 00 00 00 00 00 14 02 16 02 00 00 00 00 00 00 00 00 00 02 00 00 00 02
 00 00 00 00 05 00 02 00 00 00 00 00 00 00 14 00 02 24 02 25 02 00 00 00 00 00 00 00 02 00 02 00
 00 00 00 00 00 02 00 00 00 00 00 00 00 00 14 08 56 09 24 09 53 02 00 00 00 00 00 00 00 02 00 00
 00 00 00 00 00 43 02 47 00 00 00 00 00 47 02 00 00 00 09 00 00 00 02 00 00 00 00 00 02 00 00 00
 00 00 00 00 00 00 00 02 00 00 00 00 00 02 00 00 00 00 00 00 00 00 00 02 46 25 46 02 00 00 00 00
 00 00 00 00 00 43 00 00 02 47 00 47 02 00 00 00 00 00 24 00 00 00 00 00 02 50 02 25 00 00 00 00
 02 02 02 02 02 02 02 02 02 02 02 02 02 07 07 07 08 08 08 08 08 07 07 07 02 02 04 02 02 09 09 09
 00 00 00 00 00 00 00 00 00 00 00 00 00 00 00 00 00 00 00 00 00 00 00 00 00 00 00 00 00 00 10 00
 19 19 19 19 19 19 19 00 00 00 00 00 00 00 00 00 15 00 00 00 00 00 00 00 00 00 19 19 19 19 19 19
 00 00 00 00 00 00 00 00 00 00 00 00 00 00 00 00 00 00 00 00 00 00 00 00 00 00 00 00 00 00 00 00
 19 19 19 19 19 19 19 00 00 00 00 00 00 00 00 00 00 00 00 00 00 00 00 00 00 00 19 19 19 19 19 19
 02 02 02 02 02 13 13 02 02 02 02 02 02 02 02 02 02 02 02 05 02 05 02 05 02 02 02 02 02 07 07 07
 00 00 00 00 00 00 00 00 00 00 00 00 00 00 49 02 46 00 00 00 00 00 00 00 00 00 00 00 46 02 00 02
 00 00 00 00 03 00 03 00 03 00 00 00 00 00 00 02 00 00 00 00 00 00 00 00 00 00 00 00 00 02 29 02
 00 00 00 03 00 03 00 03 00 00 00 00 00 00 00 02 00 00 00 00 00 53 00 00 00 00 00 00 00 02 00 02
 00 00 00 00 00 00 00 00 00 00 00 00 00 00 00 02 00 00 00 00 00 00 00 00 00 00 00 00 00 02 00 02
 00 00 00 00 00 00 00 00 00 00 00 00 00 00 00 02 00 00 00 00 00 00 00 00 00 00 00 00 00 02 00 02
 00 00 00 00 00 00 00 00 00 00 00 00 00 00 46 02 00 00 00 00 00 00 00 00 00 00 00 00 00 02 01 02
 02 00 00 00 00 00 58 00 00 00 00 00 00 00 00 02 49 00 00 00 28 00 28 00 00 00 00 00 02 30 00 30
 00 00 00 03 00 00 00 00 00 03 00 00 00 00 00 02 00 00 00 00 00 00 00 00 00 00 00 00 00 02 00 02
 00 00 00 31 00 00 00 00 00 31 00 00 00 00 00 02 00 28 00 28 00 28 00 28 00 00 28 00 51 02 01 02
 02 00 00 00 00 00 00 00 00 00 00 00 00 00 00 02 00 00 00 00 00 00 00 00 00 00 00 00 02 30 00 30
 53 00 31 00 00 00 31 00 00 00 31 00 00 00 46 02 00 00 28 00 00 00 28 00 00 00 28 00 00 02 01 02
 02 00 00 00 03 00 00 00 03 00 00 00 00 00 33 02 28 00 00 00 28 00 00 00 28 00 00 00 02 30 00 30
 53 49 00 00 32 00 00 00 32 00 00 00 00 53 11 02 46 00 00 00 00 46 12 46 00 00 00 00 46 02 50 02
 02 02 02 02 02 02 02 02 02 02 02 02 02 02 02 02 02 02 02 02 02 02 02 02 02 02 02 02 02 02 02 02
