Gauntlet II
Maze number: 3
Offset for maze 2: 230132 - 0x0382f4
big endian buf: [%!l(uint8=0) %!l(uint8=3) %!l(uint8=130) %!l(uint8=244)]
G:2 Maze real addr: 230132 - 0x0382F4, bank 0, boff: 0x0000
Maze read from: 0x0382f4 - 230132
compresssed: 138
 00 00 00 02 00 20 12 5C 6E 59 5F 10 80 C0 0E 19
 0E C8 20 45 E0 71 C2 35 51 0E C0 0E D8 A1 0D 81
 C0 0E C2 1E 60 D2 1D 50 51 0E E7 63 E1 C7 A1 0D
 83 F6 D2 1C F8 E5 77 4D EB CA 1E E4 F0 F4 DF 72
 55 83 69 E1 50 DD 19 62 65 C5 20 C0 A1 58 40 D8
 1F A0 50 D1 BF D5 1C E1 41 E9 DA 1C DE 2E ED 63
 63 7E F7 42 E0 D3 1F DF 4D 61 D1 2E DE 1C DF E1
 61 E2 C8 1B 6A 55 DE 19 DA 1C E1 19 DE 19 41 61
 CB BE 35 A0 1D A0 43 D4 0F 00
  Encoded length: 138 bytes
  Wall pattern: 00, Wall color: 02     Floor pattern: 02, Floor color: 01
  Flags: 
  Random food adds: 2
  Secret trick:  0 - No trick
 02 02 02 02 02 02 02 02 02 02 02 02 02 02 02 02 02 02 02 02 02 02 02 02 02 02 02 02 02 02 02 02 02
 02 16 00 14 25 14 00 00 00 00 00 00 00 00 00 32 00 00 00 00 00 00 28 00 02 00 00 31 00 00 00 53 02
 02 00 25 14 00 14 00 00 00 00 00 00 00 00 00 00 00 00 00 00 00 00 00 00 00 00 00 00 00 00 00 02 02
 02 13 13 13 00 14 00 00 00 30 00 46 00 00 00 00 00 00 00 00 00 00 00 00 00 00 00 00 00 00 00 29 02
 02 25 00 00 25 14 00 00 00 00 00 00 00 00 02 00 00 00 00 46 00 00 02 00 00 00 00 00 00 00 00 02 02
 02 13 13 13 13 13 00 00 00 00 00 00 00 00 00 00 00 00 00 00 00 00 00 00 00 00 00 00 00 02 00 00 02
 02 00 00 00 00 00 00 00 00 00 00 00 00 00 00 00 00 28 00 00 00 00 00 00 00 00 00 00 00 00 00 00 02
 02 00 00 00 00 00 00 00 00 00 00 02 00 00 00 00 00 00 02 00 00 00 00 00 00 00 00 31 00 00 00 00 02
 02 00 00 00 00 00 00 00 00 00 28 00 00 00 00 00 00 00 00 00 00 00 00 02 00 00 00 00 00 00 00 00 02
 02 00 00 30 00 00 00 00 00 02 00 00 00 00 00 00 00 00 00 00 00 00 00 00 00 00 00 02 00 00 00 00 02
 02 00 00 00 00 00 00 00 00 00 00 00 00 00 00 00 00 02 00 00 00 00 00 00 00 00 00 00 00 00 00 00 02
 02 00 00 00 00 00 00 00 00 00 00 00 00 00 00 00 00 00 00 00 00 31 00 00 00 00 00 00 25 25 25 25 02
 02 00 00 00 00 00 00 00 00 00 00 46 00 00 02 00 25 00 00 00 00 00 00 00 00 00 00 00 00 00 00 00 02
 02 00 00 00 00 00 00 00 00 00 00 00 00 00 00 25 00 00 00 46 00 00 00 00 00 00 46 00 00 00 00 00 02
 02 32 00 02 02 00 00 00 00 00 00 00 00 00 25 00 28 00 00 00 00 00 00 00 00 00 00 00 00 00 00 00 02
 02 00 00 00 00 00 00 00 00 00 31 02 00 25 00 00 00 00 00 00 00 00 00 00 00 00 00 00 00 00 00 00 02
 02 00 00 00 00 00 00 00 00 00 00 00 00 00 00 00 00 00 00 00 00 00 00 28 00 00 02 00 00 28 00 00 02
 02 00 00 00 00 00 00 00 02 00 00 00 00 00 00 00 00 00 00 00 00 00 00 00 00 00 00 00 00 00 00 00 02
 02 00 00 00 28 00 00 00 00 00 00 00 00 00 00 00 00 00 00 00 00 00 00 00 00 00 00 00 00 00 00 00 02
 02 00 00 00 46 00 00 00 00 00 00 00 00 00 00 00 00 00 00 02 00 00 00 00 46 00 00 00 00 46 00 00 02
 02 00 00 00 00 00 00 00 00 00 00 00 00 31 00 00 00 00 00 00 00 00 00 00 00 00 00 00 00 00 00 00 02
 02 00 00 00 00 00 02 00 00 00 28 00 02 00 00 00 00 00 00 00 00 00 00 00 00 00 00 00 00 00 00 00 02
 02 31 00 00 00 00 00 00 00 00 00 00 00 00 00 00 00 00 00 00 00 00 00 00 00 00 00 00 00 00 00 00 02
 02 00 00 00 00 00 00 00 00 00 00 00 00 00 00 00 28 00 00 46 00 00 00 00 00 00 00 00 00 00 00 00 02
 02 00 00 00 00 00 46 00 00 00 00 00 00 00 00 00 00 00 00 00 00 00 00 00 00 00 00 00 00 00 00 00 02
 02 00 00 00 00 00 28 00 00 00 00 00 00 00 00 00 00 00 00 00 00 00 00 00 00 00 00 00 00 00 00 00 02
 02 00 00 00 00 00 00 00 00 02 00 00 46 00 00 00 02 00 00 00 00 00 00 00 00 00 27 00 00 00 00 00 02
 02 00 00 00 00 00 46 00 00 00 00 00 00 25 00 00 00 00 00 00 00 00 00 00 00 00 00 00 00 00 00 00 02
 02 00 00 00 00 00 00 00 00 00 00 00 00 25 00 00 00 00 00 00 00 00 00 00 00 00 00 00 00 00 00 00 02
 02 00 00 00 00 00 00 00 00 28 00 00 02 25 00 00 00 00 00 00 00 00 00 00 00 00 00 00 00 00 00 00 02
 02 00 00 00 00 00 00 00 00 00 00 00 00 25 00 00 28 00 00 46 00 00 00 00 00 00 00 00 00 00 00 00 02
 02 53 02 29 02 00 00 00 00 28 00 00 00 00 00 00 00 00 00 00 00 00 00 00 00 00 00 00 00 00 00 15 02
 02 02 02 02 02 02 02 02 02 02 02 02 02 02 02 02 02 02 02 02 02 02 02 02 02 02 02 02 02 02 02 02 02
