Gauntlet II
Maze number: 110
Offset for maze 109: 234532 - 0x039424
big endian buf: [%!l(uint8=0) %!l(uint8=3) %!l(uint8=148) %!l(uint8=36)]
G:2 Maze real addr: 259108 - 0x03F424, bank 3, boff: 0x6000
Maze read from: 0x03f424 - 259108
compresssed: 364
 0E 00 00 A0 00 61 95 EE 50 88 89 2E 80 E7 10 C5
 2E 40 E0 2E C6 0F E2 C1 42 E0 C4 A1 E0 CD 35 05
 E0 2E E4 C1 07 C6 A3 E6 C1 04 A0 E1 C1 2E A1 E2
 E2 2E C9 35 05 E0 2E E1 E1 E3 2E A0 C1 78 10 B4
 40 E0 E4 2E 58 A0 E0 2E E4 E2 2E E3 E1 C5 2E A0
 C0 2E E1 64 E1 2E C1 41 A0 E4 E2 E1 C3 B3 C2 42
 A0 C0 77 2E A0 E1 2E C2 2E A0 C3 2E E5 2E E0 E5
 C0 2E A0 E4 C0 07 E2 E1 2E E3 2E 07 E0 2E A0 E8
 2E E1 C1 2E C1 2E A0 C3 54 40 E2 C2 50 A0 C1 2E
 A0 E3 2E A0 C2 52 A0 E1 C1 04 E2 C4 50 A0 E2 E4
 2E E0 2E E9 2E E1 C8 2E A0 E1 E7 E4 C1 2E 40 C1
 BF 10 E2 2E E4 2E E0 C0 2E A0 E1 2E E1 C1 A1 E2
 C2 A1 E3 2E A0 E0 2E A0 E3 C6 2E 41 E1 2E C7 70
 A0 E4 E2 E2 2E E2 2E E0 2E A0 C1 2E 40 C1 2E 42
 72 40 EB 2E E1 2E A0 E1 E2 E2 2E 07 E0 E3 2E E3
 C4 51 40 E8 2E 63 A2 E6 2E E2 E9 E7 E3 2E C5 2E
 E2 2E A0 E3 2E A2 E2 2E 40 A0 E3 E2 E0 2E E2 2E
 E2 2E C0 2F 05 61 A0 E0 2E E2 E3 E4 2E 76 2E 40
 40 E1 E1 2E E1 E5 C1 A2 E4 C0 07 E7 E5 E4 10 C4
 55 A0 C3 2E 40 40 C0 07 2F C1 2E A0 C0 04 A0 C4
 2E A0 E1 2E 07 2E E2 C2 2E A0 E1 C0 2E A0 E1 2E
 C2 35 E2 70 40 A0 E1 2E E1 E5 2E C1 A2 C0 B4 A0
 BE 10 05 2F 63 40 61 40 66 40 64 00
  Encoded length: 364 bytes
  Wall pattern: 01, Wall color: 05     Floor pattern: 06, Floor color: 09
  Flags: EXIT_CHOOSE_ONE WALLS_DELETABLE2 
  Random food adds: 0
  Secret trick: 14 - Go On a Diet (no food)
 02 02 02 02 02 02 02 02 02 02 02 02 02 02 02 02 02 02 02 02 02 02 02 02 02 02 02 02 02 02 02 02 02
 02 46 00 00 00 00 00 00 00 00 02 16 00 00 00 00 00 00 46 02 46 00 02 46 00 00 00 00 00 00 00 15 02
 02 00 02 02 00 00 02 02 02 46 00 02 00 00 00 00 00 02 02 00 02 00 00 00 00 00 00 00 00 00 00 00 02
 02 00 02 53 05 00 02 46 00 00 00 00 00 02 00 00 07 00 00 00 00 00 00 00 02 02 02 02 00 00 00 00 02
 02 00 02 02 00 00 04 02 00 00 02 00 00 46 02 02 00 00 00 02 00 00 00 02 46 00 00 00 00 00 00 00 02
 02 00 02 53 05 00 02 46 00 00 02 00 00 02 00 00 00 00 02 46 02 00 00 09 00 00 00 00 00 02 00 00 02
 02 16 02 02 46 00 02 00 00 00 00 00 02 46 08 00 00 00 00 00 00 00 00 00 02 00 02 46 00 02 00 00 02
 02 02 00 00 00 02 46 00 00 00 00 02 00 00 02 00 00 00 00 00 00 46 02 00 46 00 00 02 00 02 00 00 02
 02 16 00 00 02 46 00 00 02 02 46 02 00 00 00 00 00 02 00 00 00 02 00 00 02 00 00 00 00 02 00 00 02
 02 02 02 02 46 02 00 09 00 00 00 00 00 00 00 00 46 02 00 00 02 46 00 00 00 46 02 00 00 00 00 46 02
 02 00 00 00 00 00 02 46 00 02 00 00 00 00 00 00 02 00 46 02 00 00 00 00 00 02 00 07 00 00 00 02 02
 02 00 02 46 00 00 00 00 02 46 07 00 02 46 02 00 00 00 00 00 00 00 00 00 02 46 00 00 02 00 00 46 02
 02 00 46 02 00 00 00 00 08 00 00 00 00 00 02 46 00 00 00 02 00 00 00 08 00 02 00 00 46 02 00 00 02
 02 00 02 46 02 00 00 00 08 00 00 00 02 00 00 02 00 00 04 00 00 00 02 00 00 00 00 00 08 00 02 00 02
 02 00 02 00 00 00 00 00 02 46 00 02 46 00 00 00 00 00 00 00 00 00 00 02 46 00 00 02 00 00 00 00 02
 02 00 00 00 00 46 02 00 00 02 00 00 00 00 00 00 00 00 02 00 00 00 00 00 02 00 00 46 02 46 00 00 02
 02 16 00 00 00 02 46 00 00 00 00 00 02 46 00 02 00 46 02 00 00 02 46 00 00 02 00 00 02 02 00 00 02
 02 02 00 00 00 02 02 00 00 00 00 02 46 02 00 02 46 02 00 00 00 00 02 00 00 00 00 00 00 00 46 02 02
 02 46 00 00 02 46 00 00 00 00 00 00 00 00 09 00 02 00 00 00 00 00 02 00 00 00 02 00 00 00 02 46 02
 02 00 00 02 46 00 02 46 02 00 00 46 02 46 00 00 46 02 02 02 46 09 00 00 00 02 46 00 00 00 00 00 02
 02 00 00 00 00 00 00 02 46 00 00 02 46 02 00 00 02 00 00 00 02 00 00 00 02 46 07 00 02 00 00 00 02
 02 02 46 00 00 00 00 02 00 00 00 00 00 08 00 00 02 46 00 00 00 00 00 00 00 00 00 02 46 00 00 00 02
 02 16 02 02 02 00 00 00 00 00 00 00 02 46 00 00 00 02 00 00 00 00 00 00 00 00 00 00 02 00 00 00 02
 02 00 00 00 00 02 00 00 00 00 02 46 00 00 00 00 00 00 46 00 00 00 02 46 02 00 00 00 00 02 46 02 02
 02 02 00 00 00 02 46 02 46 02 00 00 00 00 02 00 00 00 02 00 02 46 00 00 00 02 46 00 00 00 02 46 02
 02 47 05 00 00 16 02 00 02 46 00 00 00 02 00 00 00 00 02 00 00 00 00 00 02 46 09 00 00 00 00 00 02
 02 00 46 02 46 02 46 00 00 02 00 00 02 46 00 00 02 00 00 00 00 00 00 02 00 00 02 02 02 00 02 00 02
 02 00 02 00 07 00 00 00 00 00 00 00 00 02 00 00 00 00 00 00 02 00 00 00 00 00 02 16 00 00 02 00 02
 02 08 00 00 00 00 00 00 02 00 00 00 00 46 02 46 02 46 00 07 47 00 00 46 02 00 04 02 00 00 02 00 02
 02 46 02 00 00 02 46 07 46 00 00 00 02 00 00 00 46 02 00 00 02 00 46 02 00 00 02 46 00 00 02 53 02
 02 00 00 02 09 00 02 46 02 00 00 02 46 00 00 02 00 00 00 00 00 00 02 46 00 00 02 02 02 00 02 02 02
 02 16 05 47 00 00 00 00 16 02 46 00 00 16 02 46 00 00 00 00 00 00 00 16 02 46 00 00 00 00 00 16 02
 02 02 02 02 02 02 02 02 02 02 02 02 02 02 02 02 02 02 02 02 02 02 02 02 02 02 02 02 02 02 02 02 02
