Gauntlet II
Maze number: 82
Offset for maze 81: 234999 - 0x0395f7
big endian buf: [%!l(uint8=0) %!l(uint8=3) %!l(uint8=149) %!l(uint8=247)]
G:2 Maze real addr: 251383 - 0x03D5F7, bank 2, boff: 0x4000
Maze read from: 0x03d5f7 - 251383
compresssed: 402
 0C 00 00 00 20 41 A3 0D 41 0E F5 31 80 19 60 C2
 2E A0 C5 1F A1 2F 19 61 C6 2E 63 E3 E8 62 A6 E3
 E1 EC 61 C2 1D C4 2E A0 E1 C2 51 C2 05 80 C0 19
 C1 19 2F A0 60 C2 31 C3 B4 A0 E1 C2 72 C3 40 54
 A4 C2 B3 A4 05 35 E0 1F E1 35 E1 C8 31 E2 61 15
 81 72 CF 1F E2 C2 A4 31 A1 C3 1C A0 C2 25 22 B4
 1D E7 C3 1C 2E C1 18 2E 08 E2 C5 08 C3 25 C4 A1
 C6 2E 08 C0 B3 C4 B6 35 2E 08 C5 B5 E1 C3 1F C1
 1D C0 2E 08 45 C1 A1 C0 A5 E1 35 C1 A4 C0 18 2E
 08 C8 2E A0 C6 05 18 A0 C4 3E C0 2F A1 C5 B2 C2
 2A A0 C0 A5 18 A0 15 A5 B7 A1 0B A0 E3 35 A0 E1
 E7 15 2E C4 33 C2 05 C0 A2 22 A0 22 A0 E1 2E A0
 E0 E0 C2 A8 C1 1F C0 2E 81 05 C0 05 E0 C0 28 A0
 E0 E0 C0 42 18 35 C4 3E 52 C1 05 E0 B2 A0 E0 E0
 E1 14 A0 14 A0 14 70 15 35 AA 31 A0 2E E1 E0 C1
 A4 14 A0 14 42 C1 1C A0 31 C3 22 1C A0 E7 E4 0C
 A0 E4 32 A0 1C C6 A6 C1 A2 C0 22 C1 A1 E1 E2 C0
 3E E3 05 09 C2 22 E1 C0 25 E0 CB A1 B4 C2 18 09
 AD 42 C0 51 C5 2A 09 E3 3E C3 2E 15 C1 1F C8 A6
 E4 C3 B2 2E 15 51 C0 1C C0 A2 C4 32 22 A0 15 07
 1C E6 C3 A5 C0 2E C0 A2 C4 07 C3 41 B4 C1 1E A0
 35 81 0E C5 27 C1 3E C0 2F B3 C2 0A C1 B3 E3 09
 C1 AD B5 A0 07 A0 C4 1C C3 3E A0 10 D0 2F A0 CB
 A9 C4 A3 07 C3 07 81 C0 0F C3 2E E7 08 25 08 A0
 E7 15 18 B5 C4 51 2E C6 20 3E A2 3E E5 28 A0 2A
 33 00
  Encoded length: 402 bytes
  Wall pattern: 01, Wall color: 03     Floor pattern: 04, Floor color: 10
  Flags: WRAP_H 
  Random food adds: 0
  Secret trick: 12 - Don't Be Greedy (no keys or potions)
 02 02 02 02 02 02 02 02 02 02 02 02 02 02 02 02 02 02 02 02 02 02 02 02 02 02 02 02 02 02 02 02
 02 49 25 00 01 00 00 00 46 02 00 00 00 00 00 00 31 14 02 47 25 00 00 01 00 00 00 00 00 00 00 46
 02 00 00 00 01 00 00 00 00 02 00 00 00 00 00 00 00 14 00 02 00 00 00 01 02 02 02 02 02 02 02 00
 02 00 00 02 00 00 02 00 00 14 00 00 00 00 00 00 00 14 00 00 02 00 00 01 00 00 02 29 00 00 00 00
 02 46 02 00 00 02 00 00 00 14 00 00 02 05 05 02 25 14 00 25 47 02 00 01 00 00 02 49 00 00 00 00
 02 02 00 00 02 00 00 00 02 02 02 53 02 00 00 02 13 14 02 02 02 02 02 00 00 00 02 02 02 02 02 02
 05 53 00 02 31 00 00 02 53 00 00 02 02 00 00 02 00 00 00 00 00 49 02 00 00 02 00 00 01 21 21 21
 02 02 02 53 00 00 02 00 00 00 00 00 02 00 00 02 00 00 00 00 31 00 02 00 02 00 00 00 02 02 02 02
 02 49 02 02 00 00 02 00 28 02 00 00 02 37 34 02 29 00 00 00 00 00 02 00 00 02 00 00 00 00 28 46
 02 00 24 46 08 00 02 00 02 00 00 00 02 00 00 08 00 00 00 00 37 00 02 00 00 00 02 02 00 00 00 00
 02 00 00 46 08 00 02 00 00 00 00 00 02 53 46 08 00 00 00 00 00 00 02 00 00 02 00 00 00 00 31 00
 02 29 00 46 08 13 13 13 13 13 02 00 00 02 02 00 02 02 02 02 02 02 00 00 02 53 00 00 02 02 02 02
 02 00 24 46 08 00 00 00 00 00 02 00 00 00 46 02 00 00 00 00 00 00 00 05 24 02 00 00 00 00 00 62
 02 47 02 02 00 00 00 00 00 00 02 00 00 00 42 02 00 02 02 02 02 02 02 24 02 21 02 02 02 02 02 02
 02 02 02 11 02 00 00 00 00 02 53 02 00 00 02 00 00 00 00 00 00 00 00 02 21 46 00 00 00 00 00 51
 14 00 00 05 00 02 02 02 34 02 34 02 00 00 02 46 02 00 02 00 02 00 00 00 02 02 02 02 02 02 02 02
 14 00 00 31 00 46 02 46 05 00 05 00 02 00 40 02 00 02 00 02 00 13 13 13 24 53 00 00 00 00 00 62
 14 00 00 05 00 02 02 02 00 02 00 02 00 00 02 20 02 20 02 20 02 53 21 53 02 02 02 02 02 02 02 02
 02 02 02 49 02 46 00 00 02 00 02 00 00 02 02 02 02 02 20 02 20 13 13 13 00 00 28 02 49 00 00 00
 02 34 28 02 00 00 00 00 00 00 00 00 02 00 00 00 00 00 02 12 02 00 00 00 00 00 02 50 02 28 00 00
 02 00 00 00 00 02 02 02 02 02 02 02 00 00 02 02 02 00 34 00 00 02 02 00 00 02 00 00 00 02 00 62
 02 00 00 00 02 05 09 00 00 00 34 00 00 02 00 37 00 02 00 00 00 00 00 00 14 00 00 00 00 00 02 02
 02 00 00 02 24 09 02 02 02 02 02 02 02 02 02 02 02 02 02 02 13 13 02 00 14 00 00 00 00 00 00 42
 09 00 00 02 00 02 62 00 00 00 02 46 21 14 00 31 00 00 00 00 00 00 02 00 02 02 02 02 02 02 02 02
 00 00 00 02 00 02 00 00 00 00 02 46 21 14 00 28 00 02 02 02 00 00 02 00 02 50 34 02 21 07 28 02
 00 00 00 02 00 00 02 00 00 00 00 02 02 02 02 02 02 00 46 00 02 02 02 00 02 00 00 00 07 00 00 02
 02 13 13 02 00 00 30 02 53 53 53 14 00 00 00 00 00 00 39 00 00 62 02 47 02 00 00 00 10 00 00 02
 02 00 00 00 02 09 00 00 02 02 02 02 02 02 02 02 02 02 02 02 02 02 02 02 07 02 00 00 00 00 00 28
 02 00 00 00 62 02 16 00 00 00 00 00 00 00 00 00 00 00 00 00 00 00 00 00 47 02 00 00 00 00 00 00
 02 00 00 00 00 00 02 02 02 02 02 02 02 02 02 02 00 00 00 00 00 02 02 02 02 07 00 00 00 00 07 07
 02 00 15 00 00 00 14 46 00 00 00 00 00 00 00 00 02 08 37 08 02 00 00 00 00 00 00 00 00 02 21 24
 02 00 00 00 00 00 14 46 00 00 00 00 00 00 00 32 62 02 02 02 62 00 00 00 00 00 00 02 40 02 42 51
 02 02 02 02 02 02 02 02 02 02 02 02 02 02 02 02 02 02 02 02 02 02 02 02 02 02 02 02 02 02 02 02
