Gauntlet II
Maze number: 100
Offset for maze 99: 232214 - 0x038b16
big endian buf: [%!l(uint8=0) %!l(uint8=3) %!l(uint8=139) %!l(uint8=22)]
G:2 Maze real addr: 256790 - 0x03EB16, bank 3, boff: 0x6000
Maze read from: 0x03eb16 - 256790
compresssed: 297
 09 01 00 00 20 54 4C 9A BF 75 5D C2 2F C0 47 1A
 24 C0 10 C2 44 3A A0 1C 4F D1 2E D2 3E E1 1C 76
 E5 19 E1 C0 60 B3 C2 B3 AB 50 E3 E0 15 19 62 6F
 E8 E0 E2 C1 29 A0 C5 28 A0 E8 C0 24 E2 E2 31 D4
 A4 62 3F AB C9 3E C1 0F E4 21 32 C1 3E C1 31 05
 CB 15 CE A3 3C C0 B2 1D 73 2E E1 51 C2 3E 63 0C
 C2 33 C0 05 C1 2F A0 0D 81 E3 C2 05 81 B3 A6 B4
 A3 61 6F 50 1A 29 C2 0E C1 38 C0 05 D9 0E C3 05
 C3 46 A0 40 38 29 C8 0E 78 C4 BF C1 A4 3F A7 E0
 1B C2 31 E1 73 05 C3 32 C2 2E CB A2 C6 05 EB 1D
 C7 2F C3 BF C2 05 C1 3B C4 2E 19 E2 51 1A 31 C7
 A1 0D A4 BC E0 C0 62 3F 19 E2 0D A0 52 C0 09 81
 A0 F9 79 C2 1C EE 32 EE B2 E3 E7 C7 A1 08 A0 08
 3F 08 A0 3E 62 3F 3E A1 B8 0B A0 0A E4 19 C6 0B
 CB 31 07 C0 29 CD 2E 01 C9 0A A2 CB 19 80 31 C0
 2E 01 C6 1C C1 15 C0 33 07 C2 BF C3 2F C2 A2 B8
 A2 64 A0 C1 A3 08 81 C0 0D 81 BF A2 B2 4D B4 CD
 21 35 52 C1 2A A0 45 0E C1 29 A0 CD 21 A0 45 B6
 38 C0 3E A0 44 35 B3 45 00
  Encoded length: 297 bytes
  Wall pattern: 04, Wall color: 12     Floor pattern: 05, Floor color: 04
  Flags: ODDANGLE_GHOSTS WRAP_H 
  Random food adds: 0
  Secret trick:  9 - Don't Get Hit (while killing a dragon)
 02 02 02 02 02 02 02 02 02 02 02 02 02 02 02 02 02 02 02 02 02 02 02 02 02 02 02 02 02 02 02 02
 00 00 00 47 02 26 00 00 00 00 00 00 00 00 26 36 02 16 00 00 02 26 00 00 00 00 00 58 02 28 26 00
 00 00 00 00 02 00 00 00 00 00 00 00 00 00 00 00 02 00 00 00 02 00 00 00 00 00 00 00 00 00 00 00
 00 46 00 00 02 00 00 00 00 00 00 00 00 00 00 00 02 00 00 00 02 62 00 00 02 28 00 00 00 00 00 00
 02 29 00 00 02 00 00 00 02 25 00 00 02 00 63 00 02 00 00 00 02 02 02 02 02 02 02 02 02 02 02 02
 02 00 53 00 02 00 00 02 00 02 21 25 63 00 00 00 63 00 00 00 00 00 00 00 00 00 00 00 00 00 00 00
 02 00 00 00 02 00 00 00 00 00 02 00 02 00 00 00 02 00 00 41 02 00 00 00 00 00 00 40 02 00 00 00
 02 00 00 00 02 00 02 00 36 00 00 00 02 00 00 00 02 49 00 00 00 00 00 00 00 00 00 00 00 00 00 00
 02 00 00 00 02 00 00 02 02 02 02 02 63 00 00 00 63 02 02 02 02 02 02 02 02 02 02 02 02 00 00 00
 02 00 00 00 02 00 00 62 02 00 15 00 02 00 00 00 02 33 50 00 02 62 00 00 49 05 00 00 02 00 00 00
 02 00 00 00 02 00 21 00 02 00 00 00 02 00 00 00 00 00 00 00 02 00 02 02 02 02 60 00 02 29 00 00
 02 00 29 46 02 00 02 00 02 53 00 00 02 62 63 00 00 00 00 12 02 00 00 51 00 05 00 00 47 02 13 13
 02 00 00 00 02 02 00 00 02 05 05 05 02 02 02 02 02 02 02 02 02 02 02 02 02 63 00 00 63 00 00 00
 02 00 00 00 02 00 00 00 02 00 00 00 00 00 53 26 41 00 00 00 14 00 00 56 02 05 00 00 02 00 00 00
 02 00 00 00 02 00 00 00 02 00 00 00 00 00 00 00 00 00 00 00 14 00 00 00 02 05 00 00 02 00 26 00
 02 00 00 00 02 00 02 26 02 56 41 00 00 00 00 00 00 00 00 00 14 00 00 00 02 00 00 00 02 00 29 00
 02 00 00 00 02 00 00 02 02 02 02 02 63 02 02 02 02 02 02 02 02 00 02 27 02 00 00 49 02 00 02 00
 02 00 00 29 05 00 00 00 02 50 00 00 00 46 00 00 00 00 00 00 02 00 00 00 02 00 02 02 02 00 00 00
 02 00 00 00 05 00 00 00 02 00 00 00 00 00 00 00 00 02 29 00 02 00 00 00 02 00 00 47 02 00 00 00
 02 00 00 00 05 00 00 59 02 00 00 00 00 46 25 00 00 00 02 00 02 53 26 49 02 00 00 00 02 00 00 00
 02 02 13 02 02 02 02 02 02 00 02 00 63 00 00 00 63 25 00 00 02 02 13 02 02 00 00 53 02 09 09 09
 02 00 00 00 02 00 00 00 00 00 00 00 02 00 00 00 00 00 00 00 02 00 00 00 02 00 00 02 02 00 00 00
 00 00 00 00 02 00 29 00 00 00 28 00 02 00 00 00 00 00 00 00 02 00 00 00 02 00 02 50 02 00 00 00
 00 00 00 00 02 00 00 00 00 00 00 02 02 00 00 00 00 02 00 00 02 00 00 00 02 00 02 00 02 00 00 00
 00 00 00 02 02 08 02 08 63 08 02 62 63 00 00 00 63 62 02 02 02 11 02 10 02 00 00 00 02 02 25 00
 00 00 00 00 02 00 11 00 00 00 00 00 02 00 00 00 02 00 00 49 07 00 41 00 02 00 00 00 02 00 00 00
 00 00 00 00 02 46 01 00 00 00 00 00 02 00 00 00 02 10 02 02 02 00 00 00 02 00 00 00 02 00 00 00
 02 25 25 49 02 46 01 00 00 00 00 00 02 00 28 00 02 21 00 51 07 00 00 00 02 00 00 00 02 47 00 00
 02 02 02 02 02 02 02 02 63 00 00 00 02 00 02 00 02 02 02 02 02 08 08 08 02 13 13 13 02 02 02 02
 02 26 00 00 00 00 00 00 00 00 00 00 02 00 00 00 02 00 00 00 00 00 00 00 02 00 00 00 00 00 00 33
 53 00 00 00 53 00 00 42 02 26 00 00 02 00 00 00 14 00 00 41 02 00 00 00 02 00 00 00 00 00 00 00
 00 00 00 33 02 26 00 00 00 00 00 00 02 56 00 62 02 26 00 00 00 00 00 53 02 26 00 00 00 00 00 00
 02 02 02 02 02 02 02 02 02 02 02 02 02 02 02 02 02 02 02 02 02 02 02 02 02 02 02 02 02 02 02 02
