Gauntlet II
Maze number: 101
Offset for maze 100: 232511 - 0x038c3f
big endian buf: [%!l(uint8=0) %!l(uint8=3) %!l(uint8=140) %!l(uint8=63)]
G:2 Maze real addr: 257087 - 0x03EC3F, bank 3, boff: 0x6000
Maze read from: 0x03ec3f - 257087
compresssed: 246
 05 80 80 00 00 00 00 0D 47 0E 35 2E 80 1A F0 1A
 C8 23 C2 4B C2 4C 1A C2 31 1E C3 2E DA A7 E7 C1
 A4 D3 33 E5 CB 0F CE 2E 44 DF C8 B4 A4 C1 B4 C2
 B7 1E CF 57 2E C9 56 C2 56 CE 44 C3 75 C1 44 C7
 28 C1 58 C1 2E C2 1E C2 75 D0 2F C2 0A A4 C2 B4
 AA B9 C6 B8 07 82 C4 53 2E CB 23 31 5B 64 2E C4
 4F 43 C3 43 C7 31 C3 2B C9 2E 63 C2 BF C2 AF A3
 B9 C1 15 07 C4 53 D5 35 5B 35 07 35 82 C0 4F 48
 60 C7 0E C8 23 6B C3 A2 07 A7 C3 AB E5 07 0E 20
 C1 35 C0 15 C7 29 C1 31 C1 2B C1 2E 57 29 C0 10
 E1 48 53 C3 4B C5 0E 1D C0 35 0E 18 35 C0 0A D0
 31 A5 07 81 A2 B4 A2 B4 C3 A6 07 83 C3 0E 60 C0
 0E C0 31 CB 29 C1 31 C6 42 60 C0 49 C2 48 C6 31
 28 DB AC C2 B4 C3 A1 07 80 1A D3 57 2B C4 0A 1A
 C2 53 C2 54 4F 42 53 C1 1A 44 C0 BE 1A C7 33 1A
 2B 1A C9 B3 C6 00
  Encoded length: 246 bytes
  Wall pattern: 00, Wall color: 00     Floor pattern: 00, Floor color: 00
  Flags: INVIS_TRAPWALLS INVIS_ALLWALLS 
  Random food adds: 0
  Secret trick:  5 - Watch What You Shoot (shoot foods)
 02 02 02 02 02 02 02 02 02 02 02 02 02 02 02 02 02 02 02 02 02 02 02 02 02 02 02 02 02 02 02 02 02
 02 46 26 00 00 00 00 00 00 00 00 00 00 00 00 00 02 00 00 00 02 26 00 00 00 00 00 00 00 00 00 35 02
 02 00 14 13 13 13 13 13 13 13 13 13 13 13 13 00 02 00 13 13 13 13 14 13 13 13 13 13 13 13 14 26 02
 02 00 14 49 30 00 00 00 00 46 00 00 00 00 14 00 02 00 14 00 02 00 14 00 00 00 00 00 00 00 14 00 02
 02 00 14 00 02 02 02 02 02 02 02 02 02 00 14 00 02 00 14 00 02 02 14 00 02 02 02 02 02 00 14 00 02
 02 00 14 00 02 00 00 00 00 00 00 53 02 00 14 00 02 51 14 00 02 00 14 00 02 00 00 00 02 00 14 00 02
 02 00 14 00 02 15 00 00 00 53 00 53 02 00 14 00 02 00 14 00 02 46 14 13 13 13 14 00 02 00 14 00 02
 02 00 14 00 02 00 00 00 00 53 00 53 02 00 14 00 02 00 14 00 02 00 14 00 02 00 14 00 02 00 14 00 02
 02 00 14 00 02 02 02 02 02 53 00 53 02 00 14 00 02 30 14 00 02 00 14 00 02 00 14 00 02 00 14 00 02
 02 00 14 46 00 00 00 00 02 53 00 53 00 00 14 00 00 00 14 00 02 00 14 00 02 00 14 00 02 00 14 00 02
 02 00 13 13 13 13 14 00 02 53 00 53 00 00 13 13 13 13 13 00 02 00 14 00 02 00 14 40 02 00 14 00 02
 02 46 00 00 00 30 14 00 02 53 00 00 00 00 00 00 00 00 00 00 02 00 14 00 02 00 14 47 02 00 00 10 02
 02 02 02 02 02 00 14 00 02 02 02 02 02 02 02 02 02 02 02 02 02 00 14 00 02 00 14 00 02 07 07 07 02
 02 00 00 00 00 00 14 46 00 00 00 00 00 00 00 00 00 00 00 00 35 49 14 00 02 00 14 00 07 46 00 00 02
 02 00 14 13 13 13 13 13 13 13 13 13 13 13 13 13 13 13 13 13 13 13 13 00 02 00 14 13 13 13 14 00 02
 02 00 14 00 00 00 00 49 00 00 00 00 43 00 00 00 00 00 00 00 00 00 00 46 02 00 14 00 07 00 14 00 02
 02 00 14 00 02 02 02 02 02 02 02 02 02 02 02 02 02 02 02 02 02 02 02 02 02 00 14 21 07 00 14 00 02
 02 00 14 00 00 00 00 00 00 00 00 00 00 00 00 00 00 00 00 00 00 00 00 00 00 53 14 53 07 53 14 53 02
 02 00 13 13 13 13 13 13 13 13 13 13 13 13 13 13 13 13 13 13 13 13 13 13 13 13 13 00 07 00 14 00 02
 02 00 00 00 00 14 00 00 00 00 00 00 00 00 14 35 00 00 00 00 00 00 00 00 00 00 00 00 07 00 14 00 02
 02 02 02 02 07 02 02 02 02 02 02 02 02 00 14 00 02 02 02 02 02 02 02 02 02 02 02 02 02 00 14 00 02
 02 00 00 02 07 14 32 00 00 53 00 21 02 00 14 00 02 00 00 00 41 00 00 49 00 00 43 00 00 46 14 41 02
 02 16 00 00 02 13 13 13 13 13 13 13 02 13 14 00 02 00 14 13 13 13 13 13 13 13 13 13 13 13 13 00 02
 02 00 00 00 00 14 29 00 53 14 24 53 02 10 00 00 02 00 14 00 00 00 00 00 00 00 00 00 00 00 00 49 02
 02 02 02 02 02 02 07 07 07 02 02 02 02 02 02 02 02 00 14 00 02 02 02 02 02 02 02 02 07 07 07 07 02
 02 00 00 00 00 14 00 07 00 14 00 49 00 00 00 00 00 00 14 00 02 00 00 00 41 00 00 49 00 00 00 00 02
 02 00 14 13 13 13 00 07 00 13 13 13 13 13 13 13 13 13 14 00 02 00 13 13 13 13 13 13 13 13 14 00 02
 02 00 14 00 00 00 49 40 00 00 00 00 00 00 00 00 00 00 14 00 02 00 14 00 00 00 00 00 00 00 14 00 02
 02 00 14 00 02 02 02 02 02 02 02 02 02 02 02 02 02 00 14 00 02 00 14 00 02 02 02 07 07 26 14 00 02
 02 00 14 00 00 00 00 00 00 00 00 00 00 00 00 00 00 00 14 43 00 00 14 00 02 10 26 00 00 00 14 00 02
 02 00 14 13 13 13 13 13 13 13 13 13 13 13 13 13 13 13 13 13 13 13 14 00 02 26 13 13 13 13 13 00 02
 02 26 00 00 00 00 00 00 00 00 51 26 43 26 00 00 00 00 00 00 00 00 00 00 02 00 00 00 00 00 00 00 02
 02 02 02 02 02 02 02 02 02 02 02 02 02 02 02 02 02 02 02 02 02 02 02 02 02 02 02 02 02 02 02 02 02
