Gauntlet II
Maze number: 76
Offset for maze 75: 233141 - 0x038eb5
big endian buf: [%!l(uint8=0) %!l(uint8=3) %!l(uint8=142) %!l(uint8=181)]
G:2 Maze real addr: 249525 - 0x03CEB5, bank 2, boff: 0x4000
Maze read from: 0x03ceb5 - 249525
compresssed: 296
 01 00 00 00 30 60 8C 59 6E 7E 4C A0 23 A0 C4 15
 81 A0 1E A0 C4 01 51 C0 38 81 50 E7 1E A0 50 E5
 23 A0 CB 01 A4 E0 C0 A7 E0 19 A5 B2 A5 18 09 45
 3E 19 C6 08 20 C0 A2 C0 1E C0 A2 32 08 A0 47 E7
 70 07 08 07 C2 07 08 09 0B 20 A0 D2 0C 07 80 09
 C2 09 07 80 0B D4 0C 08 09 08 C0 10 C0 07 08 09
 0B D4 0C 09 07 08 C2 08 09 08 0B E0 47 E7 70 08
 07 09 C2 07 08 07 0B 40 08 45 3E 19 C6 09 20 32
 A2 C0 1E C0 A2 C0 20 A4 E0 E0 04 A5 E0 18 AC E4
 21 A0 50 E5 23 A0 CB 01 A0 23 A0 C4 15 81 A0 21
 A0 C4 01 51 C0 38 81 50 C2 AF AF 23 42 2E A0 2E
 C1 18 2E A0 C4 1F 41 3E 0A 80 C0 31 50 E7 E6 F5
 E8 D3 2E 6A C3 20 C3 B7 C3 23 E2 EC C7 06 E6 C6
 37 E6 C5 21 06 E5 2E CE 2F A0 C5 06 23 E4 C4 36
 C1 0F E7 2E 43 3E 19 63 18 CA 36 C4 18 A5 04 A6
 D1 2E 43 3E 19 C1 1F 60 A0 31 C6 37 CE 06 E6 6E
 B2 C5 06 E7 ED C5 1D 06 68 EB F2 69 C2 1D C5 20
 E9 E7 D5 2E A0 2E 18 C2 35 A0 2E C5 1D 3E 19 31
 B3 33 19 3E 1B 1F C0 00
  Encoded length: 296 bytes
  Wall pattern: 00, Wall color: 12     Floor pattern: 06, Floor color: 08
  Flags: WRAP_H WRAP_V 
  Random food adds: 0
  Secret trick:  1 - Try Transportability (onto demon)
 02 02 02 02 02 02 02 02 02 02 02 02 02 02 02 02 02 02 02 02 02 02 02 02 02 02 02 02 02 02 02 02
 02 35 02 00 00 00 00 00 21 21 21 02 30 02 00 00 00 00 00 01 00 00 62 00 56 02 56 00 62 00 00 00
 00 00 00 00 00 02 30 02 00 62 00 00 00 00 00 00 02 35 02 00 00 00 00 00 00 02 00 00 00 00 00 01
 02 02 02 02 02 00 02 00 02 02 02 02 02 02 02 02 00 02 25 02 02 02 02 02 02 02 02 02 02 02 02 02
 24 09 00 00 00 00 00 00 25 62 25 00 00 00 00 00 00 00 08 32 00 02 02 02 00 30 00 02 02 02 50 08
 02 00 00 00 00 00 00 00 00 25 00 00 00 00 00 00 00 00 02 00 12 07 08 07 00 00 00 07 08 09 11 32
 02 00 00 00 00 00 00 00 00 00 00 00 00 00 00 00 00 00 00 00 12 07 07 09 00 00 00 09 07 07 11 00
 00 00 00 00 00 00 00 00 00 00 00 00 00 00 00 00 00 00 00 00 12 08 09 08 00 16 00 07 08 09 11 00
 00 00 00 00 00 00 00 00 00 00 00 00 00 00 00 00 00 00 00 00 12 09 07 08 00 00 00 08 09 08 11 00
 02 00 00 00 00 00 00 00 00 25 00 00 00 00 00 00 00 00 02 00 12 08 07 09 00 00 00 07 08 07 11 00
 25 08 00 00 00 00 00 00 25 62 25 00 00 00 00 00 00 00 09 32 50 02 02 02 00 30 00 02 02 02 00 32
 02 02 02 02 02 00 02 00 02 04 02 02 02 02 02 02 00 02 24 02 02 02 02 02 02 02 02 02 02 02 02 02
 00 00 00 00 00 02 33 02 00 62 00 00 00 00 00 00 02 35 02 00 00 00 00 00 00 02 00 00 00 00 00 01
 02 35 02 00 00 00 00 00 21 21 21 02 33 02 00 00 00 00 00 01 00 00 62 00 56 02 56 00 62 00 00 00
 02 02 02 02 02 02 02 02 02 02 02 02 02 02 02 02 02 02 02 02 02 02 02 02 02 02 02 02 02 02 02 02
 35 00 00 00 25 46 02 46 00 00 24 46 02 00 00 00 00 00 31 00 00 25 62 10 10 02 49 00 62 00 00 00
 00 00 00 00 00 02 00 00 00 00 00 00 00 02 00 00 00 00 00 00 00 00 00 00 00 02 00 00 00 00 00 00
 00 00 00 00 02 00 00 00 00 00 00 00 00 00 02 00 00 00 00 00 00 00 00 00 00 02 00 00 00 00 00 00
 00 00 00 46 00 00 00 00 00 00 00 00 00 00 00 46 00 00 00 00 32 00 00 00 00 02 00 00 00 00 35 00
 00 00 02 00 00 00 00 00 00 00 00 00 00 00 00 00 02 00 00 00 00 00 00 00 00 06 00 00 00 00 00 00
 00 02 00 00 00 00 00 00 00 55 00 00 00 00 00 00 00 02 00 00 00 00 00 00 33 06 00 00 00 00 00 00
 02 46 00 00 00 00 00 00 00 00 00 00 00 00 00 00 00 47 02 00 00 00 00 00 00 06 35 00 00 00 00 00
 02 00 00 00 00 00 54 00 00 15 00 00 00 00 00 00 00 00 02 46 00 00 00 00 25 62 25 00 00 00 00 46
 24 00 00 00 00 00 00 00 00 00 00 00 54 00 00 00 00 00 24 02 02 02 02 02 02 04 02 02 02 02 02 02
 02 00 00 00 00 00 00 00 00 00 00 00 00 00 00 00 00 00 02 46 00 00 00 00 25 62 25 00 00 31 00 46
 02 49 00 00 00 00 00 00 00 55 00 00 00 00 00 00 00 00 02 00 00 00 00 00 00 06 00 00 00 00 00 00
 00 02 00 00 00 00 00 00 00 00 00 00 00 00 00 00 00 46 02 00 00 00 00 00 00 06 00 00 00 00 00 00
 00 00 02 00 00 00 00 00 00 00 00 00 00 00 00 00 00 02 00 00 00 00 00 00 29 06 00 00 00 00 00 00
 00 00 00 46 00 00 00 00 00 00 00 00 00 00 00 00 02 00 00 00 00 00 00 00 00 02 00 00 00 00 00 00
 00 00 00 00 02 00 00 00 00 00 00 00 00 00 00 46 00 00 00 29 00 00 00 00 00 02 32 00 00 00 00 00
 00 00 00 00 00 02 00 00 00 00 00 00 00 00 02 00 00 00 00 00 00 00 00 00 00 02 00 00 00 00 00 00
 00 00 00 00 00 46 02 46 24 00 00 00 53 02 46 00 00 00 00 00 00 29 62 25 49 02 51 25 62 27 31 00
