Gauntlet II
Maze number: 69
Offset for maze 68: 230841 - 0x0385b9
big endian buf: [%!l(uint8=0) %!l(uint8=3) %!l(uint8=133) %!l(uint8=185)]
G:2 Maze real addr: 247225 - 0x03C5B9, bank 2, boff: 0x4000
Maze read from: 0x03c5b9 - 247225
compresssed: 296
 03 00 00 00 20 02 A4 6E 5D 07 89 C3 34 43 C0 35
 1F CC 31 20 67 65 E6 27 CD 07 80 52 CB 36 0B C2
 27 DF C9 A1 C1 1F C2 B4 C8 B2 E3 C8 1C C2 0A C1
 0E C5 24 E0 E3 E0 C8 51 C4 0E C4 32 A1 E3 C0 24
 E0 ED C5 1E E5 E0 C5 51 E8 EC 22 A0 62 A6 0D 82
 A0 C4 1C E0 D0 31 E3 DA B2 E3 C3 B4 E3 C3 B2 41
 47 E0 1D E0 1C E1 64 E2 41 1D 2E E9 1C C1 A1 E4
 E3 42 C6 B2 E3 EE C6 2A E2 C4 B2 A0 20 EB 34 E9
 0D 82 E1 E8 E0 2E A0 E2 35 E4 38 C2 0C C0 A1 C4
 A2 E0 E2 41 A2 35 E2 C1 B2 E0 35 E0 E2 2E E6 C5
 05 C0 A1 22 C0 71 A0 E2 E1 E1 1D A2 C4 B2 E2 40
 A0 72 72 A0 E0 31 E0 E0 E2 C4 22 E1 C5 72 A0 E1
 E1 C3 36 A0 C1 18 E5 C0 0F C0 A1 C1 1E E0 E0 C6
 A1 C3 A1 C4 A2 E4 C2 A6 C6 22 A0 04 A0 C6 A2 2A
 CE 18 C2 07 A1 2E 42 A0 C6 AA B6 E2 3E 08 32 A1
 C0 A1 1E E5 2E 31 2A 16 84 E4 C0 07 E3 48 AB E0
 E2 C3 05 E7 31 2E 24 14 84 63 C1 3E A0 24 C2 05
 C2 A2 41 AB C1 1C C0 07 10 A0 C2 05 E1 33 18 2E
 E1 2F C0 27 15 84 62 00
  Encoded length: 296 bytes
  Wall pattern: 02, Wall color: 04     Floor pattern: 00, Floor color: 10
  Flags: WRAP_H 
  Random food adds: 0
  Secret trick:  3 - Try Transportability (into exit)
 02 02 02 02 02 02 02 02 02 02 02 02 02 02 02 02 02 02 02 02 02 02 02 02 02 02 02 02 02 02 02 02
 00 00 00 00 52 07 00 00 00 46 02 53 31 00 00 00 00 00 00 00 00 00 00 00 00 00 49 32 00 00 00 00
 00 00 00 00 29 07 00 00 00 00 02 29 00 00 00 00 00 00 00 02 39 00 00 00 00 00 00 00 00 00 00 00
 00 00 00 07 07 07 00 00 00 00 02 00 00 00 00 00 00 00 54 11 02 00 00 39 00 00 00 00 00 00 00 00
 00 00 00 00 00 00 00 00 00 00 02 00 00 00 00 00 00 00 00 00 02 00 00 00 00 00 00 00 00 00 00 00
 00 00 02 02 00 00 31 00 00 00 02 00 00 00 00 00 00 00 00 00 02 00 00 00 00 02 00 00 00 00 00 00
 00 00 00 28 07 00 00 10 00 00 14 00 00 00 00 00 00 36 00 02 00 00 00 00 02 00 02 00 00 00 00 00
 00 00 00 00 07 00 00 00 00 00 14 00 00 00 00 00 50 02 02 00 00 00 00 02 00 36 00 02 00 00 00 00
 00 07 00 00 00 00 00 00 00 00 02 00 00 00 00 00 02 30 00 00 00 00 00 00 02 00 02 00 00 00 00 00
 00 07 00 00 00 00 00 00 00 00 00 02 00 00 00 00 02 00 00 00 00 00 00 00 00 02 34 02 00 00 00 29
 02 02 02 02 02 02 02 13 13 13 13 02 00 00 00 00 02 28 00 02 00 00 00 00 00 00 02 00 00 00 00 00
 00 00 00 00 00 49 02 00 00 00 02 00 00 00 00 00 02 00 00 00 00 00 00 00 00 00 02 00 00 00 00 00
 00 00 00 00 00 00 02 00 00 00 00 02 00 00 00 00 02 00 00 00 00 02 00 00 00 00 02 00 00 46 00 00
 00 00 00 00 00 02 46 00 02 29 00 02 28 00 00 02 00 00 00 00 00 29 00 00 00 02 00 00 46 29 46 00
 00 00 00 00 00 02 00 00 00 02 28 00 02 02 02 00 00 00 00 00 02 00 00 00 00 02 00 00 00 46 00 00
 00 00 00 00 00 02 00 00 00 00 02 00 02 00 00 00 00 00 00 00 00 00 00 00 00 00 02 00 00 00 00 00
 00 00 42 00 00 00 02 00 00 00 00 00 02 02 32 00 00 00 00 00 00 00 00 00 00 00 00 02 52 00 00 00
 00 00 00 00 00 00 00 02 13 13 13 02 00 00 02 00 00 00 00 00 00 00 00 00 02 00 02 46 02 00 00 00
 02 53 00 00 00 00 00 02 56 00 00 02 12 00 02 02 00 00 00 00 00 02 02 02 00 02 00 00 00 02 00 00
 46 02 02 02 53 00 00 00 02 00 00 02 00 02 53 00 02 00 00 00 02 46 00 00 00 00 00 00 00 02 00 00
 00 02 00 00 05 00 02 02 34 00 09 00 00 02 00 00 00 02 00 00 02 00 00 02 29 02 02 02 00 00 02 00
 00 02 00 00 00 02 00 46 02 09 00 00 00 09 00 00 00 02 00 02 49 00 02 00 02 00 00 00 02 00 02 00
 00 00 34 00 00 02 00 00 00 00 00 00 09 00 00 00 02 00 00 02 00 00 02 00 00 00 00 54 02 00 02 24
 00 00 00 00 00 00 02 00 15 00 02 02 00 00 30 00 02 00 02 00 00 00 00 00 00 00 02 02 00 00 02 00
 02 02 00 00 00 00 00 02 02 02 00 00 00 00 00 02 00 00 00 02 02 02 02 02 02 02 00 00 00 00 02 00
 00 34 02 04 02 00 00 00 00 00 00 00 02 02 02 42 00 00 00 00 00 00 00 00 00 00 00 00 00 00 02 24
 00 00 00 07 02 02 46 00 00 00 46 02 00 00 00 00 00 00 00 02 02 02 02 02 02 02 02 02 02 02 02 00
 00 00 02 62 08 50 02 02 00 02 02 30 00 00 00 00 00 00 02 46 49 42 22 22 22 22 22 22 00 00 00 00
 00 02 00 07 00 00 00 00 02 00 00 00 00 00 00 00 00 00 46 02 02 02 02 02 02 02 02 02 02 02 02 00
 02 00 00 00 02 00 00 00 00 05 00 00 00 00 00 00 00 00 02 49 46 36 20 20 20 20 20 20 00 00 00 00
 29 00 00 62 02 36 00 00 00 05 00 00 00 02 02 02 00 00 46 02 02 02 02 02 02 02 02 02 02 02 02 00
 00 28 00 07 16 02 00 00 00 05 00 00 02 51 24 46 00 00 02 47 00 39 21 21 21 21 21 21 00 00 00 29
 02 02 02 02 02 02 02 02 02 02 02 02 02 02 02 02 02 02 02 02 02 02 02 02 02 02 02 02 02 02 02 02
