Gauntlet II
Maze number: 98
Offset for maze 97: 231587 - 0x0388a3
big endian buf: [%!l(uint8=0) %!l(uint8=3) %!l(uint8=136) %!l(uint8=163)]
G:2 Maze real addr: 256163 - 0x03E8A3, bank 3, boff: 0x6000
Maze read from: 0x03e8a3 - 256163
compresssed: 337
 0C 00 00 00 02 00 E1 AE B5 0E 4D 10 80 19 80 C0
 40 2A C0 61 05 C0 32 A0 60 A0 2E A0 1F 2E 81 C4
 29 81 C8 A2 18 C0 05 A0 D0 18 C6 40 09 A1 05 80
 08 81 2E A0 C3 A3 76 82 A1 C0 1E C0 09 80 E4 C5
 2C 73 81 B4 C3 B3 65 A3 C1 B4 0D 84 E6 C2 0A A0
 C7 43 A0 C8 A1 E1 C2 33 A4 0D A0 B2 C9 B4 C2 09
 40 09 C1 A4 31 C0 0C C5 B2 A0 E9 C1 A2 C2 3E C4
 3E E5 C2 2C CF A1 C0 B3 A1 0D E1 C3 2E 31 C1 07
 80 C0 41 1D C1 A2 08 B4 46 22 E0 C0 1D B4 A2 C0
 28 80 A6 32 E3 C1 2A C4 A1 C3 44 2E 0C C0 40 B2
 A0 C1 15 81 A0 C2 A1 B6 A1 CB 1C C2 23 C2 A1 C1
 A2 C1 07 E3 C9 B3 A1 E5 E4 C0 20 E3 C1 B7 C2 BF
 E3 C6 A4 C3 B2 E5 C2 A2 F8 C7 A2 B7 C4 20 EB 31
 C7 14 0E CD 42 B3 C9 B2 14 AF B3 C9 B2 CD 64 0E
 E0 C1 1E CC A4 C1 A1 E0 1D EA C7 60 25 E0 C0 B3
 45 0D A0 E2 B5 0D C3 49 26 05 A1 15 A2 B2 C0 A3
 18 36 C2 A3 C9 41 A0 C5 35 18 C0 3E C0 0B C0 1C
 60 2E B4 C0 B6 C1 42 49 51 C0 18 81 C2 A1 B2 C5
 A4 B2 78 81 B3 A3 D1 19 C7 0E E0 3E C5 A1 C6 51
 C5 54 E4 E7 1C C1 B8 E2 C0 A1 E4 C2 A1 C3 BE 0F
 E8 35 A0 35 A0 40 A0 35 A0 35 A0 2C C1 2E A0 42
 00
  Encoded length: 337 bytes
  Wall pattern: 00, Wall color: 01     Floor pattern: 00, Floor color: 14
  Flags: SHOTS_HURT 
  Random food adds: 0
  Secret trick: 12 - Don't Be Greedy (no keys or potions)
 02 02 02 02 02 02 02 02 02 02 02 02 02 02 02 02 02 02 02 02 02 02 02 02 02 02 02 02 02 02 02 02
 02 16 25 25 02 46 00 42 00 53 00 00 05 00 50 02 53 00 02 46 02 31 46 02 46 00 00 00 00 00 41 41
 02 00 00 00 02 00 00 00 00 02 02 02 02 24 00 05 02 00 00 00 00 00 00 02 00 00 00 00 00 00 00 00
 02 00 24 00 02 00 00 00 00 02 46 00 09 02 02 05 05 08 08 08 46 02 00 02 00 00 02 02 02 02 00 00
 02 00 00 00 02 13 13 13 13 02 02 00 30 00 09 09 00 00 00 00 00 02 00 02 00 00 00 00 44 02 00 00
 02 13 13 13 02 00 00 00 00 02 53 00 00 00 00 00 00 02 02 02 02 00 00 02 13 13 13 13 13 02 00 00
 02 00 00 00 00 02 00 00 00 10 02 00 00 00 00 00 00 00 02 46 00 02 00 00 02 00 00 00 00 02 00 00
 02 00 02 02 00 00 02 00 00 00 51 02 02 02 02 02 13 02 02 02 00 02 00 00 00 02 00 00 00 02 00 00
 02 09 46 00 09 00 00 02 02 02 02 02 49 00 12 02 00 00 00 02 00 02 02 00 00 02 00 00 02 00 00 00
 02 02 00 00 02 02 02 00 00 00 62 02 00 00 00 02 62 00 00 02 00 00 00 02 00 02 00 44 02 00 00 00
 02 00 00 00 00 00 00 00 00 00 00 02 02 02 00 02 02 02 13 02 00 02 00 00 00 02 46 49 02 00 07 07
 02 46 00 00 29 00 02 02 02 02 08 02 46 00 00 00 00 00 00 02 34 00 02 00 29 02 02 02 02 00 40 40
 02 02 02 02 02 02 02 50 00 02 00 00 02 00 00 42 00 00 00 02 00 02 02 00 00 00 00 46 02 00 00 00
 02 46 12 02 46 00 02 02 00 02 21 21 21 02 00 00 00 02 02 02 02 02 00 00 00 00 00 00 02 00 00 00
 02 00 28 02 00 00 35 00 00 02 02 02 00 00 02 02 02 00 00 07 00 00 02 00 02 00 00 00 02 00 00 00
 02 00 00 02 02 02 00 00 00 02 00 00 02 00 00 00 00 00 02 00 32 00 02 00 00 02 00 00 02 00 00 00
 02 00 00 00 00 02 00 00 00 02 00 00 00 02 02 02 02 02 00 00 00 00 02 00 00 00 02 00 00 02 00 00
 02 02 02 02 00 00 00 00 00 02 00 00 00 00 00 00 00 00 00 00 00 00 00 02 00 00 02 00 00 02 00 00
 02 00 00 00 00 02 02 02 02 02 00 00 00 00 00 32 00 00 00 00 00 00 00 02 00 00 02 00 02 49 02 00
 02 00 02 00 00 02 20 14 00 00 00 00 00 00 00 00 00 00 00 00 00 00 46 02 00 00 02 00 00 00 02 00
 02 00 02 00 00 02 20 02 02 02 02 02 02 02 02 02 02 02 02 02 02 02 02 02 00 00 00 00 00 00 02 00
 02 00 02 00 00 00 00 02 00 00 00 00 00 00 00 00 02 53 00 00 00 00 00 14 00 02 00 00 30 00 02 00
 02 00 00 00 00 02 00 02 00 02 02 02 02 02 02 00 02 02 02 00 02 29 00 02 00 00 00 00 00 00 02 00
 02 02 00 00 00 02 00 02 00 02 53 00 37 00 02 00 02 46 00 00 00 00 00 02 13 02 00 00 00 02 02 13
 02 00 00 00 46 02 00 02 00 02 00 00 00 00 00 38 05 02 02 21 02 02 02 02 00 02 02 02 02 24 54 00
 02 00 02 02 02 02 00 02 00 02 00 00 00 00 00 02 46 00 00 02 00 00 14 00 00 14 53 24 02 62 00 11
 02 28 53 02 46 02 00 02 00 02 46 00 00 00 46 02 00 00 00 00 00 00 14 00 00 14 00 24 02 24 00 00
 02 02 02 02 00 00 00 00 00 02 02 02 02 02 02 02 00 00 00 00 00 00 14 00 00 13 13 13 02 02 02 02
 02 00 00 00 00 00 00 00 00 02 00 00 00 00 00 14 00 00 00 25 00 00 14 00 00 00 00 00 14 00 02 62
 02 00 00 00 00 00 02 02 00 02 00 00 00 00 00 14 00 00 00 00 00 00 14 00 00 00 00 00 02 00 00 00
 02 00 00 00 00 02 28 00 00 02 00 00 00 02 00 02 02 00 00 00 00 00 02 00 00 00 02 02 00 00 00 00
 02 15 00 00 00 00 00 00 00 00 00 02 53 02 53 02 46 00 02 53 02 53 02 44 00 00 46 02 46 00 00 00
 02 02 02 02 02 02 02 02 02 02 02 02 02 02 02 02 02 02 02 02 02 02 02 02 02 02 02 02 02 02 02 02
