Gauntlet II
Maze number: 105
Offset for maze 104: 233169 - 0x038ed1
big endian buf: [%!l(uint8=0) %!l(uint8=3) %!l(uint8=142) %!l(uint8=209)]
G:2 Maze real addr: 257745 - 0x03EED1, bank 3, boff: 0x6000
Maze read from: 0x03eed1 - 257745
compresssed: 217
 0E 00 00 88 20 61 95 6E 90 48 49 A0 2E 41 61 2E
 A0 2F 40 A0 65 2E A0 66 68 A0 C2 04 C1 A4 07 A0
 08 81 4C E4 43 7D 80 B3 C1 B3 A0 E4 49 45 56 75
 80 A3 C2 A1 B3 C1 B3 A3 43 50 4A 4A C2 A4 42 A2
 D0 B4 C9 07 A0 2E 45 41 A5 46 C3 B4 C7 B2 C1 B4
 07 47 48 57 CB A2 C4 A5 C4 A4 41 C1 A2 DF DF C4
 B4 C9 B6 DF CE 0F 41 42 C1 0F 41 43 C1 0F 41 C0
 B4 41 C4 07 81 DB B4 C4 B4 C2 B4 C5 B4 C2 B4 C5
 B4 DF C5 B3 48 CF A2 42 A5 C5 A4 C5 A1 2E D3 2E
 09 D8 B6 48 B4 C6 A4 D2 2E 48 42 C3 A4 07 81 73
 A3 07 B3 C8 B3 42 C9 B3 42 41 78 C1 B4 EE C1 A4
 74 52 C5 B5 E6 C8 A4 C1 04 A2 56 A1 09 04 C3 B2
 43 E2 E1 2E 4A E0 E0 63 2E B2 60 A0 42 A0 62 B3
 2F 41 B3 10 2E A0 41 A0 00
  Encoded length: 217 bytes
  Wall pattern: 01, Wall color: 05     Floor pattern: 06, Floor color: 09
  Flags: EXIT_CHOOSE_ONE WALLS_CYCLIC WRAP_H 
  Random food adds: 0
  Secret trick: 14 - Go On a Diet (no food)
 02 02 02 02 02 02 02 02 02 02 02 02 02 02 02 02 02 02 02 02 02 02 02 02 02 02 02 02 02 02 02 02
 02 46 00 02 46 16 02 00 46 02 47 00 46 02 16 00 00 00 00 00 00 46 02 16 00 00 00 00 00 00 00 16
 00 00 00 02 00 00 02 00 00 02 00 00 00 04 00 00 02 02 02 02 02 07 02 08 08 02 00 00 02 00 00 00
 00 00 00 02 00 00 02 46 00 00 00 00 00 02 00 00 00 00 46 00 00 00 00 00 00 02 00 00 02 00 00 00
 02 09 09 02 00 00 02 02 00 00 00 00 00 02 00 00 00 00 00 00 00 00 00 00 46 02 00 00 02 00 00 46
 02 00 00 00 00 00 00 08 00 00 02 00 00 00 09 09 02 02 02 02 00 00 02 02 02 02 00 00 02 02 02 02
 02 00 00 00 00 46 00 08 00 00 02 00 00 00 00 00 00 00 00 46 00 00 02 00 00 00 00 00 00 00 00 46
 02 00 00 02 02 02 02 02 00 00 02 46 02 02 02 00 00 00 00 02 00 00 02 00 00 00 00 00 00 00 00 00
 02 00 00 00 00 00 00 00 00 00 02 07 02 46 00 00 02 00 00 02 46 00 02 46 02 02 02 02 02 02 00 00
 00 00 00 00 00 46 00 00 00 00 02 00 00 00 00 00 02 00 00 02 00 00 02 07 00 00 00 00 00 00 00 00
 46 00 00 00 00 02 00 00 00 00 46 00 00 00 00 00 02 00 00 08 00 00 00 00 00 00 00 00 00 00 00 00
 02 02 02 00 00 02 00 00 02 02 02 02 02 02 00 00 02 00 00 02 02 02 02 02 00 00 46 00 00 02 02 02
 00 00 00 00 00 02 00 00 00 00 00 00 00 00 00 00 02 00 00 00 00 00 00 00 00 00 02 00 00 00 00 00
 00 00 00 00 00 02 00 00 00 00 00 00 00 00 00 00 02 00 00 00 00 00 00 00 00 00 02 00 00 00 00 00
 00 00 02 00 00 02 00 00 02 00 00 00 02 00 00 00 02 00 00 02 00 00 00 02 00 00 02 00 00 00 02 00
 00 00 02 00 00 00 00 00 02 00 00 00 02 00 00 00 00 00 00 02 00 00 00 02 00 00 02 00 00 00 02 00
 15 00 02 46 00 00 00 46 02 00 15 00 02 46 00 00 00 00 46 02 00 15 00 02 46 00 02 00 00 46 02 00
 00 00 02 07 07 02 00 00 02 00 00 00 02 00 00 00 02 00 00 02 00 00 00 02 00 00 00 00 00 00 02 00
 00 00 02 00 00 02 00 00 02 00 00 00 02 00 00 00 02 00 00 02 00 00 00 02 00 00 00 00 00 00 02 00
 00 00 00 00 00 02 00 00 00 00 00 00 00 00 00 00 02 00 00 00 00 00 00 00 00 00 00 02 00 00 00 00
 00 00 00 00 00 02 00 00 00 00 00 00 00 00 00 46 02 00 00 00 00 00 00 00 00 00 00 02 00 00 00 00
 02 02 02 00 00 00 46 02 02 02 02 02 02 00 00 00 02 00 00 02 02 02 02 02 00 00 00 02 00 00 02 02
 46 00 00 00 00 00 00 00 00 00 00 00 00 00 00 00 02 00 00 00 00 46 09 00 00 00 00 02 00 00 00 00
 02 00 00 00 00 00 00 00 00 00 02 00 00 02 00 00 02 00 00 00 00 02 00 00 00 02 46 02 00 00 00 00
 02 00 00 02 02 02 02 02 00 00 02 00 00 02 00 00 00 00 00 00 00 02 00 00 00 02 00 46 00 00 00 00
 02 00 00 00 00 46 00 00 00 46 02 00 00 02 02 02 02 02 02 07 07 02 00 00 00 02 09 02 02 02 02 07
 02 00 00 00 00 00 00 00 00 00 02 00 00 02 46 00 00 00 00 00 00 02 00 00 00 02 00 00 00 46 00 00
 46 00 00 00 00 00 00 00 00 00 09 00 00 02 00 00 00 00 00 00 00 02 00 00 00 00 00 00 00 02 00 00
 02 02 02 02 02 00 00 00 00 00 09 00 00 00 08 00 00 00 00 02 00 02 00 00 02 00 00 00 00 02 00 00
 00 00 02 00 00 00 02 02 02 02 02 02 00 00 04 02 02 02 00 02 00 00 00 00 02 08 02 02 09 04 00 00
 00 00 02 00 00 00 02 46 00 00 00 02 00 00 02 46 00 00 00 02 00 00 00 00 02 00 00 46 00 02 00 02
 16 00 00 00 00 46 02 16 00 02 00 00 00 46 02 16 00 00 00 02 47 00 00 46 02 16 46 02 00 00 46 02
 02 02 02 02 02 02 02 02 02 02 02 02 02 02 02 02 02 02 02 02 02 02 02 02 02 02 02 02 02 02 02 02
