Gauntlet II
Maze number: 116
Offset for maze 115: 236841 - 0x039d29
big endian buf: [%!l(uint8=0) %!l(uint8=3) %!l(uint8=157) %!l(uint8=41)]
G:2 Maze real addr: 261417 - 0x03FD29, bank 3, boff: 0x6000
Maze read from: 0x03fd29 - 261417
compresssed: 287
 00 00 00 00 00 31 DA 43 4D 0E 41 DF C0 1F C3 1F
 C7 1F C5 1C C6 1F C5 AF A7 DF 7A 71 32 A4 C2 A5
 7A 71 E7 C5 32 C3 1F 77 E6 04 C0 2E A0 DB 32 D0
 01 80 B6 A0 C6 3E D6 32 CC 04 B5 CB 3F C1 3F A0
 B2 C0 B3 C3 2B C3 2C D1 15 C1 04 C0 B5 C0 B6 A1
 16 C1 A4 C0 B7 CB A2 C3 2E CC B8 C9 2A C6 3E C3
 3E 01 D0 A5 B2 A1 B7 C1 B7 A3 B8 07 80 04 A1 BC
 C2 BF 12 82 C0 2E 0A C2 13 C6 14 C3 2E 07 C6 12
 80 29 B5 C5 18 C2 0F C8 07 1F C5 A2 04 07 82 A5
 C2 AE 28 03 C9 2E C4 0E 08 2D 08 C2 35 45 40 C7
 3E 64 3E C0 08 63 82 43 C1 A5 C4 17 C0 0B 0E C0
 0E C1 35 C2 32 43 40 C6 04 65 35 0D 60 62 82 E2
 C3 A3 41 C4 35 0E 35 0E C2 54 35 54 C0 54 43 42
 42 66 60 60 C3 A2 E2 C1 B6 A0 40 A0 B2 E0 C6 0E
 C0 0E C4 A2 42 49 C3 B8 A6 B2 B2 32 81 46 C1 A3
 40 6C 81 4A C6 51 C2 51 C2 35 48 E2 E0 E0 C2 35
 80 04 A7 0D 81 B5 C3 B3 C0 B3 C0 B4 E1 E1 D2 BE
 E6 41 C1 BD C1 51 C2 51 C0 2E C2 51 C2 35 00
  Encoded length: 287 bytes
  Wall pattern: 01, Wall color: 10     Floor pattern: 03, Floor color: 13
  Flags: 
  Random food adds: 0
  Secret trick:  0 - No trick
 02 02 02 02 02 02 02 02 02 02 02 02 02 02 02 02 02 02 02 02 02 02 02 02 02 02 02 02 02 02 02 02 02
 02 00 00 00 00 00 00 00 00 00 00 00 00 00 00 00 00 00 00 00 00 00 00 00 00 00 00 00 00 00 00 00 02
 02 31 00 00 00 00 31 00 00 00 00 00 00 00 00 31 00 00 00 00 00 00 28 00 00 00 00 00 00 00 31 00 02
 02 00 00 00 02 02 02 02 02 02 02 02 02 02 02 02 02 02 02 02 02 02 02 02 02 02 02 02 02 00 00 00 02
 02 00 00 00 02 00 00 00 00 00 00 00 00 00 00 00 00 00 00 00 00 00 00 00 00 00 00 00 02 00 00 00 02
 02 00 00 00 02 00 00 00 01 00 00 01 50 02 02 02 02 02 00 00 02 02 02 02 02 02 02 00 02 00 00 00 02
 02 00 00 00 02 00 01 00 00 01 00 00 02 00 00 00 00 00 02 00 02 00 00 00 02 50 02 00 02 00 31 00 02
 02 00 00 00 02 00 00 01 00 00 02 00 02 00 00 02 04 00 46 02 02 00 02 00 02 00 02 00 02 00 00 00 02
 02 00 00 00 02 00 00 00 02 00 02 00 02 00 02 00 50 02 00 00 02 00 02 00 02 00 02 00 02 00 00 00 02
 02 00 01 01 02 02 02 00 02 00 02 00 02 62 02 00 00 02 00 00 02 00 02 00 02 00 02 00 02 00 00 00 02
 02 00 00 00 00 50 02 00 02 00 02 00 02 00 02 00 00 02 00 04 02 00 02 00 02 00 02 00 02 00 00 00 02
 02 63 00 00 63 02 02 00 02 00 02 00 02 43 02 00 00 02 44 00 00 00 02 00 02 00 02 00 02 00 00 00 02
 02 00 00 00 02 21 00 00 04 00 02 00 02 02 02 22 00 02 02 02 02 02 02 00 02 00 02 00 02 00 00 00 02
 02 00 00 00 02 02 02 02 00 00 00 02 46 00 02 00 00 02 00 00 00 00 02 00 00 00 02 00 02 00 00 00 02
 02 00 00 00 02 42 00 00 00 00 00 02 00 62 02 00 00 02 62 01 00 00 02 00 00 00 00 00 02 00 00 00 02
 02 00 00 00 02 02 02 02 02 02 02 02 02 02 02 00 00 02 02 02 02 02 02 07 07 04 02 02 02 00 00 00 02
 02 18 18 18 02 00 46 10 00 00 00 19 00 00 00 00 00 00 00 20 00 00 00 00 46 07 00 00 00 00 00 00 02
 02 18 18 41 02 00 00 00 00 00 00 24 00 00 00 15 00 00 00 00 00 00 00 00 00 07 31 00 00 00 00 00 02
 02 02 02 02 04 07 07 07 07 02 02 02 02 02 02 00 00 02 02 02 02 02 02 02 02 02 02 02 02 02 02 02 02
 02 40 03 00 02 00 00 00 00 00 00 00 00 46 02 00 00 02 00 14 08 45 08 00 00 14 53 14 00 14 00 00 02
 02 03 00 03 02 00 00 00 00 00 00 00 62 00 02 00 00 02 13 62 00 08 00 00 00 14 13 14 13 14 00 00 02
 02 00 03 00 02 02 02 02 02 02 02 00 00 00 02 00 23 02 11 14 00 14 00 00 53 14 00 14 50 14 00 00 02
 02 03 00 03 02 00 00 00 00 00 00 04 00 00 02 00 00 02 13 53 13 00 13 00 00 14 13 14 13 14 00 00 02
 02 02 00 00 02 00 02 02 02 02 00 00 03 00 02 00 00 02 53 14 53 14 00 00 00 14 53 14 00 14 00 00 02
 02 00 03 00 02 00 03 00 00 02 03 00 00 00 02 00 00 02 13 00 13 00 13 00 00 02 02 02 02 02 00 00 02
 02 02 00 00 02 02 00 03 02 02 00 02 00 00 02 00 00 02 00 14 00 14 00 00 00 02 02 02 02 02 00 00 02
 02 03 00 00 00 00 02 00 00 00 00 00 03 00 02 00 00 02 02 02 02 02 02 02 02 02 02 50 50 02 00 00 02
 02 00 02 00 02 03 02 00 02 02 02 02 00 03 02 00 00 14 00 00 00 14 00 00 00 00 00 13 13 02 00 00 02
 02 00 02 00 02 00 02 00 00 03 00 00 00 00 02 00 00 14 00 00 00 14 00 00 00 53 00 00 00 02 00 00 02
 02 00 02 03 02 00 02 02 00 02 00 02 00 00 02 53 53 04 02 02 02 02 02 02 02 02 13 13 13 02 00 00 02
 02 00 02 00 02 00 02 00 00 02 00 00 02 00 02 00 00 14 00 00 00 14 00 00 00 00 00 14 00 00 00 00 02
 02 00 00 00 00 00 00 00 02 00 00 03 00 00 02 00 00 14 00 00 00 14 00 46 00 00 00 14 00 00 00 53 02
 02 02 02 02 02 02 02 02 02 02 02 02 02 02 02 02 02 02 02 02 02 02 02 02 02 02 02 02 02 02 02 02 02
