Gauntlet II
Maze number: 53
Offset for maze 52: 234541 - 0x03942d
big endian buf: [%!l(uint8=0) %!l(uint8=3) %!l(uint8=148) %!l(uint8=45)]
G:2 Maze real addr: 242733 - 0x03B42D, bank 1, boff: 0x2000
Maze read from: 0x03b42d - 242733
compresssed: 259
 0E 00 00 80 60 52 19 01 6E 10 9C C1 31 C2 22 C1
 26 A1 2E 69 C0 32 25 C5 51 61 A1 51 DA 51 C6 52
 CB B2 A2 52 C3 41 CC 0F CD 52 C4 10 81 C5 54 C3
 54 65 C6 1D C5 52 A1 61 63 C1 54 10 81 C2 A2 C2
 41 69 41 2E A0 C2 72 54 C4 52 61 C3 7F C2 10 80
 2E C6 51 42 64 C6 42 C6 A2 D2 2E C5 51 62 52 68
 DF 53 70 52 C1 53 C8 1D A5 D3 52 C5 22 65 C2 56
 63 C4 54 C3 53 C3 41 C3 53 25 C5 A3 D5 55 CE 42
 CD 1D E0 CC 25 C9 52 C1 42 60 61 25 61 53 C3 42
 C1 55 C0 52 60 52 CC 52 C0 40 C1 52 6B C0 A1 C2
 A3 D3 51 66 C1 54 E1 2E 67 D3 2E C2 A4 C6 51 A0
 CA 24 C7 26 C7 26 61 C2 1D C0 52 C1 52 C4 41 C6
 53 C2 53 C5 52 61 CA 10 81 2E 61 CC A3 ED C6 52
 67 C6 51 C7 54 C6 42 C1 42 C2 55 C0 51 DF C5 43
 C2 53 C0 10 81 E7 C7 53 6C 10 31 51 2E 24 51 C1
 32 55 2E 1E 51 A1 52 C0 33 C0 55 24 2E A2 31 2E
 A0 1E 00
  Encoded length: 259 bytes
  Wall pattern: 02, Wall color: 09     Floor pattern: 05, Floor color: 01
  Flags: EXIT_CHOOSE_ONE WRAP_H EXIT_FAKE 
  Random food adds: 0
  Secret trick: 14 - Go On a Diet (no food)
 02 02 02 02 02 02 02 02 02 02 02 02 02 02 02 02 02 02 02 02 02 02 02 02 02 02 02 02 02 02 02 02
 00 16 49 00 00 00 34 16 00 38 02 16 46 00 16 00 00 00 00 16 00 00 00 46 02 50 37 00 16 00 00 00
 00 16 00 16 46 02 02 16 00 00 00 16 00 00 16 00 00 00 00 16 00 00 16 00 02 00 00 00 16 00 00 16
 00 00 00 16 00 00 00 00 00 00 00 16 00 00 16 00 00 00 00 16 00 00 16 00 02 02 02 16 16 00 00 16
 00 01 01 00 00 00 00 00 00 16 00 00 00 00 16 00 15 00 00 16 00 00 16 00 00 00 00 16 00 00 00 16
 00 00 00 00 00 16 16 16 00 16 00 00 00 00 16 00 00 00 00 16 00 00 16 00 00 00 46 16 00 00 00 00
 00 16 29 00 00 00 00 00 00 16 02 02 00 00 46 00 00 00 00 46 00 00 16 16 16 16 00 16 00 02 02 02
 00 16 00 01 01 00 00 00 00 00 00 00 00 00 00 46 01 01 46 02 00 00 00 28 00 00 00 16 00 00 00 00
 00 16 00 00 46 00 00 16 00 28 00 00 16 00 00 00 00 00 00 00 00 00 00 00 00 00 00 00 00 16 16 46
 00 00 00 00 16 00 00 16 01 01 01 00 16 00 00 16 46 00 00 00 00 16 00 00 01 01 01 00 00 00 00 16
 00 00 02 02 16 00 00 00 00 00 00 00 16 00 00 16 00 00 16 00 00 16 00 16 46 00 00 00 00 00 00 16
 00 00 00 46 16 00 00 00 00 16 00 00 16 00 46 16 00 00 16 00 00 16 00 16 00 00 16 00 16 00 00 00
 00 00 00 00 00 00 00 16 00 16 00 00 16 00 00 16 28 00 16 00 00 16 00 16 00 00 16 00 16 00 00 29
 02 02 02 02 02 02 00 16 00 16 00 00 16 00 00 00 00 00 00 00 00 00 00 16 00 00 16 00 16 00 16 00
 00 34 00 00 00 00 00 16 46 16 00 00 16 00 00 00 00 46 00 00 00 00 00 16 00 00 00 00 16 00 16 00
 00 01 01 00 00 00 00 16 37 16 00 00 00 00 00 02 02 02 02 00 16 00 00 00 00 00 00 00 00 00 16 00
 00 00 00 00 00 16 00 00 00 16 00 00 00 00 00 00 00 00 00 00 16 00 00 00 00 01 01 01 00 00 16 00
 16 00 00 16 00 16 00 00 00 00 29 00 02 16 00 00 00 16 00 00 16 00 16 00 00 00 37 00 00 00 16 00
 16 00 00 16 00 16 00 00 01 01 01 00 46 16 00 46 37 16 00 46 16 00 16 00 00 01 01 01 00 00 16 00
 16 00 46 16 00 00 00 00 00 00 00 00 00 16 00 00 00 16 00 01 00 00 16 00 00 00 00 00 00 00 00 00
 00 00 16 46 00 02 02 00 00 00 02 02 02 16 00 00 00 00 00 00 00 00 00 00 00 00 00 00 00 00 00 00
 00 00 16 00 00 00 00 00 00 00 46 00 00 16 00 00 02 46 00 00 00 00 00 00 00 16 46 00 00 16 00 16
 00 00 00 00 00 00 00 16 00 00 16 00 00 00 00 46 00 00 00 02 02 02 02 02 00 16 00 00 00 16 00 16
 02 00 00 00 16 00 00 16 00 00 16 00 36 00 16 00 00 00 00 00 00 38 00 00 00 16 00 16 00 16 38 00
 00 46 00 00 16 29 00 16 00 00 16 00 00 00 16 00 01 01 00 00 00 00 00 00 00 16 00 16 00 16 00 00
 00 16 00 00 16 00 00 46 00 00 00 00 00 00 16 00 00 00 00 16 16 16 46 00 00 46 00 16 00 00 00 00
 00 16 00 00 00 00 00 02 02 02 02 00 16 00 16 00 00 00 16 00 00 00 16 00 00 02 00 16 00 00 16 00
 00 16 00 00 00 00 00 00 00 00 46 00 16 00 16 00 16 00 16 00 16 00 16 00 00 00 00 16 00 00 16 00
 00 00 00 01 01 01 00 00 01 01 01 00 16 00 16 00 16 00 00 00 16 00 16 00 00 00 00 00 00 00 16 00
 00 00 00 00 00 00 00 00 00 00 00 00 16 00 00 00 00 00 16 00 16 00 16 01 01 01 01 00 00 00 16 00
 16 16 16 00 00 16 00 00 16 00 00 02 16 00 00 16 00 00 16 00 16 00 16 00 00 00 00 00 00 00 00 00
 00 00 46 16 49 16 46 36 16 00 00 50 16 46 30 16 02 02 16 00 51 00 16 36 46 02 02 02 49 46 02 30
 02 02 02 02 02 02 02 02 02 02 02 02 02 02 02 02 02 02 02 02 02 02 02 02 02 02 02 02 02 02 02 02
