Gauntlet II
Maze number: 55
Offset for maze 54: 235035 - 0x03961b
big endian buf: [%!l(uint8=0) %!l(uint8=3) %!l(uint8=150) %!l(uint8=27)]
G:2 Maze real addr: 243227 - 0x03B61B, bank 1, boff: 0x2000
Maze read from: 0x03b61b - 243227
compresssed: 472
 08 00 00 05 00 60 DD 45 49 08 07 18 80 09 C7 22
 0E C4 22 CB 2E 60 80 C8 0E D0 22 C2 2E C0 08 81
 05 09 81 05 A2 05 08 81 05 07 81 05 08 81 05 A1
 63 40 24 C1 0B C3 0A C3 3B C0 0A C6 21 A0 43 0B
 C1 A1 05 A2 05 08 81 05 09 81 05 08 81 05 09 81
 E9 21 C0 0B C5 0C C4 0B C2 23 05 C0 51 C5 B2 40
 41 08 81 05 A2 05 08 81 05 A2 05 E2 C3 52 40 60
 C1 24 C5 0C C6 21 C0 0B E1 43 60 0C 09 C0 72 C0
 A1 05 08 81 05 07 81 05 09 81 C2 52 60 65 60 40
 0A A0 1E C1 0B C4 0A C0 23 05 C0 B2 40 60 65 40
 0C 41 C0 07 81 05 09 81 05 A1 42 C1 0C 09 1F C2
 72 40 46 2A C1 0B C2 24 A0 62 E2 C2 22 05 0B C3
 52 C1 0C C1 08 82 05 C0 0C 05 C0 72 0A 09 C0 72
 E0 C4 37 C1 B2 40 C0 72 69 40 60 40 C7 52 40 35
 C0 0B 05 35 52 35 C4 72 60 42 C2 51 C1 BF C0 52
 0A 05 46 C0 72 C0 0F E1 0D A0 C0 51 C2 51 E0 43
 60 C2 72 44 07 80 A0 40 0B A0 0D A0 C1 0D A0 E0
 C0 20 61 60 C0 52 40 C0 52 C1 1E C2 0A 42 E0 0D
 B2 40 65 60 40 0C 09 35 05 C0 72 05 A2 05 08 51
 42 60 C2 71 63 40 0C 61 E0 21 C7 21 63 C0 51 0D
 44 64 C0 04 A0 05 07 81 05 A2 05 B2 62 40 0B C8
 72 40 2A CB 2A 72 40 60 C0 52 C4 0B 52 40 C0 08
 81 05 07 81 05 08 81 05 09 81 05 62 C1 21 C2 72
 40 E0 1E CF 1E 61 0C 60 81 40 60 C0 A1 05 09 81
 05 08 81 05 A2 05 07 81 05 B2 0B 05 67 2A C4 0B
 C6 0B C5 2A 68 05 07 81 05 08 81 05 07 81 05 08
 81 05 09 81 05 08 51 C6 24 C0 0A C6 0A C8 0C C3
 1E B5 C3 53 08 A2 09 81 A1 05 A1 08 81 09 81 07
 80 A0 04 A3 18 24 C8 22 CD 23 C4 24 0D 80 BE 22
 CE 22 C5 51 C4 0E 10 00
  Encoded length: 472 bytes
  Wall pattern: 00, Wall color: 13     Floor pattern: 06, Floor color: 13
  Flags: 
  Random food adds: 5
  Secret trick:  8 - Don't Use Invulnerability
 02 02 02 02 02 02 02 02 02 02 02 02 02 02 02 02 02 02 02 02 02 02 02 02 02 02 02 02 02 02 02 02
 02 24 09 00 00 00 00 00 00 00 00 34 14 00 00 00 00 00 34 00 00 00 00 00 00 00 00 00 00 00 00 46
 02 09 09 00 00 00 00 00 00 00 00 00 14 00 00 00 00 00 00 00 00 00 00 00 00 00 00 00 00 00 34 00
 02 00 46 00 08 08 08 05 09 09 09 05 02 02 02 05 08 08 08 05 07 07 07 05 08 08 08 05 02 02 00 00
 02 00 09 00 05 36 00 00 11 00 00 00 00 10 00 00 00 00 59 00 10 00 00 00 00 00 00 00 33 02 00 00
 02 00 05 11 02 00 02 02 05 02 02 02 05 08 08 08 05 09 09 09 05 08 08 08 05 09 09 09 00 08 00 00
 02 00 08 00 02 00 02 33 00 11 00 00 00 00 00 00 12 00 00 00 00 00 11 00 00 00 35 05 00 08 00 00
 02 00 08 00 02 00 05 00 07 05 08 08 08 05 02 02 02 05 08 08 08 05 02 02 02 05 00 08 00 02 00 00
 02 00 08 00 05 00 09 00 07 36 00 00 00 00 00 00 12 00 00 00 00 00 00 00 33 02 11 08 00 02 00 00
 02 00 05 00 09 12 09 00 07 00 02 02 05 08 08 08 05 07 07 07 05 09 09 09 00 02 00 08 00 09 00 00
 02 00 07 00 09 00 09 00 05 10 02 30 00 00 11 00 00 00 00 00 10 00 35 05 00 02 00 05 00 09 00 00
 02 00 07 00 09 00 05 12 08 00 05 00 07 07 07 05 09 09 09 05 02 02 00 07 00 05 00 07 12 09 31 00
 02 00 07 00 05 00 02 00 08 00 07 00 05 42 00 00 11 00 00 00 36 02 00 07 00 09 00 07 00 02 00 00
 02 34 05 11 08 00 02 00 08 00 07 12 08 00 08 08 08 08 05 07 12 05 00 07 10 09 00 07 00 02 00 00
 02 00 08 55 08 00 02 00 05 00 07 00 08 00 07 00 00 00 00 07 00 09 00 05 00 09 00 05 00 08 00 00
 02 00 08 00 08 00 05 53 07 11 05 53 08 53 07 00 00 00 00 07 00 09 00 08 00 05 00 08 00 08 00 00
 02 00 08 10 05 00 08 00 07 00 08 00 05 00 07 00 15 00 00 02 13 02 00 08 00 02 00 08 00 02 00 00
 02 00 05 00 09 00 08 00 07 00 08 00 07 00 05 07 07 02 00 05 11 02 13 02 00 02 13 02 00 02 00 32
 02 00 09 00 09 00 08 00 05 00 08 00 07 30 00 00 00 10 00 08 00 05 00 02 13 02 00 05 00 07 00 00
 02 00 09 00 09 00 05 12 09 53 05 00 07 05 02 02 02 05 08 08 00 02 00 05 00 09 00 08 00 07 00 00
 02 00 09 00 05 12 07 00 09 00 02 33 00 00 00 00 00 00 00 00 33 02 00 07 00 09 00 08 13 08 00 00
 02 00 05 00 08 00 07 00 09 00 04 02 05 07 07 07 05 02 02 02 05 02 00 07 00 09 00 05 11 08 00 00
 02 00 07 00 08 00 07 00 05 42 00 00 00 00 00 00 00 00 00 00 00 00 42 07 00 05 00 09 00 08 00 00
 02 00 07 11 08 00 05 00 08 08 08 05 07 07 07 05 08 08 08 05 09 09 09 05 00 02 00 09 00 02 33 00
 02 00 07 00 05 00 02 30 00 00 00 00 00 00 00 00 00 00 00 00 00 00 00 00 30 02 00 09 12 02 09 09
 02 00 05 00 09 00 02 02 05 09 09 09 05 08 08 08 05 02 02 02 05 07 07 07 05 02 11 05 00 02 00 00
 02 00 08 00 09 42 00 00 00 00 00 11 00 00 00 00 00 00 00 11 00 00 00 00 00 00 42 08 00 02 00 00
 02 00 08 00 09 05 07 07 07 05 08 08 08 05 07 07 07 05 08 08 08 05 09 09 09 05 08 08 00 02 00 00
 02 00 08 36 00 10 00 00 00 00 00 00 00 10 00 00 00 00 00 00 00 00 00 12 00 00 00 00 30 02 00 00
 02 00 08 08 02 02 02 09 09 09 02 02 05 02 02 08 08 08 09 09 09 07 07 02 04 02 02 02 02 24 36 00
 02 00 00 00 00 00 00 00 34 00 00 00 00 00 00 00 00 00 00 00 00 00 00 35 08 00 00 00 00 36 13 13
 02 34 00 00 00 00 00 00 00 00 00 00 00 00 00 00 00 34 00 00 00 00 00 00 08 00 00 00 00 00 14 16
 02 02 02 02 02 02 02 02 02 02 02 02 02 02 02 02 02 02 02 02 02 02 02 02 02 02 02 02 02 02 02 02
