Gauntlet II
Maze number: 102
Offset for maze 101: 232757 - 0x038d35
big endian buf: [%!l(uint8=0) %!l(uint8=3) %!l(uint8=141) %!l(uint8=53)]
G:2 Maze real addr: 257333 - 0x03ED35, bank 3, boff: 0x6000
Maze read from: 0x03ed35 - 257333
compresssed: 189
 04 00 00 84 00 63 CE 06 12 9D 43 10 80 40 50 54
 14 81 10 14 83 C4 1C C0 50 1E 10 2E 42 7A D1 5F
 DF CE 5F DF 78 DF CB A2 D5 2E C5 35 C4 20 C1 20
 C8 2E 74 73 A1 C3 54 5F DF CB 57 1C 80 C0 10 1D
 80 C7 B5 04 A2 C8 33 D7 0D A1 0D C1 B5 04 A1 D2
 52 35 CF BF CD 0F C4 5F C4 50 B3 C3 B3 CD 62 C8
 04 07 0D 80 07 04 79 C0 2F 63 C8 07 C3 07 C1 55
 03 31 03 10 81 61 C6 50 07 C1 0A C0 07 79 C0 2F
 63 C2 31 C4 1C C0 39 3A C0 1C CD 62 C8 07 C0 0A
 80 C0 07 D7 50 07 81 C0 07 80 C1 5A 2E DF DF C9
 52 53 5F DA 43 DB 43 7A C6 42 64 44 D1 44 62 1E
 BE 10 42 1E C9 2E C5 41 10 41 62 2E 00
  Encoded length: 189 bytes
  Wall pattern: 03, Wall color: 14     Floor pattern: 06, Floor color: 12
  Flags: EXIT_CHOOSE_ONE 
  Random food adds: 4
  Secret trick:  4 - Try Transportability (onto secret wall)
 02 02 02 02 02 02 02 02 02 02 02 02 02 02 02 02 02 02 02 02 02 02 02 02 02 02 02 02 02 02 02 02 02
 02 16 06 29 00 29 00 00 00 00 00 20 20 20 16 20 20 20 20 20 00 00 00 00 00 28 00 29 00 30 16 46 02
 02 06 06 00 00 00 00 00 00 00 00 00 00 00 03 00 00 00 00 00 00 00 00 00 00 00 00 00 00 00 00 00 02
 02 29 00 00 00 00 00 00 00 00 00 00 00 00 00 00 00 00 00 00 00 00 00 00 00 00 00 00 00 00 00 00 02
 02 00 00 00 00 00 00 00 00 00 00 00 00 00 00 00 00 00 00 00 00 00 00 00 00 00 00 00 00 00 00 00 02
 02 29 00 00 00 00 00 00 00 00 00 00 00 00 00 00 00 00 00 00 00 00 00 00 00 00 00 00 00 00 00 00 02
 02 00 00 00 00 00 00 00 00 00 00 00 00 00 00 00 00 00 00 00 00 00 00 00 00 00 00 03 00 00 00 00 02
 02 00 00 00 00 00 00 00 00 00 00 00 00 00 00 00 00 00 00 00 00 00 00 00 00 00 00 00 00 00 00 00 02
 02 00 00 00 00 00 00 02 02 02 02 00 00 00 00 00 00 00 00 00 00 00 00 00 00 00 00 00 00 00 00 00 02
 02 46 00 00 00 00 00 02 53 00 00 00 00 00 32 00 00 32 00 00 02 00 00 00 00 00 00 46 00 00 00 00 02
 02 03 00 00 00 00 03 02 02 00 00 00 00 29 00 00 00 00 00 29 02 00 00 00 00 00 00 00 00 00 00 00 02
 02 00 00 00 00 00 00 02 00 00 00 00 00 00 00 00 00 00 00 00 02 00 00 00 00 00 00 00 00 00 00 00 02
 02 00 00 00 00 00 00 02 00 00 00 00 00 00 00 00 29 00 00 00 02 00 00 00 00 28 28 00 16 29 29 00 02
 02 00 00 00 00 00 00 02 04 02 02 02 00 00 00 00 00 00 00 00 02 51 00 00 00 00 00 00 00 00 00 00 02
 02 00 00 00 00 00 00 00 00 00 00 00 00 02 13 02 02 13 02 00 02 04 02 02 00 00 00 00 00 00 00 00 02
 02 00 00 00 00 00 00 00 00 00 00 29 00 02 00 53 00 00 02 00 00 00 00 00 00 00 00 00 00 00 00 00 02
 02 00 00 00 00 00 00 00 00 00 00 00 00 02 00 15 00 00 02 00 00 29 00 00 00 00 00 00 00 00 00 00 02
 02 00 00 00 00 00 00 00 00 00 00 29 00 02 00 00 00 00 02 00 00 00 00 00 00 00 00 00 00 00 00 00 02
 02 18 18 18 00 00 00 00 00 00 00 00 00 04 07 13 13 07 04 00 00 00 00 00 00 00 00 00 00 03 00 47 02
 02 18 18 18 00 00 00 00 00 00 00 00 00 07 00 00 00 00 07 00 00 29 00 00 00 00 00 00 03 49 03 16 02
 02 16 18 18 00 00 00 00 00 00 00 29 00 07 00 00 10 00 07 00 00 00 00 00 00 00 00 00 00 03 00 47 02
 02 18 18 18 00 00 00 49 00 00 00 00 00 28 00 57 58 00 28 00 00 00 00 00 00 00 00 00 00 00 00 00 02
 02 18 18 18 00 00 00 00 00 00 00 00 00 07 00 10 10 00 07 00 00 00 00 00 00 00 00 00 00 00 00 00 02
 02 00 00 00 00 00 00 00 00 00 00 29 00 07 07 07 00 07 07 00 00 29 00 00 00 00 00 00 00 00 00 00 02
 02 46 00 00 00 00 00 00 00 00 00 00 00 00 00 00 00 00 00 00 00 00 00 00 00 00 00 00 00 00 00 00 02
 02 00 00 00 00 00 00 00 00 00 00 00 00 00 00 00 00 00 00 00 00 00 00 00 00 00 00 00 00 00 00 00 02
 02 00 00 00 00 00 00 00 00 00 00 00 29 00 00 00 29 00 00 00 00 29 00 00 00 00 00 00 00 00 00 00 02
 02 00 00 00 00 00 00 00 00 00 00 00 00 00 00 00 00 00 00 00 00 00 00 00 00 00 00 00 00 00 00 00 02
 02 06 06 06 06 00 00 00 00 00 00 00 00 00 00 00 00 00 00 00 00 00 00 00 00 00 00 00 00 00 00 00 02
 02 06 06 06 06 00 00 00 00 00 00 00 00 00 00 00 03 00 00 00 00 00 00 00 06 06 06 18 18 18 18 18 02
 02 06 06 06 06 00 00 00 00 00 00 00 00 00 00 00 00 00 00 00 00 00 00 06 06 06 06 06 18 18 18 30 02
 02 16 06 06 06 30 00 00 00 00 00 00 00 00 00 00 46 00 00 00 00 00 00 06 06 16 06 06 18 18 18 46 02
 02 02 02 02 02 02 02 02 02 02 02 02 02 02 02 02 02 02 02 02 02 02 02 02 02 02 02 02 02 02 02 02 02
