Gauntlet II
Maze number: 67
Offset for maze 66: 230274 - 0x038382
big endian buf: [%!l(uint8=0) %!l(uint8=3) %!l(uint8=131) %!l(uint8=130)]
G:2 Maze real addr: 246658 - 0x03C382, bank 2, boff: 0x4000
Maze read from: 0x03c382 - 246658
compresssed: 345
 0D 00 00 00 06 74 D5 45 69 07 6E 0F 80 44 C6 20
 C5 1E 63 62 46 CB 1E C0 31 CE 1C 05 C6 20 C5 1E
 64 C1 18 AF AD C7 0C C2 0B C2 0B 22 CA 36 0C C1
 0C C5 0C C0 27 C0 0B C2 0B 22 CA 33 70 0C 35 40
 80 09 9C C1 33 E3 E3 22 A0 1C C0 1C C0 1C C0 1C
 C0 1C C0 1C C0 1C C0 1C E8 1D C2 08 A0 1C A0 0D
 8E E7 C3 08 A0 1F A0 08 CE B3 C4 0E C5 08 A0 1C
 A0 72 C2 2F 72 C1 3A 0E C2 21 35 0E C5 35 08 A0
 18 71 18 2E 70 18 2E 70 18 2E A4 B3 A6 08 81 E1
 C2 36 C2 1F C2 31 C9 0E 29 C4 1D 31 E0 EC E0 E0
 E0 21 0E C5 AB 3E A2 BF 1D A0 40 E0 40 C6 3E 18
 80 0B 08 62 08 E6 1D 05 40 E0 C4 38 3E C4 08 31
 C2 08 47 E0 40 40 C3 A1 B5 AC 43 E0 E0 40 15 C3
 31 6C E5 E0 40 40 C2 B7 6B 46 C0 04 E0 E0 71 40
 80 AB C2 24 60 E1 C0 04 40 40 C5 2F 2E 86 35 47
 E0 E0 E0 15 C7 07 85 49 E0 40 40 D7 05 1E 05 E0
 E0 C8 07 83 63 C5 1E 05 1E A0 40 40 C7 31 C0 18
 3E 4B 40 1E A0 1E A0 15 C7 34 18 C0 18 52 64 C4
 1E 05 1E A0 1E 05 1E 05 C6 55 07 82 3E EA 40 1E
 A0 1E A0 CF 0A 60 C0 BB C3 10 05 1E A0 40 1E 05
 C1 B9 C1 58 07 86 57 35 73 C1 BE 32 10 05 E0 40
 15 BF 40 2E CB BA 72 C1 00
  Encoded length: 345 bytes
  Wall pattern: 04, Wall color: 05     Floor pattern: 07, Floor color: 13
  Flags: TRAPS_LOCAL SHOTS_HURT 
  Random food adds: 0
  Secret trick: 13 - Don't Be Greedy (no treasure)
 02 02 02 02 02 02 02 02 02 02 02 02 02 02 02 02 02 02 02 02 02 02 02 02 02 02 02 02 02 02 02 02 02
 02 15 00 00 00 00 00 05 00 00 00 00 00 00 00 32 00 00 00 00 00 00 30 00 00 00 00 41 00 00 00 41 02
 02 00 00 00 00 00 00 05 00 00 00 00 00 00 00 00 00 00 00 00 30 00 49 00 00 00 00 00 00 00 00 00 02
 02 00 00 00 00 00 28 05 00 00 00 00 00 00 00 32 00 00 00 00 00 00 30 00 00 00 00 00 41 00 00 24 02
 02 02 02 02 02 02 02 02 02 02 02 02 02 02 02 02 02 02 02 02 02 02 02 02 02 02 02 02 02 02 00 00 02
 02 00 00 00 00 00 12 00 00 00 11 00 00 00 11 34 00 00 00 00 00 00 00 00 00 00 00 54 12 00 00 12 02
 02 00 00 00 00 00 12 00 39 00 11 00 00 00 11 34 00 00 00 00 00 00 00 00 00 00 00 51 00 46 12 53 02
 02 05 05 09 09 09 09 09 09 09 09 09 09 09 09 09 09 09 09 09 09 09 09 09 09 09 09 09 09 09 09 09 02
 02 00 02 51 00 00 00 00 02 00 00 00 00 02 34 02 28 00 28 00 28 00 28 00 28 00 28 00 28 00 28 00 02
 02 00 02 00 00 00 00 00 02 29 00 00 00 08 02 28 02 13 13 13 13 13 13 13 13 13 13 13 13 13 13 13 02
 02 00 02 00 00 02 00 00 00 02 00 00 00 00 08 02 31 02 08 00 00 00 00 00 00 00 00 00 00 00 00 00 02
 02 00 02 00 00 02 00 00 14 00 00 00 00 00 00 08 02 28 02 00 00 00 46 00 00 00 47 00 00 00 46 00 02
 02 58 14 00 00 02 33 53 14 00 00 00 00 00 00 53 08 02 24 00 00 46 24 46 00 46 24 46 00 46 24 46 02
 02 02 02 02 02 02 02 02 02 02 02 02 02 08 08 02 00 00 02 00 00 00 54 00 00 00 31 00 00 00 49 00 02
 02 00 00 00 00 00 00 00 00 14 41 00 02 00 00 02 29 49 00 02 00 00 00 00 00 00 00 00 00 00 00 00 02
 02 02 00 02 00 02 00 02 33 14 00 00 02 00 00 02 02 02 02 02 02 02 02 02 02 02 02 02 62 02 02 02 02
 02 29 02 00 05 00 02 00 05 02 00 00 02 00 00 02 62 24 24 11 08 00 00 00 41 08 00 00 00 00 00 00 02
 02 02 29 05 00 05 00 02 00 02 00 00 02 56 62 02 00 00 00 00 08 49 00 00 00 08 00 00 00 00 00 00 02
 02 00 05 00 02 00 05 00 05 02 00 00 02 02 02 02 02 02 02 02 02 02 02 02 02 02 02 02 02 00 00 00 02
 02 05 00 02 00 02 00 05 21 02 00 00 02 49 00 00 00 00 00 00 00 00 00 00 00 00 00 41 02 00 00 00 02
 02 00 02 00 02 00 05 00 05 02 00 00 02 00 00 00 00 00 00 00 00 00 00 00 00 41 00 00 02 00 00 00 02
 02 05 00 04 00 02 00 02 00 02 46 02 05 05 02 02 02 02 02 02 02 02 02 02 02 02 00 00 02 36 00 41 02
 02 00 02 00 04 00 05 00 05 02 00 02 00 00 07 47 46 46 46 46 46 46 46 46 53 02 00 00 02 00 00 00 02
 02 05 00 02 00 02 00 02 21 02 00 02 00 00 07 00 07 07 07 07 07 07 07 07 00 02 00 00 02 00 00 00 02
 02 00 05 00 02 00 05 00 05 02 00 02 00 00 07 00 07 00 00 00 00 00 00 07 00 02 00 00 02 00 00 00 02
 02 05 30 05 00 02 00 02 00 02 00 02 00 00 07 00 07 07 07 07 07 07 00 07 00 02 41 00 02 00 00 00 02
 02 30 05 30 02 00 05 00 05 02 00 02 00 00 07 00 07 49 00 24 62 07 00 07 00 02 00 00 02 00 00 00 02
 02 05 00 05 30 02 30 02 21 02 00 02 00 00 07 00 07 52 24 00 24 07 00 07 00 02 00 41 02 00 00 00 02
 02 30 05 30 02 30 05 30 05 02 00 02 00 00 07 00 07 07 07 07 07 62 00 07 00 02 00 00 02 00 00 00 02
 02 02 00 05 30 02 30 02 00 02 00 02 00 00 07 00 00 00 00 00 00 00 00 07 10 02 41 00 02 00 00 00 02
 02 16 05 30 02 00 05 30 05 02 00 02 00 00 07 07 07 07 07 07 07 07 07 07 53 02 00 00 00 46 00 00 02
 02 50 16 05 00 02 00 05 21 02 00 05 46 00 00 00 00 00 00 00 00 00 00 00 00 02 00 00 00 46 00 00 02
 02 02 02 02 02 02 02 02 02 02 02 02 02 02 02 02 02 02 02 02 02 02 02 02 02 02 02 02 02 02 02 02 02
