Gauntlet II
Maze number: 52
Offset for maze 51: 234367 - 0x03937f
big endian buf: [%!l(uint8=0) %!l(uint8=3) %!l(uint8=147) %!l(uint8=127)]
G:2 Maze real addr: 242559 - 0x03B37F, bank 1, boff: 0x2000
Maze read from: 0x03b37f - 242559
compresssed: 174
 0A 00 03 80 00 14 BE 4E 43 13 12 31 80 CE 1F CB
 33 10 A1 C0 21 AF A7 03 80 A2 35 D0 1D CA 2F C5
 0D 97 45 2E C1 1D DA 0E C0 07 88 AD 03 44 C0 07
 35 13 96 43 1D 07 C0 2E CB 2E 4D C0 07 C1 0A C0
 13 93 43 C0 07 DC 0E C0 07 DC 0E C0 07 C4 2E 12
 90 C0 1C 42 C0 07 DC 0E C0 07 DC 0E CA 12 8D BF
 43 DE 0E DE 0E DE 0E C2 2E 69 CD BF 1D 0E D0 03
 4C DB 1C 41 D0 32 64 46 C1 5F 69 D0 0E C4 5F 6D
 49 DE 0E C0 BB 6E CA B6 31 61 D4 03 C4 10 A0 C7
 7F D4 03 A0 D0 03 63 E6 2E CA 7F CE BE 1E 80 A0
 2E C0 35 B3 57 C1 56 C0 72 C1 12 CD 0F 00
  Encoded length: 174 bytes
  Wall pattern: 04, Wall color: 14     Floor pattern: 01, Floor color: 11
  Flags: FAST_GHOSTS FAST_GRUNTS EXIT_CHOOSE_ONE 
  Random food adds: 0
  Secret trick: 10 - Try Pushing a Wall
 02 02 02 02 02 02 02 02 02 02 02 02 02 02 02 02 02 02 02 02 02 02 02 02 02 02 02 02 02 02 02 02 02
 02 49 00 00 00 00 00 00 00 00 00 00 00 00 00 00 00 31 00 00 00 00 00 00 00 00 00 00 00 00 51 16 02
 02 02 00 33 02 02 02 02 02 02 02 02 02 02 02 02 02 02 02 02 02 02 02 02 02 02 02 02 03 03 02 02 02
 02 53 00 00 00 00 00 00 00 00 00 00 00 00 00 00 00 00 00 29 00 00 00 00 00 00 00 00 00 00 00 47 02
 02 00 00 00 00 00 13 13 13 13 13 13 13 13 13 13 13 13 13 13 13 13 13 13 13 13 13 13 13 13 13 00 02
 02 00 00 02 00 14 46 00 00 29 00 00 00 00 00 00 00 00 00 00 00 00 00 00 00 00 00 00 00 00 00 00 02
 02 00 00 02 00 14 00 07 07 07 07 07 07 07 07 07 07 02 02 02 02 02 02 02 02 02 02 02 02 02 02 03 02
 02 00 00 02 00 14 00 07 53 19 19 19 19 19 19 19 19 19 19 19 19 19 19 19 19 19 19 19 19 19 19 19 02
 02 00 00 02 00 14 29 07 19 46 00 00 00 00 00 00 00 00 00 00 00 00 46 00 00 00 00 00 00 00 00 00 02
 02 00 00 02 00 14 00 07 19 00 10 19 19 19 19 19 19 19 19 19 19 19 19 19 19 19 19 19 19 19 19 19 02
 02 00 00 02 00 14 00 07 19 00 00 19 00 00 00 00 00 00 00 00 00 00 00 00 00 00 00 00 00 00 00 00 02
 02 00 00 02 00 14 00 07 19 00 00 19 00 00 00 00 00 00 00 00 00 00 00 00 00 00 00 00 00 00 00 00 02
 02 00 00 02 00 14 00 07 19 00 00 19 00 46 18 18 18 18 18 18 18 18 18 18 18 18 18 18 18 18 18 18 02
 02 28 00 02 00 14 00 07 19 00 00 19 00 18 00 00 00 00 00 00 00 00 00 00 00 00 00 00 00 00 00 00 02
 02 00 00 02 00 14 00 07 19 00 00 19 00 18 00 00 00 00 00 00 00 00 00 00 00 00 00 00 00 00 00 00 02
 02 00 00 02 00 14 00 02 19 00 00 19 00 18 00 00 18 18 18 18 18 18 18 18 18 18 18 18 18 18 18 18 02
 02 00 00 02 00 14 00 02 19 00 00 19 00 18 00 00 18 00 00 00 00 00 00 00 00 00 00 00 00 00 00 00 02
 02 00 00 02 00 14 00 02 19 00 00 19 00 18 00 00 18 00 00 00 00 00 00 00 00 00 00 00 00 00 00 00 02
 02 00 00 02 00 14 00 02 19 00 00 19 00 18 00 00 18 00 00 00 00 00 00 00 00 00 00 00 00 00 00 00 02
 02 00 00 02 00 14 00 02 19 46 00 19 00 18 00 00 18 00 00 00 03 00 00 00 00 00 00 00 00 00 00 00 02
 02 00 00 02 29 14 00 02 19 00 00 19 00 18 00 00 18 00 00 00 00 00 00 03 00 00 00 00 00 00 00 00 02
 02 00 00 02 00 14 00 02 19 00 00 19 00 18 00 00 18 00 00 00 00 00 00 00 00 00 00 00 00 00 00 00 02
 02 00 28 02 00 14 00 02 19 00 00 19 00 18 00 00 18 00 00 00 00 00 00 50 00 00 00 00 00 03 00 00 02
 02 00 00 02 00 14 00 02 19 00 00 19 00 18 00 00 18 00 00 03 00 00 00 00 00 00 00 00 00 00 00 00 02
 02 00 00 02 00 14 00 02 19 00 00 19 00 18 00 00 18 00 00 00 00 00 00 00 00 00 03 00 00 00 00 00 02
 02 00 00 02 00 14 00 02 19 00 00 19 00 18 00 00 18 00 00 00 00 00 00 00 00 00 00 00 00 00 00 00 02
 02 00 00 02 00 14 00 02 19 00 00 19 00 18 00 00 18 00 00 00 00 00 00 03 00 00 00 00 00 00 00 00 02
 02 00 00 02 49 00 00 03 19 00 00 19 00 18 00 00 18 00 00 00 00 00 00 00 00 00 00 00 00 03 00 00 02
 02 00 00 16 02 00 00 02 19 00 00 19 00 18 00 00 18 00 00 00 00 00 00 00 00 00 00 00 00 00 00 00 02
 02 00 00 03 02 00 00 02 19 00 00 19 00 18 00 00 18 00 00 00 00 00 03 00 00 00 00 03 00 00 00 00 02
 02 00 00 02 46 00 00 02 19 00 00 19 00 18 00 00 18 00 00 00 00 00 00 00 00 00 00 00 00 00 00 00 02
 02 30 30 02 46 00 53 02 19 00 00 19 00 18 00 00 18 00 00 00 00 00 00 00 00 00 00 00 00 00 00 15 02
 02 02 02 02 02 02 02 02 02 02 02 02 02 02 02 02 02 02 02 02 02 02 02 02 02 02 02 02 02 02 02 02 02
