Gauntlet II
Maze number: 48
Offset for maze 47: 233303 - 0x038f57
big endian buf: [%!l(uint8=0) %!l(uint8=3) %!l(uint8=143) %!l(uint8=87)]
G:2 Maze real addr: 241495 - 0x03AF57, bank 1, boff: 0x2000
Maze read from: 0x03af57 - 241495
compresssed: 338
 11 20 00 91 00 33 F4 45 5D AE DC 1C 80 C0 0E C8
 10 C0 37 C7 2E A0 1D 70 05 31 C1 1C C0 0E C2 2C
 F1 40 1C 1D 35 C0 33 F4 E2 40 1C A4 F1 1D E3 40
 1C C0 10 35 C6 2C C3 13 82 60 A0 1D E5 40 C8 B3
 C4 13 81 B2 E0 E0 E6 1D C0 24 CA 50 13 81 07 A0
 E0 1C 05 46 C4 20 B5 43 A2 C2 08 E0 40 E0 54 55
 05 A4 E6 1D A0 40 1C A0 C8 B7 C8 3E E5 40 E0 E0
 47 AA E3 40 E0 40 1C A0 67 C3 58 1D A0 C0 09 1C
 05 40 E0 C8 18 C5 3E 65 A0 40 E0 E0 1C A0 C2 AD
 65 05 60 E0 40 E0 50 35 CA 18 67 A0 E0 60 E0 1C
 A0 BF 54 18 C4 3E BF C0 0F C1 3E 62 08 40 40 E0
 2E AE 68 A0 E0 40 40 C0 2E 12 80 C8 58 1D A0 E0
 40 E0 50 12 81 C1 18 C5 3E 67 70 05 60 E0 1C A0
 C4 A9 65 05 E0 E0 E0 E0 54 5D 1D A0 E0 E0 40 E0
 CE 3E 64 A0 40 60 E0 1C 05 63 60 C3 A2 05 A2 E3
 40 1C A0 40 E0 CD 51 33 C3 BF E0 C0 07 E0 E0 5F
 0D 80 C0 13 81 09 A0 E0 40 1C A0 C4 50 0D 80 C7
 B2 C2 13 82 E0 1D A0 E0 C5 A1 10 0E 31 CA 13 82
 60 A0 1D 05 45 1D A4 C3 20 EB E5 40 C0 50 2C B9
 C2 B3 C2 20 C4 B3 E3 E3 40 1D CB 0D 81 4B 40 1D
 A0 BE C8 2E B2 C0 10 BE 3B C8 2E A0 1D 05 1D 05
 31 00
  Encoded length: 338 bytes
  Wall pattern: 03, Wall color: 04     Floor pattern: 03, Floor color: 15
  Flags: EXIT_CHOOSE_ONE WALLS_DELETABLE1 ODDANGLE_GRUNTS 
  Random food adds: 1
  Secret trick: 17 - Don't Hurt Friends
 02 02 02 02 02 02 02 02 02 02 02 02 02 02 02 02 02 02 02 02 02 02 02 02 02 02 02 02 02 02 02 02 02
 02 28 00 14 00 00 00 00 00 00 00 00 00 16 02 55 00 00 00 00 00 00 00 00 46 02 29 02 28 05 49 00 02
 02 28 00 14 00 00 00 44 00 00 00 00 00 00 02 00 00 00 00 00 00 00 00 00 00 00 02 00 05 28 29 53 02
 02 51 00 02 00 00 02 00 00 02 00 00 00 00 02 00 00 00 00 00 00 00 00 02 00 00 00 02 00 05 28 02 02
 02 02 02 02 00 00 02 00 00 02 00 00 00 00 02 00 00 00 02 00 00 00 02 29 00 00 00 00 02 00 05 28 02
 02 16 53 02 00 00 02 00 00 02 44 00 00 00 02 19 19 19 02 00 29 02 29 00 00 00 00 00 00 02 00 05 02
 02 00 00 02 00 00 02 00 00 02 00 00 00 00 02 19 19 19 02 00 02 00 02 00 00 00 00 00 00 00 02 29 02
 02 36 00 02 00 00 02 00 00 00 00 00 00 46 02 19 19 19 07 02 00 02 28 05 00 00 00 00 00 00 00 05 02
 02 00 00 02 00 32 02 00 00 00 00 05 02 02 02 00 00 00 08 00 02 00 05 00 02 46 00 00 00 00 00 46 02
 02 00 00 02 00 00 05 02 02 02 02 02 00 00 02 00 00 00 02 02 29 02 00 05 28 02 00 00 00 00 00 00 02
 02 00 00 02 00 00 00 00 00 00 00 00 00 62 02 00 00 00 02 00 02 00 05 00 02 00 02 00 00 00 00 00 02
 02 00 00 05 02 02 02 02 02 02 02 02 02 02 02 00 00 00 02 02 00 05 00 02 00 05 28 02 00 00 00 00 02
 02 00 00 00 29 00 00 00 00 46 00 00 00 00 02 00 00 00 02 29 02 00 09 28 05 00 05 00 02 00 00 00 02
 02 00 00 00 00 00 24 00 00 00 00 00 00 62 02 00 00 00 02 00 29 02 00 05 00 02 00 02 28 02 00 00 02
 02 02 02 02 02 02 02 02 02 02 02 02 02 02 02 00 00 00 02 00 00 29 05 00 29 00 02 00 05 00 02 46 02
 02 53 00 00 00 00 00 00 00 00 00 00 00 24 02 00 00 00 02 00 00 00 29 02 00 02 00 29 00 02 28 02 02
 02 46 00 00 00 00 00 24 00 00 00 00 00 62 02 00 15 00 02 62 00 00 00 29 08 00 05 00 05 00 02 46 02
 02 02 02 02 02 02 02 02 02 02 02 02 02 02 02 00 00 00 02 00 00 00 00 00 29 02 00 02 00 05 00 05 02
 02 46 18 18 00 00 00 00 00 00 00 00 00 46 02 00 00 00 02 00 00 00 00 29 02 00 02 00 05 00 02 46 02
 02 18 18 18 00 00 24 00 00 00 00 00 00 62 02 00 00 00 02 00 00 00 29 02 28 05 00 29 00 02 28 02 02
 02 00 00 00 02 02 02 02 02 02 02 02 02 02 02 00 00 00 02 00 00 29 05 00 02 00 02 00 02 00 02 46 02
 02 00 00 00 02 46 00 00 00 00 00 00 00 00 02 00 00 00 02 00 29 02 00 02 00 02 00 05 00 02 00 00 02
 02 00 00 00 02 00 00 00 00 00 00 00 00 62 02 00 00 00 02 29 02 00 05 00 29 00 02 28 05 00 00 00 02
 02 29 00 29 02 00 00 00 02 02 02 05 02 02 02 00 00 00 02 02 00 05 28 02 00 05 00 02 00 00 00 00 02
 02 00 00 00 02 00 00 00 00 00 46 02 00 51 02 00 00 00 02 00 02 00 07 00 02 00 02 46 00 00 00 00 02
 02 00 00 00 02 00 00 00 00 00 00 02 13 13 02 19 19 19 09 02 00 02 00 05 28 02 00 00 00 00 00 46 02
 02 13 13 00 02 00 00 00 02 00 00 02 00 00 02 19 19 19 02 00 02 29 02 00 02 00 00 00 00 00 00 02 02
 02 16 14 49 02 00 00 00 02 00 00 00 00 00 02 19 19 19 02 00 29 02 29 05 00 00 00 00 00 00 05 29 02
 02 02 02 02 02 00 00 00 02 32 00 00 00 00 02 00 00 00 02 00 00 00 02 00 00 00 00 00 00 02 00 05 02
 02 46 00 44 02 00 00 00 02 00 00 02 32 00 02 00 00 00 02 00 00 00 00 02 00 00 00 00 02 00 05 29 02
 02 00 00 00 00 00 00 00 00 00 00 02 13 13 02 00 00 00 00 00 00 00 00 00 00 00 00 05 00 05 29 02 02
 02 00 00 00 00 00 00 00 00 00 46 02 00 16 02 59 00 00 00 00 00 00 00 00 00 46 02 29 05 29 05 49 02
 02 02 02 02 02 02 02 02 02 02 02 02 02 02 02 02 02 02 02 02 02 02 02 02 02 02 02 02 02 02 02 02 02
