Gauntlet II
Maze number: 74
Offset for maze 73: 232296 - 0x038b68
big endian buf: [%!l(uint8=0) %!l(uint8=3) %!l(uint8=139) %!l(uint8=104)]
G:2 Maze real addr: 248680 - 0x03CB68, bank 2, boff: 0x4000
Maze read from: 0x03cb68 - 248680
compresssed: 428
 04 00 00 00 04 2B F0 45 7E 09 98 19 81 09 0C 42
 2E 19 2F A0 2E 35 C0 31 C1 22 40 31 41 22 C3 35
 C2 39 42 C4 09 2E E4 40 22 05 E0 C8 51 41 C3 2E
 C0 A1 2E 24 C0 09 0C E1 C2 09 22 E3 0D 43 42 40
 C0 B3 C1 B3 E4 C1 0C 09 C6 2F 42 40 40 C1 04 E0
 35 09 C8 09 C2 10 C1 A1 19 05 40 C2 19 E2 C1 09
 E8 22 A2 B3 1C 04 2E 05 C5 2E C3 15 E0 E6 C2 31
 C1 09 A1 04 A0 05 A4 B2 2E C1 A2 E5 22 33 C1 1D
 C1 0C 09 C1 15 2E C0 22 C2 1F C2 70 2E C2 A2 04
 A3 2E C0 51 40 A4 C2 09 81 C0 B3 31 21 A0 C6 24
 2E 35 A3 40 62 B3 60 A0 35 C0 B2 40 A1 C8 A2 22
 E0 45 E0 72 05 61 C5 A2 35 31 C2 0E E5 0C A0 E2
 C0 1E C7 24 C1 1E C3 0E 18 81 C0 0C 80 A0 C1 09
 35 A0 1D C3 B2 CA 09 82 C0 31 A2 E3 1D C2 1C A0
 CA BF C2 1D B4 A0 B3 3E E3 C3 1D A0 62 CF 0C 51
 E1 C3 1D A0 40 C2 B8 C7 19 C0 B3 C3 1D A0 1F A0
 C0 1D C1 1D A0 E2 CA 09 A0 09 C2 A6 05 80 A1 E3
 C9 34 15 A0 C2 1C C3 0E 2E 82 04 1E C0 2E 04 E0
 C6 1C C0 15 80 A0 C1 B2 C2 AA C1 15 A0 0D B9 0D
 80 BA 0D 80 A2 09 C1 0E C0 1C C0 77 72 A0 C5 18
 2E C6 09 A0 B2 0D 88 B2 A1 61 70 3E C7 1C C0 18
 0E C5 35 C2 0B 0E CB 0D 80 C0 09 80 52 34 A0 C1
 A2 0D 81 A5 61 61 36 C2 31 C5 14 80 C0 25 E0 E2
 C0 25 C1 0E 66 73 70 71 0C C1 08 C4 08 C2 0E CA
 1D 53 09 81 52 E2 E6 E2 60 61 C4 A1 C1 0C D7 35
 C7 0C CC 20 E7 BE 35 C1 0C C4 B6 2E 35 C1 0F C2
 35 B6 2E C0 35 B2 31 C2 2E A0 10 00
  Encoded length: 428 bytes
  Wall pattern: 11, Wall color: 00     Floor pattern: 02, Floor color: 15
  Flags: TRAPS_LOCAL 
  Random food adds: 0
  Secret trick:  4 - Try Transportability (onto secret wall)
 02 02 02 02 02 02 02 02 02 02 02 02 02 02 02 02 02 02 02 02 02 02 02 02 02 02 02 02 02 02 02 02 02
 02 25 25 09 12 00 00 00 05 46 25 47 02 46 53 02 49 00 02 34 00 05 49 00 00 05 34 00 00 00 00 53 02
 02 00 00 57 09 00 00 05 00 00 00 00 00 09 46 02 00 00 02 00 02 00 05 34 05 00 02 00 00 00 00 00 02
 02 00 00 00 09 00 00 05 00 00 00 00 46 00 02 02 46 36 02 09 12 00 00 02 00 00 00 09 34 00 00 00 02
 02 02 13 02 00 00 00 05 00 00 00 05 00 05 00 02 00 00 02 00 00 00 00 00 02 00 00 12 09 00 00 00 02
 02 00 00 02 47 00 00 00 05 00 05 00 05 00 00 04 00 02 53 09 00 00 00 00 00 00 00 00 00 09 00 00 02
 02 16 00 02 02 02 25 05 00 05 00 00 00 25 00 02 00 02 00 00 09 00 00 00 00 00 00 00 00 00 02 34 02
 02 02 02 02 28 04 46 05 00 00 00 00 00 00 46 02 00 00 02 21 00 02 00 00 00 00 00 00 00 02 00 00 02
 02 49 00 00 09 02 02 04 02 05 02 02 02 02 02 02 46 00 02 02 02 02 00 00 00 00 00 00 02 34 51 00 02
 02 29 00 09 12 09 00 00 21 46 02 34 00 00 00 31 02 00 02 24 00 46 00 00 02 02 02 02 04 02 02 02 02
 02 46 00 09 00 05 02 02 02 02 02 00 00 00 09 09 02 00 02 49 33 02 00 00 02 00 00 00 00 36 46 53 02
 02 02 02 02 00 05 00 00 00 62 02 00 62 02 53 00 02 00 05 02 02 00 00 00 02 00 00 00 00 02 02 02 02
 02 34 00 02 00 02 00 00 00 00 05 00 02 24 00 00 00 05 00 00 62 02 00 00 02 00 02 02 02 02 53 49 02
 02 00 00 14 00 02 00 02 00 00 02 12 02 00 00 00 02 00 30 00 00 02 00 00 02 00 02 36 00 02 30 00 02
 02 00 00 14 24 02 24 02 12 12 02 00 00 09 53 02 29 00 00 00 00 02 00 00 02 00 02 00 00 02 00 00 02
 02 09 09 02 09 02 49 02 02 02 00 00 00 00 02 29 00 00 00 28 02 00 00 00 02 00 02 00 00 02 00 00 02
 02 00 00 02 29 02 02 02 62 09 00 00 00 02 00 00 00 00 29 02 00 00 00 62 02 00 02 00 00 02 00 00 02
 02 00 00 02 00 00 00 00 12 09 00 00 02 00 00 00 00 29 02 00 05 00 00 00 02 00 02 00 00 02 00 00 02
 02 25 00 02 00 00 00 00 29 02 31 02 00 29 00 00 29 02 00 00 00 02 00 00 00 00 02 00 00 02 00 00 02
 02 09 02 09 00 00 02 02 02 02 02 02 02 02 05 05 02 02 00 00 00 00 02 00 00 00 02 00 00 02 00 00 02
 02 52 21 02 00 00 02 28 00 00 00 00 14 46 46 46 46 04 30 00 46 04 00 02 00 00 02 00 00 02 00 28 02
 02 21 21 02 00 00 02 00 00 02 02 02 02 02 02 02 02 02 02 02 02 00 00 21 02 13 02 13 13 02 13 13 02
 02 02 02 09 00 00 14 00 28 02 24 00 00 00 00 00 00 00 00 24 02 00 00 02 00 00 00 00 00 00 24 46 02
 02 00 00 00 00 00 09 09 02 02 13 13 13 13 13 13 13 13 13 13 02 02 02 00 00 62 24 00 62 00 00 00 02
 02 00 00 00 00 28 09 24 14 00 00 00 00 00 00 53 00 00 00 11 14 00 00 00 00 00 00 00 00 00 00 00 02
 02 13 13 09 09 09 09 52 02 00 02 02 02 02 13 13 13 02 02 02 02 02 02 00 00 62 00 00 62 54 00 00 02
 02 49 00 09 00 00 00 09 20 20 02 37 00 02 00 00 00 02 00 37 02 00 14 00 00 00 00 00 00 00 62 24 02
 02 00 00 09 24 00 24 09 00 12 02 00 08 00 00 00 00 00 08 00 02 00 14 00 00 00 00 00 00 00 00 00 02
 02 00 29 09 09 09 09 09 00 00 02 02 00 00 00 00 00 00 00 02 02 00 00 02 00 62 00 00 62 00 00 00 02
 02 00 02 02 00 00 12 00 00 00 02 00 00 00 00 00 00 00 00 00 02 00 00 00 02 00 00 00 00 00 00 53 02
 02 00 00 00 00 00 00 00 12 00 02 00 00 00 00 00 00 00 00 00 02 00 32 00 02 00 00 00 00 00 00 02 02
 02 53 00 00 12 00 00 00 00 00 02 46 53 00 00 15 00 00 00 53 02 46 00 53 02 49 00 00 00 46 02 16 02
 02 02 02 02 02 02 02 02 02 02 02 02 02 02 02 02 02 02 02 02 02 02 02 02 02 02 02 02 02 02 02 02 02
