Gauntlet II
Maze number: 103
Offset for maze 102: 232946 - 0x038df2
big endian buf: [%!l(uint8=0) %!l(uint8=3) %!l(uint8=141) %!l(uint8=242)]
G:2 Maze real addr: 257522 - 0x03EDF2, bank 3, boff: 0x6000
Maze read from: 0x03edf2 - 257522
compresssed: 122
 00 22 20 00 00 12 6D 06 59 0E 6E 0F 80 61 C1 04
 DF D8 03 80 B2 C9 B2 C2 10 C5 2B C0 1F 66 C3 A1
 3F C2 3F D7 B3 DE 05 D9 B4 A4 DB 0A 07 35 DD A1
 B2 DC 08 DE 08 DA 2F C1 0B A0 C2 32 D6 A8 B8 DF
 DB 3E C2 3E D3 BF C7 52 DB A7 BC A5 DD 32 CE 01
 DF DF 75 71 DF DF D4 18 DF C1 1B CC B8 A4 41 C0
 43 C3 B9 A0 D2 41 C0 43 D8 41 C0 43 DB 43 C1 1A
 D1 1D C2 46 D8 45 BE D8 45 00
  Encoded length: 122 bytes
  Wall pattern: 02, Wall color: 13     Floor pattern: 01, Floor color: 06
  Flags: ODDANGLE_GRUNTS FAST_AUX_GRUNTS ODDANGLE_GRUNTS 
  Random food adds: 0
  Secret trick:  0 - No trick
 02 02 02 02 02 02 02 02 02 02 02 02 02 02 02 02 02 02 02 02 02 02 02 02 02 02 02 02 02 02 02 02 02
 02 15 00 02 25 00 00 04 00 00 00 00 00 00 02 00 00 00 00 00 00 00 00 00 00 00 00 00 00 00 00 00 02
 02 00 00 02 00 00 00 02 00 00 00 00 00 00 02 00 00 00 00 00 00 00 00 00 00 00 00 00 00 00 00 00 02
 02 03 02 02 00 00 00 02 00 00 00 00 00 00 02 00 00 00 16 00 00 00 00 00 00 43 00 31 00 00 00 00 02
 02 00 02 25 00 00 00 02 02 02 63 00 00 00 63 00 00 00 00 00 00 00 00 00 00 00 00 00 00 00 00 00 02
 02 00 02 00 00 00 00 02 00 00 02 00 00 00 02 00 00 00 00 00 00 00 00 00 00 00 00 00 00 00 00 00 02
 02 00 02 00 00 00 00 05 00 00 02 00 00 00 02 00 00 00 00 00 00 00 00 00 00 00 00 00 00 00 00 00 02
 02 00 02 02 02 02 02 02 00 00 02 00 00 00 02 00 00 00 00 00 00 00 00 00 00 00 00 00 00 00 00 00 02
 02 00 00 00 10 07 53 02 00 00 02 00 00 00 02 00 00 00 00 00 00 00 00 00 00 00 00 00 00 00 00 00 02
 02 00 00 00 00 02 02 02 00 00 02 00 00 00 02 00 00 00 00 00 00 00 00 00 00 00 00 00 00 00 00 00 02
 02 00 00 00 00 08 00 00 00 00 02 00 00 00 02 00 00 00 00 00 00 00 00 00 00 00 00 00 00 00 00 00 02
 02 00 00 00 00 08 00 00 00 00 02 00 00 00 02 00 00 00 00 00 00 00 00 00 00 00 00 00 00 00 00 00 02
 02 47 00 00 11 02 00 00 00 50 02 00 00 00 02 00 00 00 00 00 00 00 00 00 00 00 00 00 00 00 00 00 02
 02 02 02 02 02 02 02 02 02 02 02 00 00 00 02 00 00 00 00 00 00 00 00 00 00 00 00 00 00 00 00 00 02
 02 00 00 00 00 00 00 00 00 14 00 00 00 00 02 00 00 00 00 00 00 00 00 00 00 00 00 00 00 00 00 00 02
 02 00 00 00 00 00 00 62 00 14 00 62 00 00 02 00 00 00 00 00 00 00 00 00 00 00 00 00 00 00 00 00 02
 02 00 00 00 00 00 00 00 00 14 00 00 00 00 02 00 00 00 00 00 00 00 00 00 00 00 00 00 00 00 00 00 02
 02 00 00 00 00 02 02 02 02 02 02 02 02 02 02 02 02 02 02 02 02 00 00 00 00 00 00 00 00 00 00 00 02
 02 00 00 00 00 02 00 00 00 00 00 00 00 00 00 00 00 00 00 50 02 00 00 00 00 00 00 00 00 00 00 00 02
 02 00 00 01 00 02 00 00 00 00 00 00 00 00 00 00 00 00 00 00 02 00 00 00 00 00 00 00 00 00 00 00 02
 02 00 00 00 00 02 00 00 00 00 00 00 00 00 00 00 00 00 00 00 02 00 00 00 00 00 00 00 00 00 00 00 02
 02 00 00 00 00 02 00 00 00 00 46 00 00 46 00 00 00 00 00 00 02 00 00 00 00 00 00 00 00 00 00 00 02
 02 00 00 00 00 02 00 00 00 00 00 00 00 00 00 00 00 00 00 00 02 00 00 00 00 00 00 00 00 00 00 00 02
 02 00 00 00 00 02 00 00 00 00 00 00 00 00 00 00 00 00 00 00 02 00 00 00 00 00 00 00 00 00 00 00 02
 02 00 00 24 00 02 00 00 00 00 00 00 00 00 00 00 00 00 00 00 02 00 00 00 00 00 00 00 00 00 00 00 02
 02 00 00 00 00 02 27 00 00 00 00 00 00 00 00 00 00 00 00 00 02 02 02 02 02 02 06 06 00 06 06 06 02
 02 00 00 00 00 02 02 00 00 00 00 00 00 00 00 00 00 00 00 00 00 00 00 00 00 00 06 06 00 06 06 06 02
 02 00 00 00 00 00 00 00 00 00 00 00 00 00 00 00 00 00 00 00 00 00 00 00 00 00 06 06 00 06 06 06 02
 02 00 00 00 00 00 00 00 00 00 00 00 00 00 00 00 00 00 00 00 00 00 00 00 00 00 00 00 00 06 06 06 02
 02 00 00 26 00 00 00 00 00 00 00 00 00 00 00 00 00 00 00 00 00 00 29 00 00 00 06 06 06 06 06 06 02
 02 00 00 00 00 00 00 00 00 00 00 00 00 00 00 00 00 00 00 00 00 00 00 00 00 00 06 06 06 06 06 06 02
 02 00 00 00 00 00 00 00 00 00 00 00 00 00 00 00 00 00 00 00 00 00 00 00 00 00 06 06 06 06 06 06 02
 02 02 02 02 02 02 02 02 02 02 02 02 02 02 02 02 02 02 02 02 02 02 02 02 02 02 02 02 02 02 02 02 02
