Gauntlet II
Maze number: 115
Offset for maze 114: 236489 - 0x039bc9
big endian buf: [%!l(uint8=0) %!l(uint8=3) %!l(uint8=155) %!l(uint8=201)]
G:2 Maze real addr: 261065 - 0x03FBC9, bank 3, boff: 0x6000
Maze read from: 0x03fbc9 - 261065
compresssed: 352
 0E 80 00 80 04 61 95 6E 45 09 48 10 80 2E 05 40
 42 C2 07 2E C0 10 05 2E 43 60 40 61 10 65 61 80
 C1 07 62 C2 51 62 63 2E C2 51 61 C1 0A 42 C1 09
 80 61 81 C1 07 80 09 81 64 C0 0C 05 40 C6 0A 40
 C1 0B 71 0C 60 44 70 82 C3 A2 61 46 61 0B C0 07
 83 0B 40 C7 0C C0 07 82 05 C1 A2 70 42 66 81 52
 40 62 40 60 C2 0A 71 60 81 C0 0A C9 A2 C2 0A 60
 40 42 67 81 41 45 66 81 C1 51 43 C3 0B C3 09 80
 73 82 C5 0C 05 41 C2 51 40 07 81 41 46 67 61 83
 C7 0C C2 0B E7 2E 60 43 C0 0C C1 0A C2 53 63 81
 C5 0A 07 82 0C D6 2E E2 44 72 82 2E B2 42 05 64
 C6 09 81 05 80 BF 10 60 76 80 05 C1 0F 61 C0 0C
 53 42 05 C2 10 62 68 64 63 61 44 43 C0 0B 70 44
 43 61 C1 0A 42 73 81 72 2E 63 73 61 71 C1 07 80
 60 80 62 72 C1 0A 61 C1 0B 70 81 C1 0B 08 42 81
 63 68 73 41 60 82 09 81 C3 0B 07 C2 51 09 07 82
 43 08 C2 0C 44 C5 07 2E A0 43 42 D0 05 81 C1 04
 C7 A2 C6 0A 60 82 43 E1 C5 0B 46 B2 C3 07 42 C4
 0A 41 05 81 C5 51 C5 07 81 62 80 07 81 48 05 40
 05 82 C0 0C 40 05 42 46 C0 0C 65 C3 0B 72 80 05
 6B 81 08 83 07 81 C4 09 64 81 6B 63 62 81 45 BE
 10 41 53 40 43 05 0A 40 10 05 42 09 42 C2 10 00
  Encoded length: 352 bytes
  Wall pattern: 01, Wall color: 05     Floor pattern: 06, Floor color: 09
  Flags: TRAPS_LOCAL INVIS_TRAPWALLS EXIT_CHOOSE_ONE 
  Random food adds: 0
  Secret trick: 14 - Go On a Diet (no food)
 02 02 02 02 02 02 02 02 02 02 02 02 02 02 02 02 02 02 02 02 02 02 02 02 02 02 02 02 02 02 02 02 02
 02 16 46 05 00 46 00 00 00 46 00 00 00 07 46 00 16 05 46 00 00 09 00 46 00 05 00 46 00 00 05 16 02
 02 00 00 09 00 00 05 00 00 05 05 00 00 07 00 00 00 05 00 00 00 09 00 00 00 05 00 00 00 00 05 46 02
 02 00 00 09 00 00 05 00 00 10 00 00 00 46 00 00 09 09 00 00 05 05 05 00 00 07 07 09 09 09 00 00 02
 02 00 00 05 00 12 05 00 46 00 00 00 00 00 00 00 10 00 46 00 00 11 00 00 08 12 00 05 00 00 00 00 02
 02 46 00 08 08 08 08 00 00 00 09 02 02 02 00 00 05 00 00 00 00 00 00 00 46 00 00 05 11 00 07 07 02
 02 07 07 11 00 46 00 00 00 00 09 00 00 00 12 00 07 07 07 07 05 00 00 02 02 02 00 08 00 00 00 46 02
 02 00 00 00 00 00 00 05 05 05 09 00 46 00 00 00 05 00 46 00 05 00 00 00 10 00 00 08 00 05 05 05 02
 02 10 00 00 00 00 00 00 00 00 00 00 02 02 02 00 00 00 10 00 05 00 46 00 00 00 46 00 09 00 00 00 02
 02 00 00 05 05 05 00 00 46 00 00 00 00 00 00 46 00 00 00 00 00 00 00 05 05 05 00 00 09 00 00 00 02
 02 46 00 09 00 00 11 00 00 00 09 09 09 00 00 00 00 08 08 08 08 00 00 00 00 00 00 12 05 00 00 46 02
 02 00 00 09 00 46 07 07 07 00 09 46 00 00 00 00 00 00 00 46 00 00 00 00 00 00 00 00 05 00 00 05 02
 02 05 05 05 00 00 00 00 00 00 09 00 12 00 00 00 11 00 00 00 00 00 00 00 00 02 46 00 05 00 00 00 02
 02 46 00 12 00 00 10 00 02 00 09 00 00 00 00 05 05 05 00 00 00 00 09 00 10 07 07 07 07 12 00 00 02
 02 00 00 00 00 00 00 00 02 00 00 00 00 00 00 00 00 00 00 00 00 46 09 00 00 02 00 00 00 00 00 46 02
 02 00 00 08 08 08 08 46 02 00 00 00 46 05 00 00 00 00 00 05 00 00 09 00 00 00 00 09 09 09 05 05 02
 02 16 00 05 00 00 00 00 00 00 00 08 08 05 00 00 15 00 00 05 00 12 09 00 00 00 46 05 00 00 00 16 02
 02 00 00 05 00 00 00 00 00 00 00 00 00 05 00 00 00 00 00 05 00 00 00 00 05 00 00 05 00 00 00 00 02
 02 46 00 00 00 00 46 00 11 00 08 00 00 00 00 00 46 00 00 00 00 46 00 00 05 00 00 10 00 00 00 46 02
 02 00 00 00 08 08 08 00 00 00 08 46 00 00 00 00 05 00 00 00 00 08 00 00 05 00 00 08 00 00 07 07 02
 02 05 05 00 00 00 05 00 00 00 08 00 00 10 00 00 05 00 00 11 00 08 08 08 00 00 11 08 00 00 00 46 02
 02 46 00 00 00 00 05 00 00 00 09 00 00 00 00 00 05 00 00 00 00 08 00 00 46 00 05 05 05 05 09 09 02
 02 00 00 00 00 11 07 00 00 00 09 09 07 07 07 07 00 00 00 00 46 08 00 00 00 12 00 00 00 00 00 46 02
 02 00 00 00 00 00 07 46 02 00 00 00 00 46 00 00 00 46 00 00 00 00 00 00 02 00 00 00 00 00 00 00 02
 02 00 00 05 05 05 00 00 04 00 00 00 00 00 00 00 00 02 02 02 00 00 00 00 02 00 00 10 00 05 05 05 02
 02 00 00 00 00 46 00 00 02 00 00 00 00 00 00 11 00 00 00 00 09 00 00 46 02 00 00 00 00 07 00 00 02
 02 46 00 00 00 00 00 10 00 00 46 05 05 05 00 00 00 00 00 00 09 00 00 00 00 00 00 07 07 07 00 00 02
 02 05 05 07 07 07 00 00 00 00 00 00 00 00 00 46 05 00 46 05 05 05 05 00 12 00 46 05 00 00 00 46 02
 02 00 00 00 00 09 00 46 00 12 00 00 00 00 00 00 05 00 00 00 00 11 00 00 00 08 08 05 00 00 00 00 02
 02 00 00 00 00 09 00 00 05 05 05 08 08 08 08 08 07 07 07 00 00 00 00 00 09 00 00 00 00 00 05 05 02
 02 00 00 00 00 09 00 00 00 00 00 00 00 05 00 00 00 00 05 00 00 00 05 05 05 00 00 00 00 00 00 46 02
 02 16 00 00 46 09 00 46 00 00 00 00 46 05 10 00 46 16 05 00 00 00 46 09 00 00 00 46 00 00 00 16 02
 02 02 02 02 02 02 02 02 02 02 02 02 02 02 02 02 02 02 02 02 02 02 02 02 02 02 02 02 02 02 02 02 02
