Gauntlet II
Maze number: 108
Offset for maze 107: 233819 - 0x03915b
big endian buf: [%!l(uint8=0) %!l(uint8=3) %!l(uint8=145) %!l(uint8=91)]
G:2 Maze real addr: 258395 - 0x03F15B, bank 3, boff: 0x6000
Maze read from: 0x03f15b - 258395
compresssed: 214
 0E 00 00 90 00 61 95 07 AE 48 49 10 80 2E 81 70
 2E 10 C0 68 10 40 65 60 10 75 CC 2E 40 EF C1 B2
 C4 A6 08 80 A5 E7 CD 66 04 C0 62 B4 C1 04 C1 6F
 CC 41 A0 C5 41 A1 C3 A2 C5 64 60 08 C7 2E 09 C3
 67 08 81 C0 62 08 78 CD 6F DF D2 B5 C6 60 10 C0
 6F C7 60 09 80 B6 A0 08 81 CA 62 B5 C3 63 61 6C
 09 81 71 D9 63 09 D1 61 2E 81 C3 BF 52 81 C4 BD
 C5 B7 E1 BA 41 B7 08 81 D7 09 63 6B B9 C6 63 09
 C5 BD C7 B5 C8 B4 41 A7 C5 10 61 2E 04 62 6D 65
 42 E1 09 80 A3 6F C0 0F C0 63 40 62 63 AA C7 B7
 C1 40 C4 B4 52 6F 5D C8 6D A0 E5 C2 A6 CD A3 41
 A1 C2 6F 73 10 DD 09 66 62 A4 69 B5 C1 A9 B4 E1
 61 2E 41 B5 EA 6A 08 C8 BE 10 2E B5 62 2E 04 10
 C9 2E 08 C7 2E 00
  Encoded length: 214 bytes
  Wall pattern: 01, Wall color: 05     Floor pattern: 06, Floor color: 09
  Flags: EXIT_CHOOSE_ONE WALLS_DELETABLE1 
  Random food adds: 0
  Secret trick: 14 - Go On a Diet (no food)
 02 02 02 02 02 02 02 02 02 02 02 02 02 02 02 02 02 02 02 02 02 02 02 02 02 02 02 02 02 02 02 02 02
 02 16 46 02 46 00 09 46 16 02 46 00 00 00 00 00 00 00 00 00 16 07 46 00 00 00 00 00 00 46 00 16 02
 02 00 00 02 00 00 09 00 00 02 00 00 00 00 00 00 00 00 00 00 46 07 00 00 00 00 00 00 00 00 00 00 02
 02 00 00 02 00 00 02 00 00 02 00 00 02 00 00 02 02 02 02 02 02 02 08 08 02 02 02 02 02 02 00 00 02
 02 00 00 02 00 00 02 00 00 00 00 00 02 00 00 00 00 00 00 00 00 46 00 00 00 00 00 00 00 04 00 46 02
 02 00 00 02 00 00 04 00 00 46 00 00 02 00 00 00 00 00 00 00 00 00 00 00 00 00 00 00 00 02 00 00 02
 02 00 00 00 00 00 02 07 07 02 00 00 02 00 00 02 07 07 02 02 00 00 00 02 02 02 02 00 00 02 00 00 02
 02 46 00 00 00 00 02 46 00 08 00 00 02 00 00 02 00 00 46 09 00 00 00 02 46 00 00 00 00 02 00 00 02
 02 08 08 02 00 46 02 00 00 08 00 00 02 00 00 02 00 00 00 09 00 00 00 02 00 00 00 00 00 02 00 00 02
 02 00 46 02 00 00 02 00 00 02 00 00 02 00 00 02 00 00 00 02 00 00 00 02 00 00 02 00 00 02 00 00 02
 02 00 00 02 00 00 02 00 00 02 00 00 02 00 00 02 00 00 00 02 00 00 00 02 00 00 02 00 00 02 00 00 02
 02 00 00 02 00 00 02 00 00 02 00 00 02 00 46 02 16 00 46 02 00 00 00 02 00 00 02 00 00 02 00 00 02
 02 00 00 02 00 00 00 00 00 02 00 46 02 09 09 02 02 08 08 02 00 00 00 02 00 00 02 00 00 02 00 46 02
 02 00 00 02 00 00 00 00 46 02 00 00 02 46 00 00 46 00 00 02 00 00 00 02 00 00 02 00 00 02 09 09 02
 02 00 00 09 00 00 02 00 00 02 00 00 02 00 00 00 00 00 00 02 00 00 00 02 00 00 02 00 00 02 46 00 02
 02 00 00 09 00 00 02 00 00 02 00 00 02 00 00 00 02 00 00 02 00 00 46 02 00 46 02 46 00 02 00 00 02
 02 00 00 02 08 08 02 00 00 02 00 00 02 00 00 00 02 00 00 02 00 00 02 02 07 07 02 08 08 02 00 00 02
 02 00 00 02 00 00 02 00 00 02 00 00 00 00 00 00 02 00 00 00 00 00 09 46 00 00 00 00 46 02 00 00 02
 02 00 00 02 00 00 02 00 00 02 00 00 00 00 00 00 02 46 00 00 00 00 09 00 00 00 00 00 00 02 00 00 02
 02 00 00 02 00 00 02 00 00 00 00 00 02 00 00 00 02 07 07 02 02 02 02 02 02 02 02 00 00 00 00 00 02
 02 16 46 02 00 46 04 46 00 00 00 46 02 00 00 00 00 00 00 00 00 00 00 00 00 00 46 00 00 00 00 00 02
 02 07 07 02 00 00 02 09 09 02 02 02 02 46 00 00 00 00 00 00 00 00 00 00 00 00 00 00 00 00 00 15 02
 02 46 00 02 00 00 07 46 00 00 00 46 02 00 00 00 02 02 02 02 02 02 02 02 02 02 02 00 00 00 00 00 02
 02 00 00 02 00 00 07 00 00 00 00 00 02 00 00 00 08 46 00 00 00 00 00 00 00 00 00 00 00 00 00 00 02
 02 00 00 00 00 00 02 00 00 00 00 00 00 00 00 00 08 00 00 00 00 00 00 00 00 00 46 00 00 02 00 00 02
 02 00 00 00 00 00 02 00 00 02 00 00 00 00 00 00 02 00 00 02 02 02 02 02 02 02 02 00 00 02 00 00 02
 02 00 00 02 00 00 02 00 00 02 02 02 02 07 07 02 02 00 00 02 46 00 00 00 00 00 00 00 00 02 00 00 02
 02 00 00 02 00 00 02 00 00 09 16 00 00 00 00 00 00 00 00 02 00 00 00 00 00 00 00 00 00 02 00 00 02
 02 00 00 02 00 00 02 00 00 09 46 00 00 00 00 00 00 00 46 02 00 00 02 02 02 02 02 46 00 02 00 00 02
 02 00 00 02 00 00 02 00 00 02 02 02 02 02 02 02 02 02 02 02 00 00 02 46 00 00 46 07 07 02 00 00 02
 02 00 00 02 00 00 00 00 00 02 46 00 00 00 00 00 00 00 00 00 00 00 08 00 00 00 00 00 00 00 00 00 02
 02 16 46 02 46 00 00 00 46 04 16 00 00 00 00 00 00 00 00 00 00 46 08 00 00 00 00 00 00 00 00 46 02
 02 02 02 02 02 02 02 02 02 02 02 02 02 02 02 02 02 02 02 02 02 02 02 02 02 02 02 02 02 02 02 02 02
