Gauntlet II
Maze number: 43
Offset for maze 42: 231686 - 0x038906
big endian buf: [%!l(uint8=0) %!l(uint8=3) %!l(uint8=137) %!l(uint8=6)]
G:2 Maze real addr: 239878 - 0x03A906, bank 1, boff: 0x2000
Maze read from: 0x03a906 - 239878
compresssed: 394
 11 00 00 90 30 44 28 48 47 09 4E 08 C4 3E 41 73
 1A 31 45 47 C1 10 2F 43 73 E0 28 A0 43 C2 51 6C
 73 E1 C2 29 A0 07 42 C3 51 2B C3 35 61 A0 20 A0
 70 C6 35 07 22 41 20 C2 A2 07 A0 B4 09 81 A7 08
 A1 09 80 07 A0 09 08 09 A2 07 80 08 C1 1F 40 62
 73 35 61 C3 09 62 20 E4 41 C0 20 C0 09 1C A0 71
 E2 E3 62 C4 1F 42 62 73 E2 43 62 C4 09 80 07 A1
 08 07 08 A5 09 A1 15 A0 08 80 A1 09 07 83 08 09
 C4 09 E7 31 38 E0 2F 66 31 19 80 C0 54 E8 C0 23
 A0 07 42 67 43 E9 61 62 67 43 33 C5 31 1C E1 E0
 C6 1E 43 C3 A1 08 07 A1 09 08 83 60 A0 09 82 E2
 B5 08 09 A0 15 09 07 80 A1 47 43 67 C1 20 A0 C2
 1C C8 09 C5 0F C0 B3 C2 38 09 62 C1 1A C0 51 C4
 2F C0 38 07 C2 35 C2 35 07 C2 1A 07 42 E4 E1 B7
 A0 07 A3 09 A6 09 08 A7 09 A1 35 42 42 1D C5 18
 A0 E3 2F C1 09 C2 31 E2 E0 62 2F C3 15 C1 05 63
 62 C3 B3 C1 1E E0 62 C7 05 43 42 C3 3F C3 3F 1A
 C0 38 C5 32 E1 E3 20 E1 1D C2 3F C3 3F 07 80 09
 C3 33 B7 A2 3F 80 09 81 A1 07 09 A1 08 07 A0 E2
 E0 C2 52 73 47 C1 35 49 C0 29 60 2F 72 C0 2C A0
 E1 2B 60 C0 1C C4 2C 52 31 E2 62 1D 72 47 C2 52
 44 07 80 A1 08 07 80 A1 09 80 A4 3F 80 A4 09 08
 A1 08 07 A0 07 CB 32 0E 47 67 C3 51 77 E0 1D E1
 41 E1 C0 24 A0 E4 E0 77 E1 C1 1C A0 60 C7 51 C2
 29 A0 3E C1 B4 73 67 C6 1A 00
  Encoded length: 394 bytes
  Wall pattern: 04, Wall color: 08     Floor pattern: 04, Floor color: 02
  Flags: WRAP_V EXIT_CHOOSE_ONE WALLS_DELETABLE1 WRAP_H 
  Random food adds: 0
  Secret trick: 17 - Don't Hurt Friends
 02 02 02 02 02 02 02 02 02 02 02 02 02 02 02 02 02 02 02 02 02 02 02 02 02 02 02 02 02 02 02 02
 08 00 00 00 00 02 62 00 00 08 00 00 00 00 14 26 49 00 00 00 00 00 00 08 00 00 00 09 00 00 00 00
 08 00 00 16 47 02 00 00 00 08 00 00 00 00 14 00 02 40 02 00 00 00 00 08 00 00 00 09 00 00 00 00
 09 00 00 00 00 02 00 00 00 07 00 00 00 00 14 00 00 02 00 00 00 41 02 07 00 00 00 08 00 00 00 00
 09 43 00 00 00 02 53 00 00 07 02 32 02 00 14 00 00 00 00 00 00 00 53 07 34 00 00 08 32 00 00 00
 02 02 02 07 02 02 09 09 09 02 02 02 02 02 02 02 02 08 02 02 09 09 07 02 09 08 09 02 02 02 07 07
 08 00 00 31 00 08 00 00 00 07 00 00 00 00 14 53 00 00 07 00 00 00 00 09 00 00 00 07 32 00 00 00
 09 00 02 00 00 08 00 32 00 09 28 02 00 00 14 00 00 00 02 00 00 00 00 02 00 00 00 07 00 00 00 00
 09 31 00 00 00 08 00 00 00 07 00 00 00 00 14 00 00 00 02 00 00 00 00 08 00 00 00 07 00 00 00 00
 09 09 09 07 02 02 08 07 08 02 02 02 02 02 02 09 02 02 21 02 08 08 02 02 09 07 07 07 07 07 08 09
 09 00 00 00 00 09 00 00 00 00 00 00 00 00 02 49 56 00 02 47 00 00 00 02 00 00 00 07 49 25 25 00
 09 00 00 00 00 02 00 00 00 00 02 00 35 02 07 00 00 00 08 00 00 00 00 02 00 00 00 07 00 00 00 00
 08 00 00 00 00 02 00 00 00 00 00 02 00 00 07 00 00 00 07 00 00 00 00 02 00 00 00 07 00 00 00 00
 08 51 00 00 00 02 00 00 49 28 00 00 02 00 02 00 00 00 02 00 00 00 30 02 00 00 00 08 00 00 00 00
 02 02 08 07 02 02 09 08 08 08 08 08 00 07 02 09 09 09 02 00 00 00 02 02 08 09 02 21 09 07 07 02
 02 00 00 00 00 02 00 00 00 08 00 00 00 00 08 00 00 00 02 00 00 00 00 07 00 00 32 02 00 00 00 28
 09 00 00 00 00 02 00 00 00 09 00 00 00 00 02 00 15 00 02 00 00 00 56 09 00 00 00 07 00 00 26 00
 09 00 00 00 00 02 47 00 56 07 00 00 00 53 02 00 00 53 07 00 00 00 26 07 00 00 00 08 00 00 00 00
 02 02 00 00 02 02 02 07 02 02 02 02 09 02 02 02 02 02 02 02 09 08 02 02 02 02 02 02 02 02 09 02
 02 53 00 00 00 08 00 00 00 08 29 00 00 00 02 00 00 24 02 00 00 00 00 02 47 00 00 09 00 00 00 49
 02 00 00 02 00 02 00 00 00 07 47 00 00 00 02 21 00 00 05 00 00 00 00 07 00 00 00 07 00 00 00 00
 02 00 00 30 00 02 00 00 00 07 00 00 00 00 02 00 00 00 05 00 00 00 00 08 00 00 00 08 00 00 00 00
 63 00 00 00 00 63 26 00 56 09 00 00 00 00 02 50 00 00 02 00 00 00 00 02 32 00 00 02 29 00 00 00
 63 00 00 00 00 63 07 07 09 09 00 00 00 51 02 02 02 02 63 63 09 09 09 02 02 07 09 02 02 08 07 02
 09 00 00 02 00 02 00 00 00 09 00 00 00 00 14 00 00 00 00 00 00 00 00 08 00 00 53 09 00 00 00 00
 09 00 00 00 00 08 00 41 00 07 47 00 00 00 14 00 44 02 00 00 02 43 00 07 00 28 00 09 00 00 00 44
 09 49 00 00 00 02 00 00 00 07 29 00 00 00 14 00 00 00 00 00 00 00 00 08 00 00 00 09 00 00 00 00
 00 08 07 07 02 02 08 07 07 02 02 09 09 02 02 02 02 02 63 63 02 02 02 02 02 09 08 02 02 08 07 02
 07 00 00 00 00 09 00 00 00 02 00 00 00 50 14 00 00 00 00 00 00 00 00 08 00 00 00 00 00 00 00 00
 07 00 00 00 00 09 00 00 00 02 00 00 00 00 14 00 02 29 00 00 02 00 00 08 00 00 02 00 36 02 00 00
 09 00 00 02 00 02 00 00 00 02 00 00 00 00 14 00 00 02 00 00 28 02 00 07 00 00 00 00 00 00 00 00
 09 00 00 00 41 02 62 00 00 02 00 00 00 00 14 00 00 00 00 00 00 00 00 07 00 00 00 00 00 00 00 26
