Gauntlet II
Maze number: 113
Offset for maze 112: 235654 - 0x039886
big endian buf: [%!l(uint8=0) %!l(uint8=3) %!l(uint8=152) %!l(uint8=134)]
G:2 Maze real addr: 260230 - 0x03F886, bank 3, boff: 0x6000
Maze read from: 0x03f886 - 260230
compresssed: 361
 06 00 00 88 00 61 95 6E 90 06 49 10 80 C5 2F C0
 60 2E 81 43 C1 61 2E 08 2E 35 C1 60 2E C8 51 C3
 51 C8 08 C5 A5 09 80 40 C1 B2 C2 A8 46 10 07 40
 A0 C1 B3 46 44 CA 07 C9 06 80 B2 C1 51 49 E3 2E
 C3 51 C2 52 75 80 A4 07 80 70 81 C1 04 A3 08 80
 A0 C4 51 47 08 C8 2F 4E C4 08 46 C2 51 42 B6 C7
 A2 04 C8 08 80 B2 C1 A4 04 42 41 C0 2F C7 B9 74
 C1 07 DB 09 C1 07 2E C2 51 2E B5 C1 B4 C1 B6 2E
 43 81 42 C2 A9 06 85 A2 06 81 B4 A5 E1 C1 03 43
 81 46 C4 08 C2 2F 81 C2 05 A0 CD A6 06 81 A0 BF
 08 80 A0 41 A5 C2 0F 43 C4 07 C2 2F 40 C2 04 A0
 CD A2 06 81 A5 60 A0 C1 03 43 48 74 C2 2F 70 80
 C1 05 A6 45 C0 06 80 A5 06 82 49 57 06 85 57 2E
 43 45 48 E2 E1 4B A5 04 03 A4 E1 E1 C4 07 80 A1
 09 80 A2 35 A0 C0 03 2E 44 81 41 C1 35 43 C0 06
 C2 06 2E E3 C1 03 C2 03 C0 06 86 C4 04 A3 60 2E
 E1 C6 B4 C1 52 C1 52 C0 B4 C1 B3 C1 06 C2 06 2F
 A2 07 C1 B2 C0 B2 C0 B2 40 71 C1 04 40 08 80 70
 80 A6 66 2E 74 E1 C8 35 41 C1 A3 03 A0 09 A4 C3
 07 42 C4 35 43 09 C0 07 C7 03 C3 07 C1 B2 A2 06
 80 52 06 52 C2 A1 08 A0 E0 C0 A1 04 A1 E4 C1 08
 E6 C1 BE 61 A0 2E A0 40 35 A0 61 2E B3 2F E0 2E
 80 08 C0 63 2E A0 2E 10 00
  Encoded length: 361 bytes
  Wall pattern: 01, Wall color: 05     Floor pattern: 06, Floor color: 09
  Flags: EXIT_CHOOSE_ONE WALLS_CYCLIC 
  Random food adds: 0
  Secret trick:  6 - Watch What You Shoot (shoot secret walls)
 02 02 02 02 02 02 02 02 02 02 02 02 02 02 02 02 02 02 02 02 02 02 02 02 02 02 02 02 02 02 02 02 02
 02 16 00 00 00 00 00 00 47 02 16 06 46 02 46 00 06 00 00 46 00 00 16 00 00 46 08 46 53 02 00 16 02
 02 46 00 00 00 00 00 00 00 02 00 06 00 02 00 00 06 00 00 00 00 00 00 00 00 00 08 00 00 02 00 00 02
 02 02 02 02 02 02 02 09 09 02 46 02 00 02 00 00 02 02 02 02 02 02 02 02 02 02 00 00 00 02 00 00 02
 02 46 16 07 00 46 02 00 00 02 00 02 00 06 00 00 02 46 00 06 00 00 00 46 00 00 00 00 00 02 00 00 02
 02 00 00 07 00 00 00 00 00 06 00 02 00 06 06 06 02 00 00 06 00 00 00 00 00 00 00 00 00 02 46 00 02
 02 00 00 02 46 00 00 00 00 06 00 02 00 06 00 00 06 00 00 02 09 09 02 02 02 02 02 07 07 02 09 09 02
 02 00 00 04 02 02 02 02 08 08 02 02 00 02 00 00 06 00 00 02 00 00 00 00 00 46 08 00 00 02 00 00 02
 02 00 00 02 47 00 06 00 00 00 00 02 00 02 00 00 02 00 00 02 46 00 00 00 00 00 08 00 00 02 00 00 02
 02 00 46 02 00 00 06 00 00 00 46 02 00 02 00 00 02 00 00 02 02 02 02 04 00 00 02 00 00 02 00 00 02
 02 08 08 02 00 00 02 02 02 02 02 04 00 02 00 46 02 00 46 02 47 00 00 00 00 00 02 00 00 02 00 00 02
 02 00 00 09 00 00 07 00 00 00 00 06 00 02 00 00 02 00 00 02 00 00 00 00 00 00 02 00 00 00 00 00 02
 02 00 00 09 00 00 07 46 00 00 00 06 46 02 00 00 02 00 00 02 46 00 00 00 00 46 02 46 00 00 00 46 02
 02 00 00 02 02 02 02 02 02 02 02 02 06 06 06 06 06 06 06 06 06 02 02 06 06 06 02 02 02 02 02 02 02
 02 00 00 02 00 00 03 00 00 00 00 46 06 46 00 00 00 00 00 00 06 46 00 00 00 00 00 08 00 00 00 47 02
 02 47 00 00 00 05 02 00 00 00 00 00 06 00 00 00 00 00 00 00 06 02 02 02 02 02 02 02 06 06 06 02 02
 02 08 08 02 00 00 46 02 02 02 02 02 06 00 00 00 15 00 00 00 06 46 00 00 00 00 00 07 00 00 00 47 02
 02 46 00 00 00 04 02 00 00 00 00 00 06 00 00 00 00 00 00 00 06 02 02 02 06 06 06 02 02 02 02 02 02
 02 16 00 02 00 00 03 00 00 00 00 46 06 00 00 00 00 00 00 00 06 46 00 00 00 00 00 09 00 00 00 47 02
 02 09 09 00 00 05 02 02 02 02 02 02 06 00 00 00 00 00 00 46 06 06 06 02 02 02 02 02 02 06 06 06 02
 02 00 00 00 00 00 00 00 00 00 00 46 06 06 06 06 06 06 06 06 06 46 00 00 00 00 46 00 00 00 00 00 02
 02 46 00 00 00 00 00 00 00 00 00 46 02 00 00 02 00 00 02 00 02 00 00 00 00 00 00 00 00 00 00 46 02
 02 02 02 02 02 02 04 03 02 02 02 02 02 00 00 02 00 00 02 00 02 00 00 02 07 07 02 02 09 09 02 02 02
 02 53 02 00 03 46 00 00 00 00 00 46 02 46 00 06 46 00 06 53 02 00 00 02 46 00 06 00 00 00 06 46 02
 02 00 00 00 02 00 02 03 02 00 02 03 02 06 06 06 06 06 06 06 02 00 00 02 00 00 04 02 02 02 02 16 02
 02 46 00 00 02 00 02 00 02 00 02 00 02 00 00 06 00 00 06 00 02 00 00 02 00 00 06 00 00 00 06 47 02
 02 02 02 07 00 00 02 00 02 00 02 00 46 00 00 09 00 00 04 00 46 08 08 00 09 09 02 02 02 02 02 02 02
 02 16 00 00 00 00 00 00 00 46 00 00 00 00 00 09 00 00 02 00 00 02 00 00 00 00 00 06 53 06 00 46 02
 02 00 02 02 02 02 03 02 09 02 02 02 02 02 00 02 00 00 07 00 00 02 46 00 00 00 00 06 53 06 00 00 02
 02 46 09 00 07 00 00 00 00 00 00 00 00 03 00 02 00 00 07 00 00 02 02 02 02 06 06 06 06 06 00 00 02
 02 02 02 08 02 00 02 00 02 02 04 02 02 00 00 02 00 00 02 00 00 08 00 00 00 00 00 00 00 02 00 00 02
 02 16 00 00 02 46 02 00 46 53 02 16 00 00 46 02 47 00 02 46 46 08 00 16 00 00 00 00 46 02 46 16 02
 02 02 02 02 02 02 02 02 02 02 02 02 02 02 02 02 02 02 02 02 02 02 02 02 02 02 02 02 02 02 02 02 02
