Gauntlet II
Maze number: 6
Offset for maze 5: 230604 - 0x0384cc
big endian buf: [%!l(uint8=0) %!l(uint8=3) %!l(uint8=132) %!l(uint8=204)]
G:2 Maze real addr: 230604 - 0x0384CC, bank 0, boff: 0x0000
Maze read from: 0x0384cc - 230604
compresssed: 137
 06 00 80 00 00 40 50 19 6E C7 94 2E 80 C0 0A 80
 62 C4 0F 69 C0 09 60 C0 10 D5 22 C3 09 DE 09 C9
 1C F7 DB 44 CA B5 DF C2 B6 DE 04 6F ED EA C5 A9
 07 81 A0 DF 68 DF D2 20 6C 84 D2 BA CA AF 53 C9
 BF DA 44 DF 2E D5 1D DF C1 BF C7 AF A2 07 82 A0
 D0 01 7A 2E 04 D0 01 7F CD 01 7F C1 A5 04 80 AE
 C3 31 DD B3 C7 22 63 D0 08 C4 31 0A D4 14 81 08
 64 81 AB 08 81 A5 08 81 44 DF CF 0C CD BE C5 42
 31 C5 1A C6 42 32 C1 1A 00
  Encoded length: 137 bytes
  Wall pattern: 00, Wall color: 00     Floor pattern: 04, Floor color: 05
  Flags: INVIS_ALLWALLS 
  Random food adds: 0
  Secret trick:  6 - Watch What You Shoot (shoot secret walls)
 02 02 02 02 02 02 02 02 02 02 02 02 02 02 02 02 02 02 02 02 02 02 02 02 02 02 02 02 02 02 02 02 02
 02 46 00 10 10 00 00 00 46 00 00 00 02 00 15 00 02 00 00 00 00 00 00 00 00 46 00 09 00 46 00 16 02
 02 00 00 00 00 00 00 00 00 00 00 00 02 00 00 00 02 00 00 00 00 00 34 00 00 00 00 09 00 00 00 00 02
 02 00 00 00 00 00 00 00 00 00 00 00 02 00 00 00 02 00 00 00 00 00 00 00 00 00 00 09 00 00 00 00 02
 02 00 00 00 00 00 28 00 00 00 00 00 02 00 00 00 02 00 00 00 00 02 00 00 00 00 00 02 00 00 00 02 02
 02 00 00 00 00 00 00 00 00 00 00 00 02 00 00 00 02 00 00 00 00 02 00 00 00 00 00 02 25 25 25 25 02
 02 00 00 00 00 00 00 00 00 00 00 00 02 00 00 00 02 00 00 00 00 02 00 00 00 00 00 02 00 00 00 00 02
 02 00 00 00 00 00 00 00 00 00 00 00 00 00 00 00 02 00 00 00 00 02 00 00 00 00 00 02 00 00 00 00 02
 02 00 00 00 00 00 00 00 00 00 00 00 00 00 00 00 04 00 00 00 00 02 00 00 00 00 00 02 00 00 00 00 02
 02 46 00 00 00 00 00 00 00 00 00 00 00 00 00 00 02 00 00 00 00 02 00 00 00 00 00 02 02 00 00 00 02
 02 00 00 02 02 02 02 02 02 02 02 02 02 07 07 07 02 00 00 00 00 02 00 00 00 00 00 02 00 00 00 00 02
 02 00 00 00 00 00 00 00 00 00 00 00 00 00 00 00 00 00 00 00 00 02 00 00 00 00 46 02 00 00 00 00 02
 02 00 00 00 00 00 00 00 00 00 00 00 00 00 00 00 00 00 00 00 00 02 00 00 00 00 00 02 00 00 00 00 02
 02 00 00 00 00 00 00 00 00 00 00 00 00 00 32 00 00 00 00 00 00 02 00 00 00 00 00 02 46 46 46 46 02
 02 46 00 00 00 00 00 00 00 00 00 00 00 00 00 00 00 00 00 00 00 02 00 00 00 00 00 02 00 00 00 00 02
 02 02 02 02 02 02 02 02 02 02 02 02 02 02 02 02 02 02 02 02 02 07 00 00 00 00 00 02 00 00 00 00 02
 02 00 00 00 00 00 00 00 00 00 00 00 00 00 00 00 00 00 00 00 00 00 00 00 00 00 00 02 25 25 25 25 02
 02 00 00 00 00 00 00 00 00 00 00 00 00 00 00 00 00 00 00 00 00 00 00 00 00 00 00 02 00 00 00 00 02
 02 46 00 00 00 00 00 00 00 00 00 00 00 00 00 00 00 00 00 00 00 00 00 00 29 00 00 02 00 00 00 00 02
 02 00 00 00 00 00 00 00 00 00 00 00 00 00 00 00 00 00 00 00 00 00 00 00 00 00 00 02 00 00 00 00 02
 02 00 00 00 02 02 02 02 02 02 02 02 02 02 02 02 02 02 02 02 02 02 02 07 07 07 07 02 00 00 00 00 02
 02 00 00 00 00 00 00 00 00 00 00 00 00 01 20 00 00 00 00 00 00 00 00 00 00 00 46 04 00 00 00 00 02
 02 00 00 00 00 00 00 00 00 00 00 00 00 01 20 00 00 00 00 00 00 00 00 00 00 00 00 02 00 00 00 00 02
 02 00 00 00 00 00 00 00 00 00 00 00 00 01 20 00 00 00 00 00 00 00 00 00 00 00 00 02 00 00 00 00 02
 02 02 02 02 02 02 02 04 04 02 02 02 02 02 02 02 02 02 02 02 02 02 02 02 00 00 00 02 49 00 00 00 02
 02 00 00 00 00 00 00 00 00 00 00 00 00 00 00 00 00 00 00 00 00 00 00 00 00 00 00 02 00 00 00 00 02
 02 00 00 00 34 00 00 00 00 46 00 00 00 00 00 00 00 00 00 00 00 00 00 00 00 00 00 08 00 00 00 00 02
 02 49 10 00 00 00 00 00 00 00 00 00 00 00 00 00 00 00 00 00 00 00 00 00 20 20 20 08 00 00 00 00 02
 02 46 46 46 02 02 02 02 02 02 02 02 02 02 02 02 08 08 08 02 02 02 02 02 02 08 08 08 25 25 25 25 02
 02 00 00 00 00 00 00 00 00 00 00 00 00 00 00 00 00 00 00 00 00 00 00 00 00 00 00 00 00 00 00 00 02
 02 00 00 00 00 00 00 00 00 00 00 00 00 00 00 00 00 12 00 00 00 00 00 00 00 00 00 00 00 00 00 00 02
 02 00 00 00 00 00 00 25 25 25 49 00 00 00 00 00 00 26 00 00 00 00 00 00 00 25 25 25 50 00 00 26 02
 02 02 02 02 02 02 02 02 02 02 02 02 02 02 02 02 02 02 02 02 02 02 02 02 02 02 02 02 02 02 02 02 02
