Gauntlet II
Maze number: 89
Offset for maze 88: 237229 - 0x039ead
big endian buf: [%!l(uint8=0) %!l(uint8=3) %!l(uint8=158) %!l(uint8=173)]
G:2 Maze real addr: 253613 - 0x03DEAD, bank 2, boff: 0x4000
Maze read from: 0x03dead - 253613
compresssed: 294
 08 00 00 11 00 50 CE 5F BF B5 43 27 80 E1 E8 2E
 C2 2F 81 C3 07 C3 10 E2 C3 A3 E6 44 07 E6 C1 A2
 2E 1E 31 EE E5 E1 C0 58 A0 C3 22 C3 2F 08 E6 C0
 24 C6 22 E0 C3 B4 32 C5 08 C9 B4 0D 82 E1 E3 E0
 C2 B2 E2 09 81 E6 C0 35 81 A0 E3 C1 2F 61 64 2E
 C2 A4 C2 B6 A0 E3 40 E0 C3 27 C2 32 19 C2 1E C2
 0E C0 0F C0 0E C2 1D C0 3B E1 C4 2E 72 05 C4 A1
 0E 51 0E A1 E5 C4 01 81 E9 0D 81 A0 C0 5B 1C C1
 22 C6 27 D2 B4 E2 C5 B2 C6 27 C0 B2 E8 EB 0D 80
 B2 C0 B2 0D 80 A0 C7 20 A0 E2 B8 C4 B7 CC B6 E4
 C8 BF C1 A6 04 A4 1F C1 B5 E1 C7 22 C5 0E C1 31
 C1 0E C5 61 66 A2 C4 0E C0 2E 18 50 0E C5 61 60
 03 05 C8 A5 3F 80 A7 C8 1C C9 37 C6 60 20 44 E2
 D8 2E B2 C2 B6 32 D0 1F E6 C6 05 C4 A5 3F 80 A3
 3F A4 C7 32 C6 38 E4 C0 29 73 40 C8 01 E7 C0 28
 73 C0 2A E3 C2 1D C2 01 18 01 C3 AF A7 B6 1F 01
 54 1C C4 1C 43 C6 20 C0 33 43 D8 B2 C8 B3 A1 C1
 A3 E1 B3 A0 C1 A3 71 DF C5 BE C6 1C B2 1D C5 1D
 C1 B2 1D C8 3B 00
  Encoded length: 294 bytes
  Wall pattern: 00, Wall color: 14     Floor pattern: 05, Floor color: 12
  Flags: WALLS_DELETABLE1 
  Random food adds: 1
  Secret trick:  8 - Don't Use Invulnerability
 02 02 02 02 02 02 02 02 02 02 02 02 02 02 02 02 02 02 02 02 02 02 02 02 02 02 02 02 02 02 02 02 02
 02 39 00 00 02 00 00 00 00 00 00 00 00 00 02 46 00 00 00 47 02 47 00 00 00 00 07 00 00 00 00 16 02
 02 00 00 02 00 00 00 02 02 02 02 02 00 00 00 00 00 00 00 02 02 00 00 00 00 31 07 00 00 00 00 00 02
 02 00 02 00 00 02 02 02 46 30 49 02 00 00 00 00 00 00 00 00 02 00 00 00 00 00 02 00 00 00 00 00 02
 02 02 00 00 02 00 53 02 00 00 00 02 00 00 00 00 02 00 00 00 02 34 00 00 00 02 47 08 00 00 00 00 02
 02 00 00 02 00 36 00 02 00 00 00 02 00 34 00 02 00 00 00 00 02 50 00 00 00 02 00 00 08 00 00 00 02
 02 00 00 00 00 00 00 02 13 13 13 02 00 00 02 00 00 00 00 02 00 02 00 00 00 02 00 00 02 02 09 09 02
 02 00 00 00 00 00 00 00 02 00 53 02 53 02 00 00 00 00 02 00 00 47 63 00 00 63 00 00 02 00 00 46 02
 02 00 02 02 02 02 02 02 00 00 00 02 02 00 00 00 00 02 00 31 00 02 00 00 00 02 39 00 02 00 50 25 02
 02 00 02 30 00 00 00 14 00 15 00 14 00 00 00 29 02 59 00 00 02 00 00 00 00 02 46 00 02 00 03 05 02
 02 00 02 00 00 02 02 14 53 00 00 14 02 02 00 00 02 00 00 00 02 00 00 00 00 02 01 01 02 00 00 00 02
 02 00 02 00 02 00 00 02 13 13 13 02 00 53 02 00 02 00 00 02 00 00 00 00 00 02 28 00 02 34 00 00 02
 02 00 02 00 02 39 00 00 02 00 02 00 00 00 02 00 02 00 00 02 00 00 00 00 00 02 00 00 02 02 00 00 02
 02 00 02 00 02 00 00 00 02 00 02 00 39 00 02 00 02 00 00 02 00 00 00 00 02 00 00 00 02 00 00 00 02
 02 00 02 00 00 02 13 13 02 00 02 13 13 02 00 00 02 00 00 02 00 00 32 02 00 00 00 02 02 00 00 00 02
 02 00 02 00 00 00 00 00 00 00 00 00 00 00 00 00 02 00 00 02 00 00 02 00 00 00 02 00 00 00 00 00 02
 02 00 00 02 02 02 02 02 02 02 04 02 02 02 02 02 31 00 00 02 00 00 02 00 00 00 02 00 00 00 00 34 02
 02 00 00 00 00 00 14 00 00 49 00 00 14 00 00 00 00 00 00 63 00 00 63 00 00 00 02 00 00 00 02 02 02
 02 00 00 00 00 00 14 00 46 24 53 00 14 00 00 00 00 00 00 63 00 00 63 00 03 05 02 00 00 00 00 00 02
 02 00 00 02 02 02 02 02 02 63 63 02 02 02 02 02 02 02 02 00 00 00 02 00 00 00 02 00 28 00 00 00 02
 02 00 00 00 00 00 00 55 00 00 00 00 00 00 00 63 00 32 00 00 00 00 02 31 00 00 02 02 02 00 00 00 02
 02 00 00 00 00 00 00 00 00 00 00 00 00 00 00 00 00 00 00 00 00 46 02 00 00 00 02 50 02 00 00 00 02
 02 00 00 00 00 00 00 00 00 00 00 00 00 31 00 00 00 00 00 00 00 02 00 00 00 00 00 00 02 05 00 00 02
 02 00 00 02 02 02 02 02 02 63 63 02 02 02 02 63 02 02 02 02 02 00 00 00 00 00 00 00 02 50 00 00 02
 02 00 00 00 00 56 00 00 00 00 00 02 00 41 00 00 00 00 03 00 31 00 00 00 00 00 00 00 02 00 01 00 02
 02 00 00 00 00 00 00 02 00 40 00 00 00 00 03 00 42 00 00 00 00 02 00 00 00 29 00 00 02 01 24 01 02
 02 00 00 02 02 02 02 02 02 02 02 02 02 02 02 02 02 02 02 02 02 02 02 02 02 02 02 02 02 31 01 53 02
 02 00 00 02 00 28 00 00 00 00 00 28 00 00 00 02 31 00 00 00 00 00 00 00 32 02 51 00 00 00 00 31 02
 02 00 00 02 00 00 00 00 00 00 00 00 00 00 00 02 00 00 00 00 00 00 00 00 00 02 00 00 00 00 00 00 02
 02 00 00 02 02 02 00 00 02 02 02 02 00 00 02 02 02 00 00 02 02 02 02 00 00 03 00 00 00 00 00 00 02
 02 00 00 00 00 00 00 00 00 02 00 00 00 00 00 00 00 00 00 00 02 00 00 00 00 00 00 00 00 00 00 00 02
 02 00 00 00 00 00 00 00 28 02 29 00 00 00 00 00 00 29 00 00 02 29 00 00 00 00 00 00 00 00 00 59 02
 02 02 02 02 02 02 02 02 02 02 02 02 02 02 02 02 02 02 02 02 02 02 02 02 02 02 02 02 02 02 02 02 02
