Gauntlet II
Maze number: 73
Offset for maze 72: 232005 - 0x038a45
big endian buf: [%!l(uint8=0) %!l(uint8=3) %!l(uint8=138) %!l(uint8=69)]
G:2 Maze real addr: 248389 - 0x03CA45, bank 2, boff: 0x4000
Maze read from: 0x03ca45 - 248389
compresssed: 291
 01 00 20 00 00 44 EC 81 BE 0E 5D 31 80 E1 33 E8
 10 07 0B C1 44 2F 2B 1A 01 32 E4 18 2C E7 C3 47
 1E 45 A0 E9 0B 19 80 48 1A C6 A6 62 A0 0B 19 4A
 1F E1 70 E0 63 A0 C3 A1 CB 2E 81 E0 E2 C1 18 E1
 E3 CB 63 A0 E2 C2 35 A1 E3 3A C3 01 14 82 C0 19
 82 03 E0 E2 E1 2E E0 2E E1 C5 41 46 3E A0 C0 1C
 C0 A2 0F E1 1D C0 1C C4 40 01 80 C4 03 E3 C6 2E
 A0 C2 B2 C9 67 A0 E5 1E C3 A1 C7 2E 81 E6 C2 35
 A0 E0 E4 CF 1B E1 35 54 A0 E2 E4 D2 A1 C3 A1 0D
 83 A0 C0 05 83 7F E2 E4 62 BF 22 81 C2 1F C4 20
 C7 A2 E2 C3 0D 81 D1 1D 35 3E A0 E2 C2 27 D1 A4
 31 E3 63 0D 89 C2 A1 C8 23 2E A0 C2 BF ED 15 C0
 26 E7 6E 1C E0 15 C1 A8 F1 15 E1 14 45 05 C5 31
 19 83 C3 58 A0 35 81 A0 14 46 05 81 C0 2E 80 B3
 AA 71 A0 01 80 D0 18 C0 31 C0 18 E5 04 CD 35 80
 3E 51 C0 18 C0 60 18 C0 51 E2 CF AE D0 10 08 C1
 0A 80 C4 43 2C C9 01 82 C0 08 72 C5 47 2E C4 01
 14 83 C1 1E C7 4F 41 BE 2F 72 C5 4B 2C C1 1A 80
 01 32 00
  Encoded length: 291 bytes
  Wall pattern: 04, Wall color: 12     Floor pattern: 04, Floor color: 14
  Flags: FAST_AUX_GRUNTS 
  Random food adds: 0
  Secret trick:  1 - Try Transportability (onto demon)
 02 02 02 02 02 02 02 02 02 02 02 02 02 02 02 02 02 02 02 02 02 02 02 02 02 02 02 02 02 02 02 02 02
 02 49 00 00 02 51 00 00 00 00 00 00 00 00 00 02 16 07 11 00 00 01 00 00 00 00 00 47 43 26 01 50 02
 02 00 00 00 00 02 24 44 00 00 00 00 00 00 00 00 02 00 00 00 00 01 00 00 00 00 00 00 00 00 30 01 02
 02 00 00 00 00 00 02 00 00 00 00 00 00 00 00 00 00 02 11 25 25 01 00 00 00 00 00 00 00 00 00 26 02
 02 00 00 00 00 00 00 02 02 02 02 02 02 02 62 00 00 00 02 11 25 01 00 00 00 00 00 00 00 00 00 00 02
 02 31 00 02 02 00 29 00 02 62 00 00 00 00 02 00 00 00 00 02 02 00 00 00 00 00 00 00 00 00 00 00 02
 02 46 46 02 00 02 00 00 00 02 00 00 24 00 00 02 00 00 00 00 02 00 00 00 00 00 00 00 00 00 00 00 02
 02 62 00 02 00 00 02 00 00 00 02 00 00 00 53 02 02 00 00 00 00 02 58 00 00 00 00 01 20 20 20 20 02
 02 25 25 02 25 03 00 02 00 00 00 02 00 00 02 46 00 02 46 00 00 02 02 00 00 00 00 00 01 00 00 01 02
 02 00 00 02 00 00 00 62 02 00 28 00 02 02 14 15 00 00 02 29 00 28 02 00 00 00 00 01 00 01 01 00 02
 02 00 00 02 03 00 00 00 00 02 00 00 00 00 14 00 00 46 02 00 00 00 02 00 00 00 00 00 00 00 00 00 02
 02 62 00 02 00 00 00 00 00 00 02 00 00 00 14 00 00 02 30 00 00 00 00 02 02 00 00 00 00 00 00 00 02
 02 46 46 02 00 00 00 00 00 00 00 02 00 00 14 53 02 00 02 00 00 00 00 00 02 00 00 00 00 00 00 00 02
 02 00 00 02 00 00 00 00 00 27 00 00 02 53 14 02 00 00 00 02 00 00 00 00 00 02 00 00 00 00 00 00 02
 02 00 00 02 00 00 00 00 00 00 00 00 00 02 02 00 00 00 00 02 02 13 13 13 13 13 02 00 05 05 05 05 02
 02 00 00 02 00 00 00 00 00 00 00 00 00 00 14 00 00 29 00 00 00 02 00 00 00 00 00 02 62 00 00 00 02
 02 34 34 02 00 00 00 31 00 00 00 00 00 32 14 00 00 00 00 00 00 00 02 02 02 00 00 00 02 00 00 00 02
 02 13 13 02 00 00 00 00 00 00 00 00 00 00 14 00 00 00 00 00 00 00 29 53 62 02 00 00 00 02 00 00 02
 02 39 00 02 00 00 00 00 00 00 00 00 00 00 14 00 00 00 00 00 02 02 02 02 02 49 00 00 00 00 02 62 02
 02 00 00 02 13 13 13 13 13 13 13 13 13 13 14 00 00 00 02 02 00 00 00 00 00 00 00 00 00 35 46 02 02
 02 00 00 02 00 00 00 00 00 00 00 00 00 00 14 00 00 00 02 21 00 38 00 00 00 00 00 00 00 00 02 62 02
 02 00 00 02 00 00 00 00 00 00 00 00 00 00 14 28 00 02 21 00 00 02 02 02 02 02 02 02 02 02 00 00 02
 02 00 00 02 00 00 00 00 00 00 00 00 00 00 14 00 02 21 00 00 02 20 01 00 00 00 00 00 00 05 00 00 02
 02 00 00 02 49 25 25 25 25 25 00 00 00 00 14 02 53 53 53 02 20 01 00 00 00 00 00 00 00 05 05 05 02
 02 46 46 02 02 02 02 02 02 02 02 02 02 02 02 00 00 29 02 01 01 00 00 00 00 00 00 00 00 00 00 00 02
 02 00 00 00 14 00 24 00 49 00 24 00 14 00 00 00 00 02 04 00 00 00 00 00 00 00 00 00 00 00 00 00 02
 02 53 53 62 14 00 24 00 62 00 24 00 14 00 00 00 02 00 00 00 00 00 00 00 00 00 00 00 00 00 00 00 02
 02 02 02 02 02 02 02 02 02 02 02 02 02 02 02 02 00 00 00 00 00 00 00 00 00 00 00 00 00 00 00 00 02
 02 16 08 00 00 10 10 00 00 00 00 00 01 00 00 00 00 44 00 00 00 00 00 00 00 00 00 00 01 01 01 01 02
 02 08 00 00 00 29 00 00 00 00 00 00 01 00 00 00 00 00 00 00 00 46 00 00 00 00 00 01 20 20 20 20 02
 02 00 00 30 00 00 00 00 00 00 00 00 01 00 00 00 00 00 00 00 00 00 00 00 00 00 00 00 00 01 00 00 02
 02 47 00 00 00 29 00 00 00 00 00 00 01 00 00 00 00 00 00 00 00 00 00 00 00 44 00 00 26 26 01 50 02
 02 02 02 02 02 02 02 02 02 02 02 02 02 02 02 02 02 02 02 02 02 02 02 02 02 02 02 02 02 02 02 02 02
