Gauntlet II
Maze number: 77
Offset for maze 76: 233437 - 0x038fdd
big endian buf: [%!l(uint8=0) %!l(uint8=3) %!l(uint8=143) %!l(uint8=221)]
G:2 Maze real addr: 249821 - 0x03CFDD, bank 2, boff: 0x4000
Maze read from: 0x03cfdd - 249821
compresssed: 282
 0D 00 00 00 28 51 3A 48 59 0E 9D C2 1A 81 E3 CC
 1A 81 C0 0B A0 33 C2 A1 25 A0 C0 A1 42 C2 A1 E2
 C4 0B A0 E3 E1 E0 E1 40 2F 08 E0 E1 E0 31 05 E3
 0A 80 E1 48 C0 24 40 E2 E1 71 A2 04 A1 32 2E A0
 48 40 E7 E4 E1 E1 1F A2 44 F0 73 A0 2E F6 C3 A1
 E2 ED E5 E7 C8 2E 29 E2 62 F9 62 E3 C3 31 CA 2E
 E3 62 E3 10 C3 1C E0 E6 C1 23 A0 64 E3 73 B4 A3
 C2 1F E0 E3 E1 60 E3 C2 B4 C3 35 E5 2E C2 1A 80
 A0 E6 1C C6 0F C5 1F 31 A0 E2 E3 E2 F4 E3 E2 C0
 71 A0 C4 A1 54 A0 C2 1F E7 E4 C8 1C E0 E2 E7 C1
 1E E3 C3 07 B4 C0 B2 E4 E1 E6 C5 0D 81 C0 07 C2
 05 E3 E3 2F E2 E1 CC 05 E4 E3 B4 1C C1 31 C9 B2
 C4 A1 E3 E4 ED C1 2E A0 E6 E4 EB 32 E1 C1 20 E5
 E4 CB A1 1C EA C4 7C A0 E4 E5 CA 76 A0 E4 E5 0D
 83 EF E2 C1 29 E7 CB 0D 82 E3 C6 35 80 CA 09 0D
 80 13 18 2E C2 0D 85 C1 35 19 80 35 64 C4 09 13
 82 51 0C 51 14 80 1A 80 14 80 0E C0 35 18 0C 80
 18 35 53 61 36 19 C3 09 31 00
  Encoded length: 282 bytes
  Wall pattern: 01, Wall color: 10     Floor pattern: 05, Floor color: 03
  Flags: TRAPS_RANDOM WRAP_H 
  Random food adds: 0
  Secret trick: 13 - Don't Be Greedy (no treasure)
 02 02 02 02 02 02 02 02 02 02 02 02 02 02 02 02 02 02 02 02 02 02 02 02 02 02 02 02 02 02 02 02
 00 00 00 26 26 26 00 00 00 00 02 00 00 00 00 00 00 00 00 00 00 00 00 00 26 26 26 00 11 02 51 00
 00 00 02 02 37 02 00 02 02 00 00 00 08 00 00 00 02 02 00 00 00 02 00 00 00 00 00 11 02 00 00 00
 00 02 00 00 02 00 02 00 00 02 00 08 47 08 00 02 00 00 02 00 02 49 05 00 00 00 00 02 10 10 00 00
 02 00 00 00 00 00 00 00 00 00 08 00 36 00 08 00 00 00 02 00 00 02 29 00 00 02 02 02 04 02 02 50
 46 02 00 00 00 00 00 00 00 00 00 08 00 08 00 00 00 00 00 00 00 00 02 00 00 00 00 00 02 00 00 02
 00 00 02 31 02 02 02 00 00 00 00 00 08 00 00 00 00 00 00 00 00 00 00 00 00 00 00 00 00 00 02 29
 00 00 00 00 02 46 00 00 00 00 00 00 00 00 00 00 00 00 00 00 00 00 00 00 00 00 00 00 00 02 00 00
 00 00 02 02 00 00 00 02 00 00 00 00 00 00 00 00 00 00 00 00 00 00 02 00 00 00 00 00 00 02 00 00
 00 02 00 00 00 00 02 00 00 00 00 00 00 00 00 00 46 41 00 00 00 02 00 00 00 25 00 00 00 00 02 00
 00 02 00 00 00 00 00 00 00 00 00 00 00 00 00 00 00 00 00 00 02 00 00 00 25 00 00 00 00 02 02 00
 00 02 49 00 00 00 00 00 00 00 00 00 00 00 46 00 00 00 00 02 00 00 00 25 00 00 00 00 02 16 02 00
 00 02 28 00 02 00 00 00 00 00 00 00 02 00 00 35 02 00 00 00 00 00 25 00 00 00 00 02 29 00 02 00
 00 02 02 02 14 02 00 00 00 31 00 02 00 00 00 00 02 00 00 02 00 25 00 00 00 00 02 00 00 00 02 00
 00 00 00 53 14 00 00 00 00 00 02 46 00 00 00 26 26 02 00 00 00 00 00 00 00 02 28 00 00 00 00 02
 00 00 15 00 14 00 00 00 00 31 49 02 00 00 00 02 00 00 00 00 02 00 00 00 02 00 00 00 00 00 00 02
 00 00 00 00 14 00 00 00 00 00 00 00 00 00 02 00 00 00 00 02 00 00 00 02 00 29 00 00 02 00 00 02
 00 02 02 02 14 02 00 00 00 31 00 00 00 02 00 00 00 00 02 00 00 00 00 00 02 00 00 00 00 00 00 02
 00 02 28 00 02 00 00 00 02 00 00 00 00 02 00 00 00 02 00 00 30 00 00 00 00 02 00 00 00 00 07 02
 00 02 00 00 00 00 00 02 00 00 02 00 00 02 00 00 00 00 02 00 00 00 00 00 00 13 13 13 02 07 00 00
 00 05 00 00 00 00 02 00 00 00 00 02 47 02 00 00 02 00 00 02 00 00 00 00 00 00 00 00 02 00 00 00
 00 05 00 00 00 00 00 02 00 00 00 00 02 02 28 00 00 49 00 00 00 00 00 00 00 00 00 00 02 00 00 00
 00 00 02 02 00 00 00 00 02 00 00 00 00 00 02 00 00 00 00 00 00 00 00 00 00 00 00 00 00 02 00 00
 46 02 00 00 00 00 00 00 00 02 00 00 00 00 00 02 00 00 00 00 00 00 00 00 00 00 00 00 02 50 00 00
 02 00 00 32 00 00 00 00 00 00 02 00 00 00 00 00 02 00 00 00 00 00 00 00 00 00 00 00 00 02 02 28
 00 00 00 00 00 00 00 00 00 00 00 02 00 00 00 00 00 29 00 00 00 00 00 00 00 00 00 00 00 00 00 02
 00 00 00 00 00 02 00 00 00 00 00 00 02 00 00 00 00 00 00 00 00 00 00 00 29 00 00 00 00 00 00 00
 02 00 00 00 00 00 02 00 00 00 00 00 00 02 13 13 13 13 13 00 00 00 00 00 00 00 00 00 00 00 00 00
 00 00 00 02 00 00 00 02 00 00 41 00 00 00 00 00 00 00 00 02 14 00 00 00 00 00 00 00 00 00 00 00
 13 13 13 13 00 00 00 00 02 00 00 00 00 00 00 00 53 53 00 00 14 00 00 00 00 00 00 00 00 09 13 13
 19 24 46 14 00 14 13 13 13 13 13 13 13 00 00 53 25 25 53 00 14 00 00 00 25 00 00 00 00 00 09 19
 19 19 19 14 12 14 20 20 26 26 20 20 14 00 53 24 12 12 24 53 14 00 00 25 54 25 00 00 00 00 09 49
 02 02 02 02 02 02 02 02 02 02 02 02 02 02 02 02 02 02 02 02 02 02 02 02 02 02 02 02 02 02 02 02
