Gauntlet II
Maze number: 79
Offset for maze 78: 234068 - 0x039254
big endian buf: [%!l(uint8=0) %!l(uint8=3) %!l(uint8=146) %!l(uint8=84)]
G:2 Maze real addr: 250452 - 0x03D254, bank 2, boff: 0x4000
Maze read from: 0x03d254 - 250452
compresssed: 263
 09 01 1A 00 04 84 11 49 8B 08 07 2E 80 33 C1 2F
 31 C1 1D 46 1D 09 31 C6 25 C0 10 81 CA 0A 43 81
 CD 20 C4 B2 C3 07 C5 0C C8 3C CD 1F C7 08 CE 1C
 C4 72 07 72 0A C5 20 C5 B4 C5 B5 CF 52 08 52 C4
 31 D8 0C 62 B5 C9 0A C5 08 C2 31 62 09 81 0C 60
 A0 CF 22 C2 0C 43 2A 09 E2 0B 0C C0 1F C0 1F C3
 76 C3 52 08 52 46 81 CB 1C C7 6F CA 0A C8 1F 0A
 C7 08 CB 07 CA 31 0A C4 21 CB 20 C1 1C C0 0C CB
 52 08 C5 25 C3 72 07 72 D1 BF C4 63 0A C7 07 C6
 64 2E CF 71 20 71 C1 0A C0 07 C3 0A C1 1C C8 60
 08 43 81 C3 28 CA 2E C0 58 C4 28 43 1D 09 C2 72
 07 72 4B 81 C1 52 08 52 42 81 D1 09 1E 08 C3 65
 0C C6 0B 81 46 81 D0 08 C0 31 C7 0C 09 3A D1 20
 4A 81 08 84 07 86 C1 52 08 52 C5 BF D0 0A 2E CC
 19 3A C6 61 26 C5 72 6A 3A 19 CF 28 A0 C4 1D 35
 C3 B2 AD C3 A9 DD 2E C1 0F C9 1C 2E CA 1C C3 21
 BE 2E D1 28 C9 32 00
  Encoded length: 263 bytes
  Wall pattern: 04, Wall color: 01     Floor pattern: 08, Floor color: 01
  Flags: ODDANGLE_GHOSTS TRAPS_LOCAL FAST_GRUNTS FAST_SORCERERS FAST_LOBBERS 
  Random food adds: 0
  Secret trick:  9 - Don't Get Hit (while killing a dragon)
 02 02 02 02 02 02 02 02 02 02 02 02 02 02 02 02 02 02 02 02 02 02 02 02 02 02 02 02 02 02 02 02 02
 02 46 51 00 02 47 49 00 02 29 00 00 00 00 00 00 00 09 29 09 49 00 00 00 00 00 00 00 37 02 16 16 02
 02 00 00 00 02 00 00 00 02 00 00 00 10 00 00 00 00 09 09 09 00 00 00 00 00 00 00 00 02 02 00 00 02
 02 00 32 00 02 00 00 00 02 00 00 00 07 07 07 00 00 00 00 00 12 00 00 00 00 00 00 00 02 02 60 00 02
 02 00 00 00 02 00 00 00 07 00 00 00 07 31 07 00 00 00 00 00 00 08 08 08 00 00 00 00 02 02 00 00 02
 02 00 00 00 02 00 28 00 07 00 00 00 07 07 07 10 00 00 00 00 00 08 32 08 00 00 00 00 02 02 00 00 02
 02 00 00 00 02 00 00 00 07 00 00 00 00 00 00 00 00 00 00 00 00 08 08 08 00 00 00 00 02 49 00 00 02
 02 00 00 00 00 00 00 00 07 00 00 00 00 00 00 00 00 00 00 00 00 00 00 12 11 00 00 00 02 00 00 00 02
 02 00 00 00 00 00 00 10 07 00 00 00 00 08 08 08 00 00 49 11 00 00 00 09 09 09 12 11 00 02 00 00 02
 02 00 00 00 00 00 00 00 07 00 00 00 00 08 34 08 00 00 12 00 00 00 00 09 42 09 00 00 00 02 11 12 02
 02 31 00 31 02 00 00 00 07 00 00 00 00 08 08 08 00 00 00 00 00 00 00 09 09 09 00 00 00 00 00 00 02
 02 00 00 00 02 00 28 00 08 00 00 00 00 00 00 11 00 00 00 00 00 00 00 00 00 00 00 00 00 00 00 00 02
 02 00 00 00 02 00 00 00 08 00 00 10 00 00 00 00 00 00 00 00 00 31 10 00 00 00 00 00 00 00 08 08 02
 02 00 00 00 02 00 00 00 08 00 00 07 07 07 00 00 00 00 00 00 00 00 00 00 49 10 00 00 00 00 08 33 02
 02 00 00 00 02 00 00 00 08 00 00 07 32 07 00 28 00 12 00 00 00 00 00 00 00 00 00 00 00 00 08 08 02
 02 00 00 00 02 00 37 00 08 00 00 07 07 07 00 00 00 00 00 00 00 00 00 00 00 00 00 00 00 00 00 00 02
 02 00 00 00 02 00 11 00 08 00 00 10 00 00 00 00 00 00 00 07 07 07 00 00 00 00 00 00 11 00 00 00 02
 02 00 46 00 02 00 00 00 08 00 00 00 00 00 00 00 00 00 00 07 32 07 00 00 10 07 07 07 00 00 00 10 02
 02 00 28 00 02 00 00 00 08 00 00 00 11 08 08 08 00 00 00 09 09 09 00 00 00 07 40 07 00 00 00 00 02
 02 00 00 00 02 00 46 00 08 00 00 00 00 08 40 08 00 00 00 09 29 09 00 00 00 07 07 07 00 00 00 00 02
 02 00 00 00 02 00 00 00 09 09 09 00 00 08 08 08 00 00 00 09 09 09 00 00 00 00 00 00 00 00 00 00 02
 02 00 00 00 02 00 00 00 09 30 08 00 00 00 00 11 00 00 00 00 00 00 12 00 00 00 00 00 00 00 11 11 02
 02 00 00 00 02 00 00 00 09 09 09 00 00 00 00 00 00 00 00 00 00 00 00 00 00 00 00 08 08 08 49 00 02
 02 00 00 00 02 00 00 12 09 58 00 00 00 00 00 00 00 00 00 00 00 00 00 00 00 00 00 08 32 08 00 00 02
 02 00 00 00 02 00 00 00 09 09 09 08 08 08 08 08 08 07 07 07 07 07 07 07 07 00 00 08 08 08 00 00 02
 02 00 00 00 02 00 00 00 00 00 00 00 00 00 00 00 00 00 00 00 00 00 10 46 07 00 00 00 00 00 00 00 02
 02 00 00 00 02 25 58 00 00 00 00 00 00 00 11 00 00 38 00 00 00 00 00 00 07 11 00 00 00 00 00 00 02
 02 00 00 00 02 58 25 00 00 00 00 00 00 00 00 00 00 00 00 00 00 00 00 40 02 00 00 00 00 00 29 53 02
 02 00 00 00 02 02 02 02 02 02 02 02 02 02 02 02 02 02 02 00 00 00 00 02 02 02 02 02 02 02 02 02 02
 02 00 00 00 00 00 00 00 00 00 00 00 00 00 00 00 00 00 00 00 00 00 00 00 00 00 00 00 00 00 00 46 02
 02 00 15 00 00 00 00 00 00 00 00 00 00 28 46 00 00 00 00 00 00 00 00 00 00 00 28 00 00 00 00 33 02
 02 46 00 00 00 00 00 00 00 00 00 00 00 00 00 00 00 00 00 00 40 00 00 00 00 00 00 00 00 00 00 50 02
 02 02 02 02 02 02 02 02 02 02 02 02 02 02 02 02 02 02 02 02 02 02 02 02 02 02 02 02 02 02 02 02 02
