Gauntlet II
Maze number: 24
Offset for maze 23: 234916 - 0x0395a4
big endian buf: [%!l(uint8=0) %!l(uint8=3) %!l(uint8=149) %!l(uint8=164)]
G:2 Maze real addr: 234916 - 0x0395A4, bank 0, boff: 0x0000
Maze read from: 0x0395a4 - 234916
compresssed: 229
 03 00 00 08 20 42 EB 45 6E 01 0E 15 A0 C4 31 CC
 31 E7 15 40 DB 05 A0 41 C4 B2 CA B2 47 44 D7 05
 46 C6 1F C0 0F C0 1F 49 C7 A8 B4 A0 B4 AB C8 22
 C3 1C 2E C1 1D C0 35 C0 1F C5 37 18 C8 71 DF E8
 CB 72 F0 1D CF 1D C4 35 6B E1 CD B3 F1 C2 B2 CB
 29 C1 01 87 C0 09 C0 1F E0 C5 BC F5 C2 71 C3 1D
 C2 72 3E C4 3E C8 08 34 C0 35 05 CA 35 61 C8 31
 E3 DC 07 C0 1F E0 C9 B2 C4 55 01 81 55 01 82 55
 E2 C2 B3 61 D2 2E E1 CD 71 E7 1D D8 2E C3 1C A0
 CA 35 72 C6 1E D4 08 09 DC 08 09 07 C0 1D C7 22
 C3 1D C3 1E C2 1C 80 C2 09 07 18 C8 B4 05 A6 0D
 81 A9 05 B3 CB 22 C1 33 C3 39 60 35 28 D6 B2 0D
 80 A2 CD 36 68 A0 C4 B3 67 CC 22 E0 E6 C0 28 F3
 E8 CA BF 2E C4 22 32 A0 C2 27 B4 10 B4 27 E2 3A
 28 C6 31 A0 00
  Encoded length: 229 bytes
  Wall pattern: 02, Wall color: 11     Floor pattern: 04, Floor color: 14
  Flags: WRAP_H WALLS_CYCLIC 
  Random food adds: 0
  Secret trick:  3 - Try Transportability (into exit)
 02 02 02 02 02 02 02 02 02 02 02 02 02 02 02 02 02 02 02 02 02 02 02 02 02 02 02 02 02 02 02 02
 21 02 00 00 00 00 00 49 02 00 00 00 00 00 00 00 00 00 00 00 02 49 00 00 00 00 00 00 00 00 02 21
 02 05 00 00 00 00 00 00 02 00 00 00 00 02 00 02 00 00 00 00 02 00 00 00 00 00 00 00 00 00 05 02
 02 00 05 00 00 00 00 00 02 00 00 00 00 02 00 02 00 00 00 00 02 00 00 00 00 00 00 00 00 05 00 00
 02 00 00 05 00 00 00 00 00 00 00 00 00 02 00 02 00 00 00 00 00 00 00 00 00 00 00 00 05 00 00 00
 02 00 00 00 05 00 00 00 00 00 00 00 31 02 15 02 31 00 00 00 00 00 00 00 00 00 00 05 00 00 00 00
 02 00 00 00 02 02 02 02 02 02 02 02 02 02 02 02 02 02 02 02 02 02 02 02 02 02 02 02 00 00 00 00
 02 00 00 00 14 34 00 00 00 00 28 46 00 00 29 00 53 00 31 00 00 00 00 00 00 55 24 14 00 00 00 00
 02 00 00 00 14 00 00 00 00 00 00 00 00 00 00 00 00 00 00 00 00 00 00 00 00 00 00 14 00 00 00 00
 02 00 00 00 02 00 00 00 00 00 00 00 00 00 02 00 00 00 00 00 00 00 00 00 00 00 00 14 00 00 00 00
 02 00 00 00 02 00 00 00 00 00 00 00 00 02 29 00 00 00 00 00 00 00 00 00 00 00 00 02 00 00 00 29
 02 00 00 00 02 53 00 00 00 00 00 00 00 00 00 00 00 00 46 00 00 02 00 00 00 00 00 02 00 00 00 00
 02 00 00 00 02 00 00 00 00 00 00 00 00 00 00 00 00 00 00 00 00 00 00 02 00 00 00 02 00 00 00 00
 02 00 00 00 14 00 00 00 41 00 01 01 01 01 01 01 01 01 01 01 00 09 00 31 00 02 00 14 00 00 00 00
 02 00 00 00 14 00 00 00 00 00 01 00 00 00 01 00 00 00 00 01 00 00 00 02 00 00 00 14 00 00 00 00
 29 00 00 00 14 62 00 00 00 00 01 62 00 00 01 00 00 00 00 01 00 08 52 00 53 05 00 02 00 00 00 02
 00 00 00 00 02 53 00 00 46 00 01 00 00 00 01 00 00 00 49 01 00 00 00 02 00 00 00 02 00 00 00 02
 00 00 00 00 02 00 00 00 00 00 01 00 00 00 01 00 00 00 00 01 00 07 00 31 00 02 00 02 00 00 00 02
 00 00 00 00 02 00 00 00 00 00 01 01 01 01 01 01 01 01 01 01 00 00 00 02 00 00 00 02 00 00 46 02
 00 00 00 00 14 00 00 00 00 00 00 00 00 00 00 00 00 00 46 00 00 02 00 00 00 00 00 14 00 00 00 02
 00 00 00 00 14 00 00 00 00 00 00 00 00 02 29 00 00 00 00 00 00 00 00 00 00 00 00 14 00 00 00 02
 00 00 00 00 02 00 00 00 46 00 00 00 00 28 02 00 00 00 00 00 00 00 00 00 00 00 53 14 00 00 00 02
 00 00 00 30 02 00 00 00 00 00 00 00 00 00 00 00 00 00 00 00 00 00 00 00 00 08 09 02 00 00 00 02
 00 00 00 00 02 00 00 00 00 00 00 00 00 00 00 00 00 00 00 00 00 00 00 00 08 09 07 02 29 00 00 02
 00 00 00 00 02 34 00 00 00 00 29 00 00 00 00 30 00 00 00 28 28 00 00 00 09 07 24 02 00 00 00 02
 00 00 00 00 02 05 02 02 02 02 02 02 02 13 13 13 02 02 02 02 02 02 02 02 02 02 05 02 00 00 00 02
 00 00 00 00 00 00 00 00 34 00 00 51 02 00 00 00 57 02 46 53 40 00 00 00 00 00 00 00 00 00 00 02
 00 00 00 00 00 00 00 00 00 00 00 00 02 02 13 02 02 02 00 00 00 00 00 00 00 00 00 00 00 00 00 02
 54 00 00 00 00 00 00 00 00 00 46 02 00 02 00 02 00 02 00 00 00 00 00 00 00 00 46 00 00 00 00 02
 00 00 00 00 00 00 00 00 34 00 02 00 00 02 00 02 00 00 02 00 40 00 00 00 00 00 00 00 00 00 00 02
 00 00 00 00 00 00 00 00 00 02 00 00 00 02 00 02 00 00 00 02 00 00 00 00 00 00 00 00 00 00 00 02
 46 00 00 00 00 00 34 50 02 00 00 00 39 02 16 02 39 00 00 00 02 58 40 00 00 00 00 00 00 00 49 02
 02 02 02 02 02 02 02 02 02 02 02 02 02 02 02 02 02 02 02 02 02 02 02 02 02 02 02 02 02 02 02 02
