Gauntlet II
Maze number: 37
Offset for maze 36: 230081 - 0x0382c1
big endian buf: [%!l(uint8=0) %!l(uint8=3) %!l(uint8=130) %!l(uint8=193)]
G:2 Maze real addr: 238273 - 0x03A2C1, bank 1, boff: 0x2000
Maze read from: 0x03a2c1 - 238273
compresssed: 390
 11 00 00 00 20 80 63 89 62 5D 6E 3A A0 C0 24 E0
 2E C2 3E A0 32 E0 3E E2 3E E2 C0 24 10 09 0F E3
 C0 1E E0 E3 60 07 A0 E3 C0 41 A0 C2 44 42 A0 E3
 C0 15 E0 E3 C0 41 A0 C2 43 2E 40 24 E0 E3 C1 1E
 A0 C1 40 22 C0 09 2E E0 1E C1 09 80 72 42 A0 E3
 E2 C1 40 43 A0 C0 24 C1 42 2E 40 1E E0 E3 E2 C1
 40 A0 E3 C3 42 2E 42 A0 E3 1D 15 E0 E3 E3 C0 1E
 C1 42 2E 40 24 E0 C0 31 E1 C1 1C A0 72 A0 C3 A1
 C2 42 2E 40 A0 E3 E2 C2 32 A0 E0 E4 C0 24 C0 42
 2E A0 E3 C0 15 E0 E3 60 E0 E4 C2 46 A0 60 E0 E3
 E4 E4 E2 E4 E2 E3 C1 1C A0 E2 E4 1E E1 E2 51 A0
 E3 50 E0 08 A0 1C C1 A1 E3 E2 E0 C0 15 E0 E3 E2
 E2 C0 1F E1 E3 C0 23 E0 1C E1 E3 E2 E4 E3 E3 E4
 E3 60 E0 E6 E3 E3 50 E0 E3 E2 E3 C3 A1 1C E1 E3
 E0 E3 C1 1C A0 32 E2 E0 E4 C0 15 1C A0 E3 05 2E
 E1 1D E1 08 E2 60 E0 E4 E2 52 09 05 E2 E2 E3 C0
 0C 1C A0 C4 05 E2 C1 31 05 A0 E3 C0 1F E0 E3 E2
 C1 32 A0 60 E0 E3 E0 E3 E2 E3 C2 A2 E2 E3 60 E0
 51 E0 E2 E3 1C 54 A0 E3 1C E3 E3 C1 1C A0 E3 C0
 15 1F E1 E3 E2 E2 E3 E2 E3 C1 34 A0 E3 E2 E0 1D
 E1 E3 C1 1C A0 C3 A2 E3 60 E0 C1 0A A0 60 E0 E3
 E2 E8 1C E1 E4 C0 15 E0 51 E0 E2 E6 E2 E6 C0 07
 0B A0 E3 51 A0 E4 C0 15 E0 E3 E3 E2 E3 E2 E2 32
 23 E0 32 08 E1 15 A0 C0 3E 08 3A A0 C0 3E E0 C1
 3E E0 32 22 E0 00
  Encoded length: 390 bytes
  Wall pattern: 00, Wall color: 03     Floor pattern: 08, Floor color: 06
  Flags: WRAP_H 
  Random food adds: 0
  Secret trick: 17 - Don't Hurt Friends
 02 02 02 02 02 02 02 02 02 02 02 02 02 02 02 02 02 02 02 02 02 02 02 02 02 02 02 02 02 02 02 02
 58 02 00 36 00 02 46 00 00 00 62 02 50 00 02 62 00 00 00 02 62 00 00 00 02 00 36 16 09 15 00 00
 00 00 02 00 30 00 02 00 00 00 00 02 00 34 07 02 00 00 00 00 02 00 09 00 00 02 00 00 00 09 00 00
 00 00 00 09 00 00 00 02 00 00 00 00 02 00 21 00 02 00 00 00 00 02 00 09 00 00 02 00 00 00 09 00
 00 00 00 46 09 00 36 00 02 00 00 00 00 02 00 00 30 02 00 00 09 00 34 00 09 46 00 02 30 00 00 09
 09 00 00 00 46 09 00 00 00 02 00 00 00 00 02 00 00 00 02 00 00 09 00 09 00 00 00 00 02 00 36 00
 00 09 00 00 00 46 09 00 30 00 02 00 00 00 00 02 00 00 00 02 00 00 09 00 02 00 00 00 00 02 00 00
 00 00 09 00 00 00 46 09 00 00 00 02 00 00 00 00 02 29 21 00 02 00 00 00 00 02 00 00 00 00 02 00
 30 00 00 09 00 00 00 46 09 00 36 00 02 00 49 00 00 02 00 00 28 02 00 00 00 46 02 00 00 00 00 02
 02 00 00 00 09 00 00 00 46 09 00 02 00 00 00 00 02 00 00 00 02 00 00 00 50 02 00 02 00 00 00 00
 00 02 00 36 00 09 00 00 00 46 02 00 00 00 00 02 00 21 00 02 00 00 00 00 02 00 34 00 02 00 00 00
 00 00 02 00 00 00 09 00 00 00 00 00 00 00 02 00 34 00 02 00 00 00 00 02 00 00 00 00 00 02 00 00
 00 00 00 02 00 00 00 02 00 00 00 00 00 02 00 00 00 02 00 00 00 00 02 00 00 28 02 00 00 00 02 00
 00 00 00 00 02 30 00 00 02 00 00 00 02 00 00 29 02 00 00 00 00 02 00 29 00 02 08 02 28 00 00 02
 02 00 00 00 00 02 00 00 00 02 00 02 00 21 00 02 00 00 00 00 02 00 00 00 02 00 00 00 02 00 31 00
 00 02 00 00 00 00 02 00 35 00 02 28 00 00 02 00 00 00 00 02 00 00 00 02 00 00 00 00 00 02 00 00
 00 00 02 00 00 00 00 02 00 00 00 00 00 02 00 00 00 00 02 00 34 00 02 00 00 00 00 00 00 00 02 00
 00 00 00 02 00 00 00 00 02 00 29 00 02 00 00 00 00 02 00 00 00 02 00 00 00 00 02 00 00 00 00 02
 02 28 00 00 02 00 00 00 00 02 00 02 00 00 00 00 02 00 00 28 02 50 00 00 00 02 00 02 00 00 00 00
 00 02 00 21 28 02 00 00 00 00 02 05 46 00 00 02 29 00 00 02 08 00 00 00 02 00 34 00 02 00 00 00
 00 00 02 00 00 00 02 00 00 00 29 09 05 00 00 00 02 00 00 00 02 00 00 00 00 02 00 12 28 02 00 00
 00 00 00 05 00 00 00 02 00 00 49 05 02 00 00 00 00 02 00 31 00 02 00 00 00 00 02 00 00 00 02 00
 00 50 02 00 34 00 02 00 00 00 00 02 00 02 00 00 00 00 02 00 00 00 02 00 00 00 00 02 00 00 00 02
 02 02 00 00 00 02 00 00 00 00 02 00 34 00 02 00 00 29 00 02 00 00 00 02 00 00 00 00 02 28 00 00
 00 00 00 29 02 00 00 00 00 02 28 00 00 00 00 02 00 00 00 00 02 00 00 28 02 00 00 00 00 02 00 21
 31 00 00 02 00 00 00 00 02 00 00 00 02 00 00 00 02 00 00 00 00 02 00 00 00 02 00 00 00 00 02 00
 00 52 02 00 00 00 00 02 00 00 00 02 00 02 29 00 00 02 00 00 00 00 02 00 00 28 02 00 00 00 00 02
 02 02 00 00 00 00 02 00 34 00 02 00 00 10 02 00 34 00 02 00 00 00 00 02 00 00 00 02 00 00 00 00
 00 00 00 00 00 02 28 00 00 02 00 00 00 00 00 02 00 21 00 02 00 00 29 00 02 00 00 00 02 00 00 00
 00 00 00 00 02 00 00 00 02 00 00 00 00 00 00 00 02 00 07 11 02 00 00 00 00 02 00 00 29 02 00 00
 00 00 00 02 00 21 00 02 00 00 00 00 02 00 00 00 00 02 00 00 00 02 00 00 00 00 02 00 00 00 02 00
 00 00 02 50 35 00 02 50 08 00 00 02 21 02 00 62 08 58 02 00 62 00 02 00 00 62 00 02 50 34 00 02
 02 02 02 02 02 02 02 02 02 02 02 02 02 02 02 02 02 02 02 02 02 02 02 02 02 02 02 02 02 02 02 02
