Gauntlet II
Maze number: 112
Offset for maze 111: 235285 - 0x039715
big endian buf: [%!l(uint8=0) %!l(uint8=3) %!l(uint8=151) %!l(uint8=21)]
G:2 Maze real addr: 259861 - 0x03F715, bank 3, boff: 0x6000
Maze read from: 0x03f715 - 259861
compresssed: 369
 0F 00 00 80 20 61 95 AE 45 7E 4F 05 2F 53 05 43
 10 05 41 10 A0 2F C2 2E 05 43 10 05 C3 2E 05 C4
 2E 05 C3 2E A0 63 C6 43 A0 C4 A1 C3 A1 E3 C5 2E
 A0 C2 2E A0 43 05 43 A0 42 2E 05 44 A1 C2 A1 C3
 A1 3E C2 A1 3E C2 A1 C4 2E A0 C3 04 E4 43 A0 43
 A0 2E 3E C3 A1 E3 C2 2E A1 C3 A1 42 A1 65 42 2E
 A0 E3 43 A0 C4 04 44 A1 E4 40 2E A1 C3 A1 41 2E
 A1 E5 2F C3 A1 E2 C3 35 A0 E4 43 2E A1 64 42 A0
 C3 A1 C3 A1 E5 43 A1 42 A0 C2 2E A0 42 2E A0 44
 A1 E4 43 A0 41 A1 C3 A1 E5 C3 2E A1 C3 A1 E2 C3
 2E A0 43 2E A1 42 2E A0 E4 42 A0 42 A1 E5 C4 A1
 C3 A1 E3 70 E1 71 C2 A1 70 C2 40 0F C1 2E A0 40
 0F E1 C2 A1 43 2E A0 43 A1 E3 04 C3 A1 C2 45 A1
 C3 2E A0 E4 43 A0 42 A0 E5 43 A1 C3 A1 C3 A1 C2
 2E A0 C3 2E A1 2F C2 2E A0 C3 2E A0 43 A0 43 A0
 43 A0 C4 A1 41 3E A1 52 A1 C3 A1 C2 2E A1 43 A0
 E4 2F E3 43 A0 43 A0 C4 A1 42 A1 C3 A1 C3 A1 E4
 42 2E A0 E4 43 A0 43 A0 43 2E A0 C3 A1 C3 A1 C3
 A1 C3 A1 65 E3 C3 2E 05 42 2E A0 C3 2E A0 3E C4
 A1 41 04 A0 42 A1 C3 A1 C3 A1 C4 2E A0 42 A0 E4
 C3 2E 04 43 05 C5 A1 C4 42 A1 C3 A1 C3 2E A0 43
 2E A0 E5 E2 53 A0 65 C4 A1 65 C1 2E A0 10 C2 2E
 05 2E 10 52 05 35 C2 2E A0 10 42 3E 2E 05 35 C0
 00
  Encoded length: 369 bytes
  Wall pattern: 01, Wall color: 05     Floor pattern: 06, Floor color: 09
  Flags: WRAP_H EXIT_CHOOSE_ONE 
  Random food adds: 0
  Secret trick: 15 - Be Pushy
 02 02 02 02 02 02 02 02 02 02 02 02 02 02 02 02 02 02 02 02 02 02 02 02 02 02 02 02 02 02 02 02
 05 47 00 00 00 00 62 05 46 00 00 00 00 16 05 46 00 00 16 02 47 00 00 00 46 05 46 00 00 00 00 16
 05 00 00 00 00 46 05 00 00 00 00 00 46 05 00 00 00 00 46 02 00 00 00 00 05 00 00 00 00 00 00 00
 46 00 00 00 00 02 00 00 00 00 00 02 02 00 00 00 00 02 02 00 00 00 00 02 00 00 00 00 00 00 46 02
 00 00 00 46 02 46 00 00 00 00 05 46 00 00 00 00 02 46 00 00 00 46 05 46 00 00 00 00 00 02 02 00
 00 00 02 02 00 00 00 00 02 02 62 00 00 00 02 02 62 00 00 00 02 02 00 00 00 00 00 46 02 00 00 00
 00 04 00 00 00 00 00 02 46 00 00 00 00 02 46 00 00 00 00 02 46 62 00 00 00 00 02 02 00 00 00 00
 02 00 00 00 46 02 02 00 00 00 00 02 02 46 00 00 00 02 02 00 00 00 00 00 00 05 46 00 00 00 46 02
 00 00 00 00 02 46 00 00 00 00 02 00 00 00 00 00 04 46 00 00 00 00 00 02 02 00 00 00 00 00 02 46
 00 46 02 02 00 00 00 00 02 02 46 00 00 46 02 02 00 00 00 00 00 00 02 47 00 00 00 00 02 02 00 00
 00 02 00 00 00 00 53 02 00 00 00 00 00 02 46 00 00 00 00 46 02 02 00 00 00 00 00 05 46 00 00 00
 02 00 00 00 00 02 02 00 00 00 00 02 02 00 00 00 00 00 00 02 46 00 00 00 00 02 02 46 00 00 00 02
 00 00 00 46 02 46 00 00 00 46 02 46 00 00 00 00 00 02 02 00 00 00 00 00 02 46 00 00 00 00 02 46
 00 00 02 02 00 00 00 00 02 02 00 00 00 00 00 00 02 00 00 00 00 46 02 02 00 00 00 00 02 02 00 00
 00 02 00 00 00 00 46 02 46 00 00 00 00 46 02 02 46 00 00 00 46 02 00 00 00 00 00 02 46 00 00 00
 02 46 00 00 00 02 02 00 00 00 00 00 00 02 00 00 00 00 00 02 02 00 00 00 00 02 02 00 00 00 00 02
 00 15 00 00 02 00 00 15 00 00 00 02 02 00 15 00 00 00 46 00 15 00 00 46 02 46 00 15 00 00 02 00
 00 00 02 02 46 00 00 00 00 46 02 46 00 00 00 00 02 02 00 00 00 00 02 04 00 00 00 00 02 02 00 00
 00 46 00 00 00 00 00 00 02 02 00 00 00 00 46 02 00 00 00 00 00 02 46 00 00 00 00 02 46 00 00 00
 02 00 00 00 00 00 00 02 46 00 00 00 00 02 02 00 00 00 00 02 02 00 00 00 00 02 02 00 00 00 46 02
 00 00 00 00 46 02 02 47 00 00 00 46 02 00 00 00 00 46 02 46 00 00 00 00 02 46 00 00 00 00 02 46
 00 00 00 00 02 00 00 00 00 00 02 02 46 00 00 62 02 02 00 00 00 62 02 02 00 00 00 00 02 02 00 00
 00 46 02 02 46 00 00 00 00 02 00 00 00 00 00 02 47 00 00 00 00 02 46 00 00 00 00 02 46 00 00 00
 00 02 00 00 00 00 00 02 02 46 00 00 00 02 02 00 00 00 00 02 02 00 00 00 00 02 02 00 00 00 00 00
 02 46 00 00 00 46 02 00 00 00 00 00 02 46 00 00 00 00 02 46 00 00 00 00 02 46 00 00 00 00 46 02
 00 00 00 00 02 02 00 00 00 00 02 02 00 00 00 00 02 02 00 00 00 00 02 02 00 00 00 00 00 00 05 00
 00 00 00 02 00 00 00 00 46 05 46 00 00 00 46 02 00 00 00 00 46 02 62 00 00 00 00 00 02 02 46 00
 00 04 02 46 00 00 00 02 02 00 00 00 00 02 02 00 00 00 00 02 02 00 00 00 00 00 46 02 46 00 00 00
 02 00 00 00 00 00 02 00 00 00 00 46 04 46 00 00 00 00 05 00 00 00 00 00 00 02 02 00 00 00 00 00
 46 00 00 00 02 02 00 00 00 00 02 02 00 00 00 00 46 02 46 00 00 00 00 46 02 00 00 00 00 00 00 02
 00 00 00 02 00 00 00 00 62 02 00 00 00 00 00 00 05 00 00 00 00 00 02 02 00 00 00 00 00 00 05 00
 00 46 02 16 00 00 00 46 05 46 16 00 00 00 62 05 53 00 00 00 46 02 16 46 00 00 00 62 46 05 53 00
 02 02 02 02 02 02 02 02 02 02 02 02 02 02 02 02 02 02 02 02 02 02 02 02 02 02 02 02 02 02 02 02
