Gauntlet II
Maze number: 38
Offset for maze 37: 230471 - 0x038447
big endian buf: [%!l(uint8=0) %!l(uint8=3) %!l(uint8=132) %!l(uint8=71)]
G:2 Maze real addr: 238663 - 0x03A447, bank 1, boff: 0x2000
Maze read from: 0x03a447 - 238663
compresssed: 181
 10 00 00 85 00 52 6F 0D 9D 0E 6E 10 80 2E 1A C6
 1A 76 1A C8 1A 10 DF C5 21 C5 19 81 C9 21 DF D4
 1B F4 47 A0 4A C1 21 C4 21 C2 35 F0 ED CE 21 C7
 1A C6 4E CE 24 E1 C0 20 C5 1C E1 F3 35 E7 35 F4
 E6 D4 1C C1 45 A0 C1 1E C6 1A 6D 35 CA 57 C1 64
 61 58 C0 6F E0 1D 19 C2 BF E4 C8 0F 7F 19 C9 53
 C3 35 53 D5 20 E0 46 C1 1C CB 67 A0 C5 A1 D4 35
 A0 E8 C0 5A F1 C1 1E C4 1F C0 35 A1 CE 24 C0 5C
 4B A0 33 F0 CD 21 C1 60 2E 1A 67 A0 EF 58 77 C1
 58 A0 C1 68 64 2F C7 61 A0 48 A0 49 DF DC 2E 1D
 2E C9 1D 2E C7 19 81 7E DC 2E BE 10 1A 80 C6 1A
 C8 1A 77 10 00
  Encoded length: 181 bytes
  Wall pattern: 02, Wall color: 15     Floor pattern: 05, Floor color: 06
  Flags: EXIT_CHOOSE_ONE 
  Random food adds: 5
  Secret trick: 16 - IT Could Be Nice
 02 02 02 02 02 02 02 02 02 02 02 02 02 02 02 02 02 02 02 02 02 02 02 02 02 02 02 02 02 02 02 02 02
 02 16 46 26 00 00 00 00 00 00 00 26 00 00 00 00 00 00 00 46 26 00 00 00 00 00 00 00 00 00 26 16 02
 02 00 00 00 00 00 00 00 00 00 00 00 00 00 00 00 00 00 00 00 00 00 00 00 00 00 00 00 00 00 00 00 02
 02 00 00 00 00 00 33 00 00 00 00 00 00 25 25 25 00 00 00 00 00 00 00 00 00 00 33 00 00 00 00 00 02
 02 00 00 00 00 00 00 00 00 00 00 00 00 00 00 00 00 00 00 00 00 00 00 00 00 00 00 00 00 00 00 00 02
 02 00 00 00 00 00 00 00 00 00 00 00 00 00 00 00 27 00 00 00 00 00 00 00 00 00 00 00 00 00 00 00 02
 02 00 00 00 00 00 02 13 13 13 13 13 13 13 13 02 13 13 13 13 13 13 13 13 13 13 13 00 00 33 00 00 02
 02 00 00 33 00 00 14 53 00 00 00 00 00 00 00 00 00 00 00 00 00 00 00 00 00 02 14 00 00 00 00 00 02
 02 00 00 00 00 00 14 00 02 00 00 00 00 00 00 00 00 00 00 00 00 00 00 00 33 00 14 00 00 00 00 00 02
 02 26 00 00 00 00 14 00 00 13 13 13 13 13 13 13 13 13 13 13 13 13 13 13 00 00 14 00 00 00 00 00 02
 02 00 00 00 00 00 14 36 00 14 02 00 32 00 00 00 00 00 00 28 00 00 02 14 00 00 14 00 00 00 00 00 02
 02 00 00 00 00 00 14 00 00 14 00 02 53 00 00 00 00 00 00 00 00 02 53 14 00 00 14 00 00 00 00 00 02
 02 00 00 00 00 00 14 00 00 14 00 00 02 00 00 00 00 00 00 00 02 00 00 14 00 00 14 00 00 00 00 00 02
 02 00 00 00 00 00 14 00 00 14 28 00 00 13 13 13 13 13 13 02 00 00 30 14 00 00 14 00 00 00 26 29 02
 02 00 00 00 00 00 14 00 00 14 00 00 00 14 53 00 00 00 00 14 00 00 00 14 00 00 14 00 00 29 00 00 02
 02 00 00 29 00 00 14 00 29 14 00 00 00 14 00 00 00 00 00 14 00 00 00 14 00 00 02 29 25 00 00 00 02
 02 00 00 00 00 00 02 00 00 14 00 00 00 14 00 00 15 00 00 14 00 00 00 14 00 00 14 00 00 00 00 00 02
 02 46 25 00 00 00 14 00 00 14 00 00 00 14 00 00 00 00 53 14 00 00 00 14 00 00 14 00 00 00 00 00 02
 02 00 00 00 00 00 14 00 00 14 32 00 02 13 13 13 13 13 13 13 00 00 28 14 00 00 14 00 00 00 00 00 02
 02 00 00 29 00 00 14 00 00 14 00 00 02 00 00 00 00 00 00 02 02 00 00 14 00 00 14 00 00 00 00 00 02
 02 00 00 00 00 00 14 00 00 14 53 02 00 00 00 00 00 00 00 00 00 02 00 14 00 00 14 00 00 00 00 00 02
 02 00 00 00 00 00 14 00 00 14 02 00 00 30 00 00 00 00 00 31 00 53 02 02 00 00 14 00 00 00 00 00 02
 02 00 00 00 00 00 14 36 00 14 13 13 13 13 13 13 13 13 13 13 13 13 02 51 00 00 14 00 00 00 00 00 02
 02 00 00 00 00 00 14 00 00 02 00 00 00 00 00 00 00 00 00 00 00 00 00 00 33 00 14 29 00 46 26 29 02
 02 00 00 00 00 00 14 00 02 00 00 00 00 00 00 00 00 00 00 00 00 00 00 00 00 02 14 00 00 00 00 00 02
 02 00 00 46 00 00 14 02 00 00 29 00 00 00 00 00 00 00 00 00 29 00 00 00 00 00 47 00 00 00 00 00 02
 02 00 00 29 00 00 02 13 13 13 13 13 13 13 13 13 02 13 13 13 13 13 13 13 13 13 13 00 00 00 00 00 02
 02 00 00 00 00 00 00 00 00 00 00 00 00 00 00 00 00 00 00 00 00 00 00 00 00 00 00 00 00 00 00 00 02
 02 00 00 00 00 00 00 00 00 00 00 00 00 00 00 00 00 00 00 00 00 00 00 00 46 29 46 00 00 00 00 00 02
 02 00 00 00 00 29 46 00 00 00 00 00 00 00 00 25 25 25 00 00 00 00 00 00 00 00 00 00 00 00 00 00 02
 02 46 00 00 00 00 00 00 00 00 00 00 00 00 00 00 00 00 00 00 00 00 00 00 00 00 00 00 00 00 00 46 02
 02 16 26 26 00 00 00 00 00 00 00 26 00 00 00 00 00 00 00 00 00 26 00 00 00 00 00 00 00 00 46 16 02
 02 02 02 02 02 02 02 02 02 02 02 02 02 02 02 02 02 02 02 02 02 02 02 02 02 02 02 02 02 02 02 02 02
