Gauntlet II
Maze number: 83
Offset for maze 82: 235401 - 0x039789
big endian buf: [%!l(uint8=0) %!l(uint8=3) %!l(uint8=151) %!l(uint8=137)]
G:2 Maze real addr: 251785 - 0x03D789, bank 2, boff: 0x4000
Maze read from: 0x03d789 - 251785
compresssed: 398
 07 00 00 00 20 33 7E 9C 6E 09 0E 10 C2 2F C1 35
 C4 40 29 35 C2 23 C3 18 2E 0A A1 10 C1 1D C4 35
 0F C6 AB 35 1D A0 CA 72 64 C2 21 C3 18 32 07 C3
 09 81 53 C2 0D 81 A0 C2 B3 C0 AB 35 CD 22 E0 61
 C2 2A C5 18 A0 0D 80 C0 2F 19 C9 05 C2 A3 07 82
 E0 07 80 C3 A3 C2 1F E2 C1 A1 2E C3 25 C0 07 34
 A0 C5 34 44 A3 E1 E9 21 C2 1F C5 01 80 B8 44 A0
 C0 24 62 C3 0E 2E CC A5 44 24 C3 0D 85 C0 48 35
 CA 1D A0 C0 22 C5 A1 C0 B5 C4 A1 B2 63 85 A0 C7
 0C C2 28 C2 1F C1 31 A3 C6 08 EB E1 C2 37 2E 15
 80 05 C0 1D C4 08 2E 81 B4 C4 48 35 A3 C3 1F C1
 08 C2 05 E4 C8 05 41 A0 0D 86 C0 18 C0 05 C2 BF
 C8 38 B5 42 2E CB 1C 81 C0 0D 85 A2 08 80 62 C0
 25 C2 22 C1 35 31 35 C0 18 82 C5 32 C0 22 C1 08
 35 E1 C2 72 C2 B3 A2 B2 35 3A 35 C1 1C 80 C1 A2
 C2 08 A3 0D 85 05 C1 3A 0B A3 E3 18 15 C2 25 A1
 3A C1 35 18 35 C0 1C 81 A8 C0 51 51 E0 15 18 B4
 C2 A1 34 18 C0 0D 85 A0 2E C4 31 C5 A1 C3 34 B3
 A2 18 82 68 18 C4 29 C4 B2 A0 31 C0 1F 73 0D 72
 0D 73 69 C1 20 65 A0 31 34 A0 B2 67 E2 43 A0 05
 09 80 05 A7 C8 25 01 C8 03 C1 03 C1 3B C0 18 80
 60 C2 31 01 60 E5 43 03 C0 03 80 C0 03 C0 19 51
 09 80 C0 1F C5 28 CC 03 0D 80 03 E6 CB 2A A0 43
 03 C0 03 C1 03 C5 18 D0 35 BD 31 0C 03 80 0C 35
 54 C2 31 54 18 B2 44 2E 35 01 C6 21 09 00
  Encoded length: 398 bytes
  Wall pattern: 03, Wall color: 14     Floor pattern: 03, Floor color: 07
  Flags: WRAP_H 
  Random food adds: 0
  Secret trick:  7 - Save Super Shots
 02 02 02 02 02 02 02 02 02 02 02 02 02 02 02 02 02 02 02 02 02 02 02 02 02 02 02 02 02 02 02 02
 16 00 00 09 47 00 02 53 00 00 14 00 00 28 02 41 53 00 00 00 35 00 00 00 00 24 46 10 02 02 16 02
 00 29 00 09 00 00 02 53 15 00 14 00 00 00 02 00 02 02 02 02 02 02 02 02 02 02 02 02 53 29 02 02
 00 00 00 09 00 00 02 00 00 00 14 00 00 00 02 00 46 00 00 00 33 00 00 00 00 24 50 07 00 00 00 02
 09 09 09 09 00 00 02 13 13 13 02 00 00 00 02 00 02 02 02 02 02 02 02 02 02 02 02 02 53 00 00 02
 00 00 00 00 00 00 02 00 00 00 00 34 00 02 00 00 46 00 00 00 42 00 00 00 00 00 00 24 02 13 13 02
 47 25 00 00 00 00 02 00 00 00 00 00 05 00 00 00 02 02 02 02 07 07 07 07 00 02 07 07 00 00 00 02
 02 02 02 02 00 00 02 31 00 00 00 02 00 00 02 02 46 00 00 00 00 37 00 07 52 02 00 00 00 00 00 02
 52 28 00 02 00 00 02 02 02 02 02 00 00 02 00 00 00 00 00 00 00 00 00 00 02 33 00 00 00 31 00 02
 00 00 00 02 01 01 02 28 00 00 00 00 00 02 00 36 00 00 00 46 00 00 00 00 14 46 00 00 00 00 00 02
 00 00 00 02 00 00 00 02 02 02 02 02 02 28 00 00 00 00 00 36 00 00 00 00 13 13 13 02 13 13 13 02
 28 00 00 02 00 00 00 00 00 00 53 02 00 00 00 00 00 00 00 00 00 00 29 02 00 34 00 02 00 00 00 02
 02 02 00 02 00 00 00 00 00 02 02 02 00 00 00 00 46 46 46 46 46 46 46 02 00 00 00 02 00 00 00 02
 12 00 00 00 40 00 00 00 31 00 02 49 02 02 02 02 00 00 00 00 00 00 00 08 00 00 00 02 00 00 00 02
 00 00 00 00 02 00 00 02 00 00 02 55 46 21 21 05 00 29 00 00 00 00 00 08 46 46 46 02 00 00 00 02
 00 28 00 00 00 00 00 00 00 00 02 53 02 02 02 02 00 00 00 00 31 00 00 08 00 00 00 05 00 00 00 02
 00 02 00 00 00 00 00 00 00 00 02 05 28 00 00 02 13 13 13 13 13 13 13 02 00 24 00 05 00 00 00 02
 00 00 00 00 00 00 00 00 00 56 02 28 00 00 00 46 00 00 00 14 00 00 00 02 00 00 00 02 28 28 28 02
 13 13 13 13 13 13 13 02 02 02 08 08 00 00 00 46 00 37 00 14 00 34 00 02 53 49 53 02 24 24 24 02
 00 00 00 00 00 00 50 02 34 00 00 08 53 00 00 02 00 00 00 14 00 00 00 02 02 02 02 02 53 58 53 02
 00 28 28 00 00 02 02 02 00 00 00 08 02 02 02 02 13 13 13 13 13 13 13 05 00 00 58 11 02 02 02 02
 00 09 09 00 02 24 21 02 00 00 37 02 02 58 00 14 53 24 53 14 28 28 28 02 02 02 02 02 02 02 02 02
 00 09 09 00 02 21 24 02 00 00 02 02 02 52 24 14 13 14 13 14 13 13 13 02 46 00 00 00 00 00 49 02
 00 00 00 00 00 02 02 00 00 00 02 52 02 02 02 14 24 14 24 14 00 00 00 00 00 00 00 00 00 46 24 02
 00 00 00 00 41 00 00 00 00 00 02 02 49 02 31 14 13 14 13 14 00 00 00 00 00 00 00 00 00 00 46 02
 00 32 00 00 00 00 00 00 46 02 49 52 02 02 00 00 00 00 00 00 00 00 46 00 00 00 02 28 00 00 00 02
 02 05 09 09 05 02 02 02 02 02 02 02 02 00 00 00 00 00 00 00 00 00 37 01 00 00 00 00 00 00 00 02
 00 03 00 00 03 00 09 59 09 24 24 09 46 00 00 00 49 01 00 46 00 00 00 00 00 00 02 28 00 00 00 02
 03 00 03 03 00 03 09 25 09 09 09 09 31 00 00 00 00 00 00 40 00 00 00 00 00 00 00 00 00 00 00 02
 00 03 13 13 03 00 09 00 00 00 00 09 02 02 00 00 00 00 00 00 00 00 00 00 00 42 02 28 00 00 00 02
 03 00 03 00 00 03 09 00 00 00 00 09 24 02 00 00 00 00 00 00 00 00 00 00 00 00 00 00 00 00 53 02
 49 12 03 03 12 53 09 00 00 00 49 09 24 02 28 00 00 00 00 00 46 53 01 00 00 00 00 00 00 00 33 09
 02 02 02 02 02 02 02 02 02 02 02 02 02 02 02 02 02 02 02 02 02 02 02 02 02 02 02 02 02 02 02 02
