Gauntlet II
Maze number: 13
Offset for maze 12: 232054 - 0x038a76
big endian buf: [%!l(uint8=0) %!l(uint8=3) %!l(uint8=138) %!l(uint8=118)]
G:2 Maze real addr: 232054 - 0x038A76, bank 0, boff: 0x0000
Maze read from: 0x038a76 - 232054
compresssed: 210
 08 00 42 86 00 51 0A AE 5D 0E 90 33 80 C3 1F 41
 1C C7 42 22 C2 2E A0 2F C0 7F EA C1 24 C6 18 F7
 FD 44 A9 2E A5 CC 20 C0 76 40 14 C4 2F A3 C7 18
 47 1D CB 74 22 66 A0 EA C0 1F EF 49 A0 1C A0 35
 1F C8 1F C8 42 35 E3 1C A0 C9 4F E2 1C A0 E2 6A
 C0 40 1D E9 C3 1C A0 D0 58 C0 58 60 CB 43 B8 47
 A0 E0 D2 0D 87 A0 E2 C6 2E B8 C4 BF C2 2E 14 C2
 35 C4 0F E0 0D 87 C8 0D 87 A0 C6 35 C2 14 49 47
 A1 E0 0D 87 6B C0 41 1D CB 4F 68 63 DF E7 C2 45
 42 35 C3 41 47 1C C2 A1 D7 1D A1 C2 21 D8 2E 81
 69 C7 41 1D D9 1D ED C0 B9 70 2F C0 43 40 14 C0
 42 41 10 B8 66 C0 35 A2 B2 A5 59 2E 59 A7 35 DF
 DF C4 BE 72 1D 45 1C 40 38 E1 1C A0 C5 24 C0 24
 3B 00
  Encoded length: 210 bytes
  Wall pattern: 01, Wall color: 10     Floor pattern: 05, Floor color: 00
  Flags: FAST_GRUNTS FAST_DEATHS EXIT_CHOOSE_ONE 
  Random food adds: 6
  Secret trick:  8 - Don't Use Invulnerability
 02 02 02 02 02 02 02 02 02 02 02 02 02 02 02 02 02 02 02 02 02 02 02 02 02 02 02 02 02 02 02 02 02
 02 51 00 00 00 00 31 46 00 00 28 00 00 00 00 00 00 00 00 46 00 00 00 34 00 00 00 46 02 47 00 16 02
 02 00 00 00 00 00 00 00 00 00 00 00 00 00 00 00 00 00 00 00 00 00 00 00 00 00 00 02 00 00 36 00 02
 02 00 00 00 00 00 24 00 00 00 00 00 00 00 00 00 00 00 00 00 00 00 00 00 00 00 00 00 00 00 00 02 02
 02 00 00 00 00 00 00 00 00 00 00 00 00 00 00 00 00 00 00 00 00 00 00 00 00 00 00 00 00 00 02 46 02
 02 00 00 00 00 02 02 02 02 02 02 02 02 02 14 46 14 02 02 02 02 02 00 00 00 00 00 00 00 00 00 00 02
 02 00 00 32 02 16 00 00 00 00 00 00 00 46 14 20 14 00 00 00 00 47 02 02 02 02 00 00 00 00 00 00 02
 02 00 24 46 02 00 00 00 00 00 00 00 29 00 14 00 14 00 00 00 00 00 00 00 00 16 02 00 00 00 00 34 02
 02 00 00 00 02 00 00 29 02 00 00 00 00 00 14 00 14 00 00 00 02 00 31 00 00 00 02 00 00 00 00 00 02
 02 00 00 00 02 00 00 02 46 00 00 00 00 00 14 00 14 00 00 02 28 02 53 31 00 00 02 00 00 00 00 00 02
 02 31 00 00 02 00 00 00 00 00 00 46 00 00 14 53 14 00 00 00 02 28 02 00 00 00 02 00 00 00 00 00 02
 02 46 00 00 02 00 00 00 00 00 00 00 00 00 14 00 14 00 00 00 00 02 28 02 00 00 02 02 00 00 00 00 02
 02 00 00 00 02 00 00 29 00 46 00 29 00 00 14 00 14 00 00 00 00 00 02 00 00 00 02 28 02 00 00 00 02
 02 00 00 00 02 00 00 00 00 00 00 00 00 00 14 00 14 00 29 00 00 00 00 00 00 00 02 00 00 00 00 46 02
 02 00 00 00 02 46 00 00 00 00 00 00 00 00 02 00 02 00 00 00 00 00 00 00 00 00 02 00 00 00 00 00 02
 02 00 00 00 13 13 13 13 13 13 13 13 13 02 00 00 00 02 00 00 00 00 00 00 00 46 02 00 00 00 00 00 02
 02 00 00 00 46 20 00 00 00 53 00 00 00 00 00 15 00 02 13 13 13 13 13 13 13 13 13 00 00 00 00 00 02
 02 00 00 00 13 13 13 13 13 13 13 13 13 02 00 00 00 00 00 00 00 53 00 00 00 20 46 00 00 00 00 00 02
 02 00 00 00 02 46 00 00 00 00 00 00 00 00 02 02 00 02 13 13 13 13 13 13 13 13 13 00 00 00 00 00 02
 02 00 00 00 02 00 00 29 00 46 00 00 29 00 00 14 00 14 00 00 00 00 00 00 00 46 02 00 00 00 00 00 02
 02 00 00 00 02 00 00 00 00 00 00 00 00 00 00 14 00 14 00 29 00 00 00 00 29 00 02 00 00 00 00 00 02
 02 00 00 00 02 00 00 00 00 00 00 00 00 00 00 14 00 14 00 00 00 00 00 00 00 00 02 00 00 00 00 00 02
 02 02 00 00 02 46 00 00 00 00 00 00 46 00 00 14 53 14 00 00 00 46 00 00 46 00 02 00 00 00 00 00 02
 02 28 00 00 02 02 02 00 00 00 00 00 00 00 00 14 00 14 00 00 00 00 00 00 00 00 02 00 00 00 00 29 02
 02 02 00 00 02 33 00 00 00 00 00 00 00 00 00 14 00 14 00 00 00 00 00 00 00 00 02 00 00 00 00 46 02
 02 46 00 00 02 00 00 00 00 00 00 00 29 00 00 14 00 14 00 00 00 46 00 00 29 00 02 00 00 00 00 00 02
 02 00 00 00 02 00 00 00 02 00 00 00 00 00 00 14 00 14 00 29 00 00 00 00 00 00 02 00 00 00 00 00 02
 02 00 02 00 02 16 00 47 02 46 00 00 00 00 46 14 20 14 46 00 00 00 46 00 00 16 02 00 00 00 00 00 02
 02 00 29 00 53 02 02 02 02 02 02 02 02 02 02 14 46 14 02 02 02 02 02 02 02 02 53 00 00 00 00 00 02
 02 00 00 00 00 00 00 00 00 00 00 00 00 00 00 00 00 00 00 00 00 00 00 00 00 00 00 00 00 00 00 00 02
 02 00 00 00 00 00 00 00 00 00 00 00 00 00 00 00 00 00 00 00 00 00 00 00 00 00 00 00 00 00 00 00 02
 02 16 00 00 00 29 46 00 00 00 00 00 00 28 46 00 56 00 00 02 28 02 00 00 00 00 00 00 36 00 36 59 02
 02 02 02 02 02 02 02 02 02 02 02 02 02 02 02 02 02 02 02 02 02 02 02 02 02 02 02 02 02 02 02 02 02
