Gauntlet II
Maze number: 34
Offset for maze 33: 229376 - 0x038000
big endian buf: [%!l(uint8=0) %!l(uint8=3) %!l(uint8=128) %!l(uint8=0)]
G:2 Maze real addr: 237568 - 0x03A000, bank 1, boff: 0x2000
Maze read from: 0x03a000 - 237568
compresssed: 178
 0B 00 00 82 42 71 C8 6E 50 0E 5C 2F 80 DC 35 60
 E0 20 A0 E3 1E 42 1D E3 39 74 43 DE A5 04 A4 C1
 A3 C1 A9 41 DE 10 E0 20 A0 E3 1E 42 1D E3 75 C3
 31 DE AA C2 A2 C2 A9 41 DE 10 C1 20 E4 1E 42 1D
 43 75 43 DE AB C1 A3 C1 A9 C1 31 DE 10 E0 21 A0
 E3 1E 42 1D E3 75 C3 33 DD BF AB C1 A2 C2 A8 5F
 0F 40 DE 10 E0 1F 05 E3 1E 42 1D E3 38 74 43 DE
 04 A9 C2 A3 C1 A9 41 DE 10 C1 21 A0 E3 1E 42 1D
 E3 75 C3 31 DE AB C1 A2 C2 A9 41 DE 10 E0 20 A0
 E3 1E 42 1D E3 3A 74 C3 31 DE AA C2 A3 C1 A9 41
 DE 10 E0 1F A0 E3 1E 42 1D 43 75 C2 BE 33 DB 5E
 38 00
  Encoded length: 178 bytes
  Wall pattern: 01, Wall color: 08     Floor pattern: 07, Floor color: 12
  Flags: SHOTS_HURT EXIT_FAKE EXIT_CHOOSE_ONE 
  Random food adds: 2
  Secret trick: 11 - Don't Be Fooled
 02 02 02 02 02 02 02 02 02 02 02 02 02 02 02 02 02 02 02 02 02 02 02 02 02 02 02 02 02 02 02 02 02
 02 47 00 00 00 00 00 00 00 00 00 00 00 00 00 00 00 00 00 00 00 00 00 00 00 00 00 00 00 00 14 53 02
 02 16 00 02 32 02 00 00 00 00 02 30 00 00 00 46 29 00 00 00 00 02 57 00 00 00 00 00 28 00 14 00 02
 02 46 00 00 00 00 00 00 00 00 00 00 00 00 00 00 00 00 00 00 00 00 00 00 00 00 00 00 00 00 14 00 02
 02 02 02 02 02 02 02 04 02 02 02 02 02 00 00 02 02 02 02 00 00 02 02 02 02 02 02 02 02 02 14 00 02
 02 46 00 00 00 00 00 00 00 00 00 00 00 00 00 00 00 00 00 00 00 00 00 00 00 00 00 00 00 00 14 00 02
 02 16 00 02 32 02 00 00 00 00 02 30 00 00 00 46 29 00 00 00 00 02 00 00 00 00 00 00 28 00 14 00 02
 02 49 00 00 00 00 00 00 00 00 00 00 00 00 00 00 00 00 00 00 00 00 00 00 00 00 00 00 00 00 14 00 02
 02 02 02 02 02 02 02 02 02 02 02 02 00 00 00 02 02 02 00 00 00 02 02 02 02 02 02 02 02 02 14 00 02
 02 46 00 00 00 00 00 00 00 00 00 00 00 00 00 00 00 00 00 00 00 00 00 00 00 00 00 00 00 00 14 00 02
 02 16 00 00 32 00 00 00 00 00 02 30 00 00 00 46 29 00 00 00 00 46 00 00 00 00 00 00 28 00 14 00 02
 02 46 00 00 00 00 00 00 00 00 00 00 00 00 00 00 00 00 00 00 00 00 00 00 00 00 00 00 00 00 14 00 02
 02 02 02 02 02 02 02 02 02 02 02 02 02 00 00 02 02 02 02 00 00 02 02 02 02 02 02 02 02 02 14 00 02
 02 49 00 00 00 00 00 00 00 00 00 00 00 00 00 00 00 00 00 00 00 00 00 00 00 00 00 00 00 00 14 00 02
 02 16 00 02 33 02 00 00 00 00 02 30 00 00 00 46 29 00 00 00 00 02 00 00 00 00 00 00 28 00 14 00 02
 02 51 00 00 00 00 00 00 00 00 00 00 00 00 00 00 00 00 00 00 00 00 00 00 00 00 00 00 00 00 14 00 02
 02 02 02 02 02 02 02 02 02 02 02 02 02 00 00 02 02 02 00 00 00 02 02 02 02 02 02 02 02 02 14 15 02
 02 46 00 00 00 00 00 00 00 00 00 00 00 00 00 00 00 00 00 00 00 00 00 00 00 00 00 00 00 00 14 00 02
 02 16 00 02 31 05 00 00 00 00 02 30 00 00 00 46 29 00 00 00 00 02 56 00 00 00 00 00 28 00 14 00 02
 02 46 00 00 00 00 00 00 00 00 00 00 00 00 00 00 00 00 00 00 00 00 00 00 00 00 00 00 00 00 14 00 02
 02 04 02 02 02 02 02 02 02 02 02 02 00 00 00 02 02 02 02 00 00 02 02 02 02 02 02 02 02 02 14 00 02
 02 46 00 00 00 00 00 00 00 00 00 00 00 00 00 00 00 00 00 00 00 00 00 00 00 00 00 00 00 00 14 00 02
 02 16 00 00 33 02 00 00 00 00 02 30 00 00 00 46 29 00 00 00 00 02 00 00 00 00 00 00 28 00 14 00 02
 02 49 00 00 00 00 00 00 00 00 00 00 00 00 00 00 00 00 00 00 00 00 00 00 00 00 00 00 00 00 14 00 02
 02 02 02 02 02 02 02 02 02 02 02 02 02 00 00 02 02 02 00 00 00 02 02 02 02 02 02 02 02 02 14 00 02
 02 46 00 00 00 00 00 00 00 00 00 00 00 00 00 00 00 00 00 00 00 00 00 00 00 00 00 00 00 00 14 00 02
 02 16 00 02 32 02 00 00 00 00 02 30 00 00 00 46 29 00 00 00 00 02 58 00 00 00 00 00 28 00 14 00 02
 02 49 00 00 00 00 00 00 00 00 00 00 00 00 00 00 00 00 00 00 00 00 00 00 00 00 00 00 00 00 14 00 02
 02 02 02 02 02 02 02 02 02 02 02 02 00 00 00 02 02 02 02 00 00 02 02 02 02 02 02 02 02 02 14 00 02
 02 46 00 00 00 00 00 00 00 00 00 00 00 00 00 00 00 00 00 00 00 00 00 00 00 00 00 00 00 00 14 00 02
 02 16 00 02 31 02 00 00 00 00 02 30 00 00 00 46 29 00 00 00 00 46 00 00 00 00 00 00 28 00 14 00 02
 02 51 00 00 00 00 00 00 00 00 00 00 00 00 00 00 00 00 00 00 00 00 00 00 00 00 00 00 00 00 14 56 02
