Gauntlet II
Maze number: 95
Offset for maze 94: 230822 - 0x0385a6
big endian buf: [%!l(uint8=0) %!l(uint8=3) %!l(uint8=133) %!l(uint8=166)]
G:2 Maze real addr: 255398 - 0x03E5A6, bank 3, boff: 0x6000
Maze read from: 0x03e5a6 - 255398
compresssed: 245
 10 00 00 54 00 71 53 9D 47 0E 5E 31 80 1E C0 19
 C0 10 C1 19 70 C0 10 C1 19 C1 10 C0 2E C3 38 A0
 74 80 51 7C C4 42 A0 C1 0F C1 0D 81 F5 FD D6 1E
 EC CE 04 A4 E8 31 C6 47 35 C1 2E E3 E3 19 81 C1
 19 C7 49 A0 E4 0D 81 D0 1E C1 35 A0 C5 08 F6 C5
 08 C5 41 0D 83 C1 19 C5 BA 65 CA 1B EA 65 C2 1C
 2E 76 E9 C2 1C C1 A4 09 81 CB 4F C0 37 C2 19 D3
 08 C6 BF 77 E3 B9 C6 08 C3 41 2E CC A1 C6 09 A9
 C2 44 56 C0 A1 C6 08 C7 2E 12 C5 57 35 81 A2 66
 C8 2E 12 A6 0D 80 A1 67 C2 45 2E 12 C0 35 C5 A1
 C2 1C C3 AE C2 41 A1 67 EF C2 A1 C7 08 C7 B2 CA
 A1 C7 08 2E 45 35 0E E1 2E 1E 32 C3 A1 C7 AB 09
 80 04 A3 C1 A1 D3 40 2E 70 33 2E C0 0D 80 A0 67
 C8 B2 D3 07 71 C6 0E C3 2F B2 C7 42 AD 09 80 A0
 08 81 12 81 C0 14 83 61 E6 2E E6 C5 BE 35 64 73
 E7 C0 46 2E 00
  Encoded length: 245 bytes
  Wall pattern: 01, Wall color: 03     Floor pattern: 07, Floor color: 05
  Flags: WALLS_DELETABLE1 EXIT_MOVES 
  Random food adds: 4
  Secret trick: 16 - IT Could Be Nice
 02 02 02 02 02 02 02 02 02 02 02 02 02 02 02 02 02 02 02 02 02 02 02 02 02 02 02 02 02 02 02 02 02
 02 49 30 14 25 00 16 00 00 25 00 30 00 16 00 00 25 00 00 16 02 46 00 00 00 00 56 02 00 00 00 00 02
 02 30 30 14 00 00 00 00 00 00 00 00 00 00 00 00 00 30 00 00 02 00 00 29 00 00 00 02 00 00 15 00 02
 02 13 13 13 00 00 00 00 00 00 00 00 00 00 00 00 00 00 00 00 02 00 00 00 00 00 02 00 00 00 00 00 02
 02 00 00 00 00 00 00 00 00 00 00 00 00 00 00 00 00 00 00 00 02 00 00 00 00 02 00 00 00 00 00 00 02
 02 00 00 00 00 00 00 00 00 00 00 00 00 00 00 00 00 30 00 00 02 00 00 00 00 00 00 00 00 00 00 02 02
 02 00 00 00 00 00 00 00 00 00 00 00 00 00 00 04 02 02 02 02 02 00 00 00 00 00 00 00 00 00 02 49 02
 02 00 00 00 00 00 00 29 00 00 00 00 00 00 00 02 53 00 00 46 02 00 00 00 02 00 00 00 00 02 25 25 02
 02 00 00 25 00 00 00 00 00 00 00 00 29 00 00 02 00 00 00 00 02 00 00 02 00 00 00 00 00 02 13 13 02
 02 00 00 00 00 00 00 00 00 00 00 00 00 00 00 02 00 00 30 00 02 53 02 00 00 00 00 00 00 08 00 00 02
 02 00 00 00 00 00 00 00 00 00 00 00 00 00 00 02 00 00 00 00 02 02 00 00 00 00 00 00 08 00 00 00 02
 02 00 00 29 00 00 13 13 13 13 13 00 00 25 00 02 00 00 00 00 02 00 00 00 00 00 00 07 00 00 00 00 02
 02 00 00 00 00 00 14 27 00 00 14 00 00 00 00 02 00 00 00 02 00 00 00 00 00 00 07 00 00 00 28 46 02
 02 00 00 00 00 00 14 30 00 00 14 00 00 00 00 02 00 00 02 00 00 00 28 00 00 02 02 02 02 02 09 09 02
 02 00 00 00 00 00 14 00 00 00 14 00 00 29 00 02 00 00 00 00 00 00 00 00 00 00 00 00 00 00 00 55 02
 02 00 00 25 00 00 14 00 00 00 14 00 00 00 00 02 00 00 00 00 00 00 00 00 08 00 00 00 00 00 00 00 02
 02 00 00 00 00 00 14 00 00 30 14 00 00 00 02 02 00 00 00 00 00 00 00 08 00 00 00 00 29 00 00 46 02
 02 00 00 00 00 00 14 00 00 00 14 00 00 02 02 00 00 00 00 00 00 00 09 02 02 02 02 02 02 02 02 02 02
 02 00 00 00 29 00 14 00 00 00 14 00 02 02 00 00 00 00 00 00 00 08 00 00 00 00 00 00 00 00 46 18 02
 02 00 00 00 00 00 14 53 53 53 02 02 02 00 00 00 00 00 00 00 07 00 00 00 00 00 00 00 00 00 46 18 02
 02 02 02 02 02 02 02 13 13 02 02 00 00 00 00 00 00 00 00 07 00 00 00 29 00 00 00 00 00 00 46 18 02
 02 53 00 00 00 00 00 00 02 02 00 00 00 28 00 00 00 00 02 02 02 02 02 02 02 02 02 02 02 02 02 02 02
 02 00 00 00 29 00 00 02 02 00 00 00 00 00 00 00 00 07 00 00 00 00 00 00 00 02 00 00 00 00 00 00 02
 02 00 02 00 00 00 02 02 00 00 00 00 00 00 00 00 08 00 00 00 00 00 00 00 00 02 00 00 00 00 00 00 02
 02 00 00 00 00 02 02 00 00 00 00 00 00 00 00 08 46 29 00 00 00 00 00 00 53 14 00 00 02 46 30 50 02
 02 00 00 00 02 02 00 00 00 00 00 00 00 00 02 02 02 02 02 02 02 02 02 02 02 02 09 09 04 02 02 02 02
 02 00 00 02 02 00 00 00 00 00 00 00 00 00 00 00 00 00 00 00 00 00 02 00 00 29 00 46 02 30 51 46 02
 02 13 13 02 00 00 00 00 00 00 00 00 07 00 00 00 00 00 00 00 00 00 02 00 00 00 00 00 02 00 00 00 02
 02 00 00 00 00 00 00 00 00 00 00 07 00 00 30 00 00 00 00 00 00 00 14 00 00 00 00 47 02 00 00 00 02
 02 00 00 00 00 29 00 00 00 02 02 02 02 02 02 02 02 02 02 02 02 02 02 09 09 02 08 08 08 18 18 18 02
 02 20 20 20 20 20 00 00 07 00 00 00 00 00 00 00 02 46 00 00 00 00 00 00 00 02 00 00 00 00 00 00 02
 02 53 00 00 00 00 00 07 00 00 00 00 30 00 00 00 00 00 00 00 00 02 00 29 00 00 00 00 00 00 00 46 02
 02 02 02 02 02 02 02 02 02 02 02 02 02 02 02 02 02 02 02 02 02 02 02 02 02 02 02 02 02 02 02 02 02
