Gauntlet II
Maze number: 40
Offset for maze 39: 230957 - 0x03862d
big endian buf: [%!l(uint8=0) %!l(uint8=3) %!l(uint8=134) %!l(uint8=45)]
G:2 Maze real addr: 239149 - 0x03A62D, bank 1, boff: 0x2000
Maze read from: 0x03a62d - 239149
compresssed: 217
 0B 00 04 84 42 64 F0 0D 5D 0E 6E 1A 80 1D 7C 1A
 CC 2F 61 51 66 73 C4 1F C5 3C C0 10 C2 AF AD D6
 2E 1A A3 21 10 A6 C0 4F 41 B2 C5 10 62 C2 35 1D
 67 74 D0 4D C9 A5 C2 21 C4 20 C3 20 C2 A2 66 C7
 35 CB 20 C4 35 1A CB 35 CE 35 A6 C3 21 C3 35 CB
 A3 2E 62 C6 47 C1 20 C6 20 68 C2 33 D4 A5 C9 35
 74 A3 66 CD 53 C5 20 C3 BF CE 0F C2 05 C9 35 A6
 CC 0E C7 A3 1D 1A C4 5C C1 21 C7 05 C1 1F 66 C2
 43 A0 05 C2 57 4A 5B 6D C1 5D 2E C1 21 72 C3 21
 C0 35 5E A2 C5 42 C2 05 4F 77 82 71 C2 21 D0 1D
 C1 54 2F 51 C2 B3 AF A1 45 C0 42 DD 1D 62 D1 1D
 C2 1A 2E 45 54 A2 C2 A7 04 AA 21 62 C1 21 D5 2E
 C9 33 D0 22 CA 20 B3 AF A3 DF C1 BE 10 C5 1F C3
 1A C5 1A C5 1A 60 C0 10 00
  Encoded length: 217 bytes
  Wall pattern: 04, Wall color: 00     Floor pattern: 06, Floor color: 15
  Flags: SHOTS_HURT EXIT_FAKE EXIT_CHOOSE_ONE FAST_DEMONS 
  Random food adds: 4
  Secret trick: 11 - Don't Be Fooled
 02 02 02 02 02 02 02 02 02 02 02 02 02 02 02 02 02 02 02 02 02 02 02 02 02 02 02 02 02 02 02 02
 02 26 29 14 00 00 00 00 00 00 00 00 00 00 00 00 46 26 00 00 00 00 00 00 00 00 00 00 00 00 00 47
 02 00 29 14 00 00 00 00 00 00 00 29 00 00 00 00 46 00 00 00 00 00 31 00 00 00 00 00 00 60 00 16
 02 00 00 02 02 02 02 02 02 02 02 02 02 02 02 02 02 02 02 02 02 02 02 02 02 02 02 02 02 02 02 02
 02 00 00 00 00 00 00 00 00 00 00 00 00 00 00 00 00 00 00 00 00 00 00 00 46 26 02 02 02 02 33 16
 02 02 02 02 02 02 02 00 13 13 13 13 13 13 13 13 13 13 13 13 13 13 13 13 13 13 02 00 00 00 00 00
 02 16 00 00 00 29 00 00 14 53 29 00 00 00 00 00 00 00 00 29 00 00 00 00 00 46 14 00 00 00 00 00
 02 00 00 00 00 00 00 00 14 00 14 13 13 13 13 13 13 13 13 13 13 13 13 13 13 00 14 00 00 00 00 00
 02 00 00 02 02 02 02 02 14 00 14 00 33 00 00 00 00 00 32 00 00 00 00 32 14 00 14 02 02 02 00 00
 02 00 00 00 00 29 00 00 14 00 14 00 00 00 53 00 00 00 00 00 00 00 00 00 14 00 14 32 00 00 00 00
 02 53 26 00 00 00 00 00 14 00 14 00 00 00 00 53 00 00 00 00 00 00 00 00 14 00 14 00 00 00 00 53
 02 02 02 02 02 02 02 00 14 00 14 33 00 00 00 00 53 00 00 00 00 00 00 00 14 00 14 00 00 02 02 02
 02 46 00 00 00 29 00 00 14 00 14 00 14 13 13 13 13 13 13 13 14 00 00 32 14 00 14 00 00 00 00 32
 02 00 00 00 00 00 00 00 14 29 14 00 14 51 00 00 00 00 00 00 14 00 00 00 14 00 14 00 00 00 00 00
 02 00 00 02 02 02 02 02 14 00 14 00 14 00 00 00 00 00 00 53 14 00 00 00 14 46 14 02 02 02 00 00
 02 00 00 00 00 29 00 00 14 00 14 00 14 00 00 00 00 00 00 00 14 00 00 00 14 00 14 32 00 00 00 00
 02 00 00 00 00 00 00 00 14 00 14 00 14 00 00 00 15 00 00 00 05 00 00 00 14 00 14 00 00 00 00 53
 02 02 02 02 02 02 02 00 14 00 14 00 14 00 00 00 00 00 00 00 14 00 00 00 14 00 14 00 00 02 02 02
 02 29 26 00 00 00 00 00 14 00 14 33 14 00 00 00 00 00 00 00 05 00 00 31 14 00 14 00 00 00 00 29
 02 00 14 13 13 13 13 02 05 00 14 00 14 13 13 13 13 13 13 13 13 13 13 13 14 00 14 00 00 00 00 00
 02 00 14 00 00 00 00 29 02 00 14 46 00 00 33 00 00 00 46 00 00 00 00 33 00 53 14 02 02 02 00 00
 02 00 14 00 13 13 13 00 02 00 05 13 13 13 13 13 13 13 13 13 13 13 13 13 13 13 13 00 00 00 00 00
 02 00 14 46 14 46 14 00 02 46 00 00 00 33 00 00 00 00 00 00 00 00 00 00 00 00 00 00 00 00 00 29
 02 00 14 47 14 00 14 00 02 02 02 02 02 02 02 02 02 02 02 02 02 02 02 02 02 02 02 13 13 13 13 13
 02 00 13 13 13 00 14 00 00 00 00 00 00 00 00 00 00 00 00 00 00 00 00 00 00 00 00 00 00 00 00 00
 02 00 00 29 00 00 14 29 00 00 00 00 00 00 00 00 00 00 00 00 00 00 00 00 00 00 29 00 00 00 26 46
 02 13 13 13 13 13 14 02 02 02 00 00 00 02 02 02 02 02 02 02 02 04 02 02 02 02 02 02 02 02 02 02
 02 33 00 00 00 29 00 00 33 02 00 00 00 00 00 00 00 00 00 00 00 00 00 00 00 00 00 00 00 00 00 46
 02 00 00 00 00 00 00 00 00 02 51 00 00 00 00 00 00 00 00 00 00 00 00 00 00 00 00 00 34 00 00 00
 02 00 00 00 00 00 00 00 32 02 02 02 02 02 02 02 02 02 02 02 02 02 02 02 02 02 02 02 02 02 00 00
 02 00 00 00 00 00 00 00 00 00 00 00 00 00 00 00 00 00 00 00 00 00 00 00 00 00 00 00 00 00 00 00
 02 16 00 00 00 00 00 00 31 00 00 00 00 26 00 00 00 00 00 00 26 00 00 00 00 00 00 26 00 29 00 16
 02 02 02 02 02 02 02 02 02 02 02 02 02 02 02 02 02 02 02 02 02 02 02 02 02 02 02 02 02 02 02 02
