Gauntlet II
Maze number: 41
Offset for maze 40: 231174 - 0x038706
big endian buf: [%!l(uint8=0) %!l(uint8=3) %!l(uint8=135) %!l(uint8=6)]
G:2 Maze real addr: 239366 - 0x03A706, bank 1, boff: 0x2000
Maze read from: 0x03a706 - 239366
compresssed: 295
 0A 00 00 80 20 02 F3 0D 05 0E 9F 10 E5 C8 2F 10
 C1 23 C6 0E 22 E7 C3 AA C4 41 C5 52 C6 26 C9 29
 C1 42 C2 1D C0 1D C7 B2 A8 C0 29 C2 60 EB CA 61
 C3 60 C1 03 80 C8 A2 C4 31 21 C1 61 C2 60 C2 03
 80 CA 2E C8 64 76 44 C7 A4 62 2E 80 60 79 2E C8
 22 C7 2E 60 79 A0 B6 C5 60 C1 10 C7 A4 41 A0 C4
 2E C4 B4 61 22 CF 35 C0 34 C4 18 C1 35 61 B4 A2
 ED BB A1 41 A0 B3 A4 C2 31 C4 18 C1 40 E1 31 A0
 C0 1D CF B2 A4 31 C3 A2 C7 28 22 C5 20 C0 26 C1
 26 C0 A1 B5 CD 1F 32 A0 C2 40 A1 B2 C7 72 40 E9
 C3 1C A0 E1 61 A0 C7 1E E1 EF 61 A0 C0 1D A0 E7
 C1 35 C7 B6 E0 C1 0E 35 80 0E E0 CB A3 CA 28 81
 CD 31 35 80 C0 12 81 C1 A3 C7 71 35 C8 1C C0 12
 81 C1 31 C0 34 C6 70 A0 C6 35 25 C4 12 81 C3 76
 A0 C7 43 C3 42 C7 42 C4 BB C3 23 C0 23 CB 72 35
 C9 1E C4 01 81 B6 DE 27 C3 56 C1 7A 52 C6 BF EA
 B7 CB 5C C0 5C C6 2F C7 35 15 C3 35 2E 83 E0 E0
 C3 01 80 B6 A2 B9 A6 BA C1 BA A4 B2 46 B2 C7 22
 C5 0F C9 12 82 35 00
  Encoded length: 295 bytes
  Wall pattern: 02, Wall color: 03     Floor pattern: 00, Floor color: 15
  Flags: WRAP_H EXIT_CHOOSE_ONE 
  Random food adds: 0
  Secret trick: 10 - Try Pushing a Wall
 02 02 02 02 02 02 02 02 02 02 02 02 02 02 02 02 02 02 02 02 02 02 02 02 02 02 02 02 02 02 02 02
 16 00 00 00 14 00 00 02 00 00 00 00 00 00 00 00 00 47 16 00 00 35 00 00 00 00 00 00 00 14 34 02
 00 00 00 00 14 00 00 02 00 00 00 02 02 02 02 02 02 02 02 02 02 02 02 00 00 00 00 00 13 13 00 02
 00 00 00 00 14 00 00 00 00 00 00 02 38 00 00 00 00 00 00 00 00 00 00 41 00 00 13 13 13 00 00 02
 29 00 29 00 02 00 00 00 00 00 00 02 02 02 02 02 02 02 02 02 02 00 41 00 00 00 05 00 00 00 00 02
 00 00 00 00 02 00 00 02 00 00 00 00 00 00 00 00 00 00 00 05 05 00 00 00 00 05 00 00 03 03 00 02
 00 00 00 00 02 00 00 02 02 02 00 00 00 00 00 49 33 00 00 05 05 00 00 00 05 00 00 00 03 03 00 02
 00 00 00 00 02 00 00 00 00 46 02 00 00 00 00 00 00 00 00 05 05 05 05 05 31 00 00 00 00 00 00 02
 13 13 13 13 02 00 00 00 00 00 02 00 02 02 02 02 02 02 05 05 05 46 46 05 31 00 00 00 00 00 00 02
 00 00 00 46 02 00 00 00 00 00 02 00 02 34 00 00 00 00 00 00 00 00 46 05 31 00 00 00 00 00 00 02
 00 00 00 02 02 02 00 00 00 00 02 05 02 00 16 00 00 00 00 00 00 00 02 02 02 02 02 02 13 13 02 02
 00 00 00 00 46 02 00 00 00 00 02 05 02 34 00 00 00 00 00 00 00 00 02 00 00 00 00 00 00 00 53 02
 52 00 00 00 00 02 24 00 00 53 05 05 02 02 02 02 00 00 00 00 00 00 02 00 00 00 00 00 00 00 02 02
 02 02 13 13 02 02 02 02 02 02 02 00 00 00 49 02 00 00 00 00 24 00 02 13 02 00 02 49 02 00 29 00
 02 00 00 00 00 00 00 00 00 00 02 00 00 00 02 02 02 02 02 02 02 49 02 00 02 00 02 02 02 00 00 00
 02 00 00 00 00 40 34 00 00 00 02 00 00 32 02 38 00 00 38 00 02 02 02 00 02 00 00 00 00 00 00 00
 02 00 00 00 00 31 50 02 00 00 02 13 02 02 02 00 00 00 00 00 00 00 00 31 02 00 14 13 14 00 00 00
 02 00 00 00 00 00 02 00 00 00 02 28 02 00 00 02 05 05 02 00 00 00 00 00 02 00 14 30 14 00 02 00
 02 00 00 00 00 00 00 00 00 00 02 00 00 00 00 02 05 05 02 00 29 02 00 00 02 00 14 00 14 00 02 00
 02 53 00 00 00 00 00 00 00 00 02 00 02 00 00 14 53 53 14 00 02 00 00 00 02 00 14 00 14 00 00 00
 02 02 02 02 02 00 00 00 00 00 00 00 00 00 00 02 40 40 02 00 00 00 00 00 02 00 14 00 14 00 00 00
 02 49 53 53 02 18 18 02 00 14 02 02 02 02 00 02 00 00 02 00 00 00 31 00 02 53 14 00 14 00 00 00
 02 00 00 28 02 18 18 02 00 14 49 00 52 02 00 02 00 00 02 00 31 00 02 00 02 00 14 00 14 00 53 37
 02 00 00 00 02 18 18 02 00 14 00 00 31 02 00 02 00 00 02 00 02 00 00 00 02 00 14 00 14 13 13 13
 02 00 00 02 02 13 13 02 00 14 00 00 00 02 00 02 13 13 02 00 00 00 00 00 02 00 14 00 14 35 00 35
 02 00 00 02 02 00 00 02 00 14 00 00 31 02 00 02 53 00 02 00 00 00 00 00 14 00 14 30 14 00 00 00
 02 01 01 02 02 00 00 02 00 14 00 00 00 02 00 02 00 00 02 00 00 00 00 00 14 00 14 00 14 00 00 00
 02 00 00 02 39 00 00 02 00 14 00 00 31 02 00 02 00 00 02 00 00 00 00 00 14 00 14 00 14 00 00 00
 02 00 00 02 00 00 00 02 00 00 00 00 02 02 00 02 00 00 02 00 00 00 00 00 02 00 14 00 14 00 00 00
 02 00 00 02 47 00 00 02 00 00 00 00 00 53 21 02 00 00 02 53 46 46 46 46 02 00 02 00 02 00 00 00
 02 01 01 02 02 02 02 02 02 02 02 02 02 02 02 02 00 00 02 02 02 02 02 02 02 13 13 13 13 13 13 13
 02 00 00 00 00 00 00 00 00 34 00 00 00 00 00 00 15 00 00 00 00 00 00 00 00 00 00 18 18 18 18 53
 02 02 02 02 02 02 02 02 02 02 02 02 02 02 02 02 02 02 02 02 02 02 02 02 02 02 02 02 02 02 02 02
