Gauntlet II
Maze number: 39
Offset for maze 38: 230652 - 0x0384fc
big endian buf: [%!l(uint8=0) %!l(uint8=3) %!l(uint8=132) %!l(uint8=252)]
G:2 Maze real addr: 238844 - 0x03A4FC, bank 1, boff: 0x2000
Maze read from: 0x03a4fc - 238844
compresssed: 305
 0A 00 00 00 00 61 16 06 45 0E 98 2F 80 C0 27 C1
 2F E2 C1 09 1E 81 09 C8 0C 09 1A 10 32 E9 C1 09
 83 C9 0C 09 18 10 C7 15 19 0E C5 09 CA 0C 09 1A
 E9 C5 09 C5 03 21 C3 0C 09 60 83 63 31 C0 B2 C2
 09 6E 83 C1 19 15 0E D5 05 83 C0 B6 EC C8 09 C0
 15 83 C0 0E C4 A1 B3 A4 1F A0 2E C5 09 31 60 83
 C4 1D A0 C1 26 E1 C2 AA 05 80 3B 05 E5 E6 E2 C0
 04 60 60 C0 2E 60 83 E8 E7 E0 E0 1D A0 C1 29 05
 80 29 E8 E0 C4 A1 1D 05 60 E0 C8 B4 64 62 E3 1F
 A0 E0 E0 1E A0 C7 3E C2 2E A0 E4 2E 62 60 E0 E0
 C6 BA E4 C2 0F E2 E3 E0 21 A0 1D A0 33 BF C1 71
 05 C3 33 A0 E4 C0 B5 C1 A9 E5 64 62 C5 32 C0 2C
 C0 2C C1 35 E7 23 E3 35 A0 F7 E4 C3 52 C4 08 81
 CA 01 0A BD C7 22 A0 7F C2 01 80 A0 C1 3E E3 C8
 07 C0 2C C7 18 01 80 C0 A6 C1 3E C0 2E C4 07 C2
 01 87 C7 A3 B8 A0 44 C3 0B 86 C6 2C C1 31 A0 3E
 C3 2E 45 32 0B EF C6 45 08 88 E6 3B C6 45 12 87
 08 E5 C8 45 12 87 03 CF 43 70 12 87 03 CF 43 79
 03 CF 43 18 BE 35 81 2E C4 03 C5 53 12 87 43 18
 00
  Encoded length: 305 bytes
  Wall pattern: 01, Wall color: 06     Floor pattern: 06, Floor color: 01
  Flags: 
  Random food adds: 0
  Secret trick: 10 - Try Pushing a Wall
 02 02 02 02 02 02 02 02 02 02 02 02 02 02 02 02 02 02 02 02 02 02 02 02 02 02 02 02 02 02 02 02
 02 47 00 39 00 00 47 02 00 00 02 00 00 09 30 30 30 09 00 00 00 00 00 00 00 00 00 12 09 26 16 50
 02 00 00 00 00 00 00 02 00 00 02 00 00 09 09 09 09 09 00 00 00 00 00 00 00 00 00 00 12 09 24 16
 02 00 00 00 00 00 00 02 21 25 14 00 00 02 00 00 00 09 00 00 00 00 00 00 00 00 00 00 00 12 09 26
 02 00 00 00 00 00 00 02 00 00 02 00 00 02 00 00 00 09 00 00 00 00 00 00 03 33 00 00 00 00 12 09
 02 05 05 05 05 02 00 02 00 00 05 49 00 02 00 02 00 09 00 00 00 00 00 00 00 00 00 00 00 00 00 00
 02 05 05 05 05 02 00 02 25 21 14 00 00 00 00 02 00 00 00 00 00 00 00 00 00 00 00 00 00 00 00 00
 02 05 05 05 05 02 00 02 00 00 02 00 00 00 00 02 00 00 00 00 00 02 00 00 00 00 00 00 00 00 00 09
 02 21 21 21 21 02 00 14 00 00 02 00 00 02 02 02 02 02 02 02 02 31 02 46 00 00 00 00 00 00 09 49
 02 05 05 05 05 02 00 02 00 00 02 29 02 00 00 38 00 00 02 00 00 00 02 02 02 02 02 02 02 02 02 02
 02 05 05 59 05 02 00 02 00 00 02 02 00 00 00 00 00 00 00 02 00 00 00 02 00 04 00 05 00 05 00 46
 02 05 05 05 05 02 00 02 00 00 02 00 00 00 00 02 00 00 00 00 02 00 00 00 02 00 02 00 02 29 02 00
 02 41 05 05 41 02 00 02 00 00 02 00 00 00 02 00 02 00 00 00 02 00 02 02 29 05 00 05 00 02 00 00
 02 00 00 00 00 02 00 02 00 00 02 00 00 05 00 00 00 05 00 00 02 00 02 31 02 00 02 00 02 30 02 00
 02 00 00 00 00 02 00 62 00 00 02 46 02 00 00 00 00 00 02 46 02 00 00 05 00 05 00 02 00 02 00 00
 02 00 00 00 00 02 00 00 00 00 02 02 00 00 00 15 00 00 00 02 02 00 02 00 02 00 02 33 02 29 02 51
 02 00 00 24 00 00 05 00 00 00 02 51 02 00 00 00 00 00 02 00 02 00 02 02 02 02 02 02 02 02 02 02
 02 00 00 00 00 00 00 02 00 00 02 00 00 05 00 00 00 05 00 00 14 00 02 00 50 00 44 00 44 00 00 53
 02 00 00 00 00 00 00 00 02 35 02 00 00 00 02 53 02 00 00 00 14 00 02 00 00 00 00 00 00 00 00 00
 02 00 00 00 00 00 00 00 00 02 02 00 00 00 00 02 00 00 00 00 14 00 02 00 00 00 08 08 08 00 00 00
 02 00 00 00 00 00 00 00 01 10 02 00 00 00 00 00 00 00 00 34 02 24 02 00 00 00 00 00 00 00 00 00
 02 00 00 00 00 00 00 00 00 01 01 02 00 00 62 00 00 00 00 02 00 00 02 00 00 00 00 00 00 07 00 44
 02 00 00 00 00 00 00 00 24 01 01 00 02 02 02 02 02 02 02 00 00 62 02 46 00 00 00 00 00 07 00 00
 02 01 01 01 01 01 01 01 01 01 00 00 00 00 00 00 00 00 02 02 02 02 02 02 06 06 06 06 06 00 00 00
 02 11 11 11 11 11 11 11 11 00 00 00 00 00 00 00 44 00 00 49 02 62 00 00 00 00 46 06 06 06 06 06
 02 50 11 00 00 00 00 00 00 00 00 00 00 00 00 00 00 00 00 02 00 00 00 00 00 00 00 06 06 06 06 06
 02 08 08 08 08 08 08 08 08 08 08 00 00 00 00 00 00 00 02 59 00 00 00 00 00 00 00 06 06 06 06 06
 02 18 18 18 18 18 18 18 18 18 08 00 00 00 00 00 00 02 00 00 00 00 00 00 00 00 00 06 06 06 06 06
 02 18 18 18 18 18 18 18 18 18 03 00 00 00 00 00 00 14 00 00 00 00 00 00 00 00 00 06 06 06 06 24
 02 18 18 18 18 18 18 18 18 18 03 00 00 00 00 00 00 14 00 00 00 00 00 00 00 00 00 06 06 06 06 24
 02 00 00 00 00 00 00 00 00 00 03 00 00 00 00 00 00 14 00 00 00 00 00 00 00 00 00 06 06 06 06 24
 02 53 53 53 46 00 00 00 00 00 03 00 00 00 00 00 00 14 18 18 18 18 18 18 18 18 18 06 06 06 06 24
 02 02 02 02 02 02 02 02 02 02 02 02 02 02 02 02 02 02 02 02 02 02 02 02 02 02 02 02 02 02 02 02
