Gauntlet II
Maze number: 97
Offset for maze 96: 231302 - 0x038786
big endian buf: [%!l(uint8=0) %!l(uint8=3) %!l(uint8=135) %!l(uint8=134)]
G:2 Maze real addr: 255878 - 0x03E786, bank 3, boff: 0x6000
Maze read from: 0x03e786 - 255878
compresssed: 285
 0D 80 00 04 05 21 CE 07 09 0E 08 18 80 C5 1A 35
 40 18 1A C4 2F C0 2E 23 0C 60 19 10 19 C2 23 0B
 C7 37 35 40 C4 3C C0 2F C3 60 18 19 18 C7 A4 41
 0A C2 A5 C2 60 42 72 CB 0B 1C C3 A5 C3 0A 1D 32
 C5 1D CA B2 C3 1C D7 33 C5 19 B5 C6 B2 C2 A1 62
 C5 42 E4 44 08 80 C0 0A 62 0B F0 C3 0B B4 C0 0C
 C0 1A 21 C7 1A 19 75 19 1A C4 35 A0 C2 1F A1 C2
 B2 C7 0C 05 84 C3 A1 E3 E3 F8 43 A0 DD 08 C8 42
 C5 63 C5 1F DF C0 72 CE 74 C9 A5 44 C3 BF D8 0A
 B3 1A D0 20 19 CB 63 A1 C2 18 37 18 D4 0C 1F C1
 0C 62 01 81 42 AD C0 1F C5 2E 19 C8 0A C4 35 C0
 0A C0 38 35 CE 0F C4 BA C3 0D 82 D6 40 C2 52 18
 52 36 52 D6 40 C2 61 42 D6 40 C2 62 41 CC 19 C8
 01 18 C2 0C C0 35 C6 B7 C5 A6 19 C1 01 37 C2 0D
 82 C3 1C C2 1C C3 1F E1 C5 01 18 C1 52 31 52 18
 52 DA 42 08 80 C2 1A D7 0B C0 18 C2 BA 47 01 C2
 01 C6 72 C3 0D 82 C9 BE 34 01 C0 01 32 01 C3 1D
 C0 0B A0 C1 52 35 52 36 52 C7 1A 0A 00
  Encoded length: 285 bytes
  Wall pattern: 01, Wall color: 14     Floor pattern: 02, Floor color: 12
  Flags: TRAPS_LOCAL INVIS_TRAPWALLS SHOTS_STUN 
  Random food adds: 4
  Secret trick: 13 - Don't Be Greedy (no treasure)
 02 02 02 02 02 02 02 02 02 02 02 02 02 02 02 02 02 02 02 02 02 02 02 02 02 02 02 02 02 02 02 02 02
 02 24 00 00 00 00 00 00 26 53 07 24 26 00 00 00 00 00 47 02 46 35 12 09 25 16 25 08 00 00 35 11 02
 02 00 00 00 00 00 00 00 55 53 07 00 00 00 00 00 60 00 47 02 00 00 00 09 24 25 24 08 00 00 00 00 02
 02 00 00 02 02 02 02 02 07 07 10 00 00 02 02 02 02 02 02 02 00 00 00 09 07 07 07 08 00 00 00 00 02
 02 00 00 00 00 00 00 08 11 28 00 00 00 02 02 02 02 02 02 02 00 00 00 02 10 29 50 02 00 00 00 00 02
 02 29 00 00 00 00 00 08 00 00 00 00 00 02 00 00 00 00 28 02 00 00 00 02 00 00 00 02 00 00 00 00 02
 02 00 00 00 00 00 00 08 00 00 00 51 00 00 00 00 00 00 25 02 00 00 00 02 00 00 00 02 00 00 00 02 02
 02 09 09 09 00 00 00 08 00 00 07 07 07 00 00 00 00 00 02 07 07 07 07 02 08 08 02 10 09 09 09 11 02
 02 00 00 00 00 00 00 08 00 00 00 00 00 00 00 00 00 02 00 00 00 00 11 02 00 12 02 26 33 00 00 00 02
 02 00 00 00 00 26 25 08 25 26 00 00 00 00 00 53 02 00 00 00 31 02 02 00 00 00 02 00 00 00 00 00 02
 02 00 00 12 05 05 05 05 05 05 00 00 00 00 02 02 00 00 00 00 02 00 00 00 00 02 00 00 00 00 00 00 02
 02 00 00 00 00 00 08 00 00 00 00 00 00 02 00 00 00 00 00 02 07 07 07 07 02 00 00 00 00 00 00 00 02
 02 00 00 00 00 00 08 00 00 00 00 00 00 02 00 00 00 00 00 00 00 00 08 08 00 00 00 00 00 00 00 00 02
 02 07 07 07 00 00 08 00 00 00 09 09 09 02 00 00 00 00 00 00 31 00 08 00 00 00 00 02 00 00 00 00 02
 02 00 00 00 00 00 08 00 00 00 00 00 00 02 00 00 00 00 00 00 00 00 08 00 00 00 00 02 00 00 00 00 02
 02 00 00 00 00 00 08 00 00 00 00 00 00 02 00 00 00 02 02 02 02 02 02 07 07 07 07 02 00 00 00 00 02
 02 00 00 00 00 00 00 00 00 00 00 00 00 02 00 00 00 00 00 00 00 00 00 00 00 00 10 02 26 00 00 00 02
 02 00 00 00 00 00 00 00 00 00 00 00 00 02 32 25 00 00 00 00 00 00 00 00 00 00 00 00 09 09 09 09 02
 02 02 00 00 00 24 55 24 00 00 00 00 00 02 00 00 00 00 00 00 00 00 00 00 00 00 00 00 02 12 31 00 02
 02 12 09 09 09 01 01 01 07 07 07 02 02 02 02 02 02 02 02 02 02 02 02 02 02 00 31 00 02 00 00 00 02
 02 46 25 00 00 00 00 00 00 00 00 00 10 02 00 00 00 14 53 14 10 14 56 53 02 00 00 00 02 00 00 00 02
 02 00 00 00 00 00 00 15 00 00 00 00 00 02 00 00 00 14 13 14 13 14 00 00 02 00 00 00 02 00 00 00 02
 02 00 00 00 00 00 00 00 00 00 00 00 00 07 00 00 00 14 24 14 54 14 00 00 02 00 00 00 02 00 00 00 02
 02 00 00 00 00 00 00 00 00 00 00 00 00 07 00 00 00 09 09 07 07 07 00 00 02 00 00 00 02 00 00 00 02
 02 00 00 00 00 00 00 00 00 00 00 00 00 07 00 00 00 09 09 09 07 07 00 00 02 00 00 00 02 00 00 00 02
 02 00 00 25 00 00 00 00 00 00 00 00 00 01 24 00 00 14 12 14 53 14 00 00 02 00 00 00 02 00 00 00 02
 02 00 00 02 02 02 02 02 02 02 25 00 00 01 55 00 00 14 13 14 13 14 00 00 02 00 28 00 00 00 28 00 02
 02 00 00 31 00 00 02 00 00 00 00 00 00 01 24 00 00 14 49 14 24 14 00 00 02 00 00 00 00 00 00 00 02
 02 00 00 00 00 00 00 00 00 00 00 00 00 08 00 00 00 07 07 07 08 08 00 00 02 26 00 00 00 00 00 00 02
 02 00 00 00 00 00 00 00 00 00 00 00 00 08 00 00 00 14 11 14 24 14 00 00 02 07 07 07 07 07 07 07 02
 02 01 00 00 00 01 00 00 00 00 00 00 00 08 00 00 00 14 13 14 13 14 00 00 00 00 00 00 00 00 00 00 02
 02 52 01 00 01 50 01 00 00 00 00 29 00 11 02 00 00 14 53 14 54 14 00 00 00 00 00 00 00 00 26 10 02
 02 02 02 02 02 02 02 02 02 02 02 02 02 02 02 02 02 02 02 02 02 02 02 02 02 02 02 02 02 02 02 02 02
