Gauntlet II
Maze number: 72
Offset for maze 71: 231730 - 0x038932
big endian buf: [%!l(uint8=0) %!l(uint8=3) %!l(uint8=137) %!l(uint8=50)]
G:2 Maze real addr: 248114 - 0x03C932, bank 2, boff: 0x4000
Maze read from: 0x03c932 - 248114
compresssed: 275
 06 00 00 80 40 02 34 83 41 85 5A 10 80 35 19 C5
 2E A0 33 03 31 A0 79 70 1D C0 10 C0 19 81 E5 C0
 40 40 A0 C1 25 F4 C0 40 40 40 A0 E2 C8 1D C4 23
 61 2E 40 40 40 40 A2 79 66 CF 1E C9 23 61 D1 1E
 74 64 DD 01 C2 19 D5 0B 62 D4 21 C0 24 C1 0B 32
 C0 2E 04 2E A0 EC CB 08 A1 E0 E0 C7 A3 15 04 C8
 2A 08 18 C0 33 40 4B 05 A0 2E C9 08 E1 C0 40 A0
 C8 20 51 A1 C8 08 C1 31 40 49 51 1F 04 31 A0 2E
 A0 C4 0B 08 E1 E0 E0 C6 20 52 52 A0 15 A0 C2 0B
 2F A0 C0 BF E0 C9 51 1F 54 A0 C4 A1 C2 25 C7 B3
 52 51 19 E3 E2 C6 B2 E4 15 A0 C0 1F 58 A0 31 A0
 E6 C6 04 2E A0 04 C1 19 65 13 A0 E6 E9 3A 67 13
 07 F3 C7 13 07 C3 4F 2E A0 E6 78 C3 1E E6 15 A0
 62 13 A0 F7 2E A0 60 13 07 CA 1D C3 21 C1 2D E7
 13 07 C7 2E D3 31 A0 C5 0A 75 C5 24 E8 D8 2D E3
 CA 19 B9 C4 1E C9 2E A0 C3 42 2E C1 19 07 72 C7
 0C C0 09 82 A0 C1 A9 C2 BE 10 71 C3 0C 2F 09 18
 D1 0F 00
  Encoded length: 275 bytes
  Wall pattern: 02, Wall color: 04     Floor pattern: 00, Floor color: 03
  Flags: EXIT_CHOOSE_ONE EXIT_FAKE 
  Random food adds: 0
  Secret trick:  6 - Watch What You Shoot (shoot secret walls)
 02 02 02 02 02 02 02 02 02 02 02 02 02 02 02 02 02 02 02 02 02 02 02 02 02 02 02 02 02 02 02 02 02
 02 16 53 25 00 00 00 00 00 00 46 02 51 03 49 02 00 00 00 00 00 00 00 00 00 00 26 00 26 29 00 16 02
 02 25 25 25 00 00 00 00 00 00 02 00 03 00 03 00 02 00 00 37 00 00 00 00 00 00 00 00 00 00 00 00 02
 02 00 00 00 00 00 00 00 00 02 00 03 00 03 00 03 00 02 00 00 00 02 00 00 00 00 00 00 00 00 00 29 02
 02 00 00 00 00 35 00 00 01 46 03 00 03 00 03 00 03 00 02 02 02 00 00 00 00 00 00 00 00 00 00 26 02
 02 00 00 00 00 00 00 01 00 00 00 00 00 00 00 00 00 00 00 00 00 00 00 00 30 00 00 00 00 00 00 00 02
 02 00 00 35 00 00 01 00 00 00 00 00 00 00 00 00 00 00 00 00 00 00 00 00 00 30 00 00 00 00 00 26 02
 02 00 00 00 00 01 00 00 00 00 00 00 00 00 00 00 00 00 00 00 00 00 00 00 00 00 00 00 00 00 00 00 02
 02 00 00 00 01 00 00 00 25 00 00 00 00 00 00 00 00 00 00 00 00 00 00 00 00 00 00 00 00 00 00 11 02
 02 00 00 01 00 00 00 00 00 00 00 00 00 00 00 00 00 00 00 00 00 00 00 00 00 33 00 36 00 00 11 50 02
 02 46 04 46 02 00 00 00 00 00 00 00 00 00 00 00 00 00 02 00 00 00 00 00 00 00 00 00 00 00 00 08 02
 02 02 00 02 00 02 00 00 00 00 00 00 00 00 02 02 02 02 21 04 00 00 00 00 00 00 00 00 00 42 08 24 02
 02 51 03 00 03 00 00 00 00 00 00 00 00 00 00 00 00 05 02 46 00 00 00 00 00 00 00 00 00 00 08 00 02
 02 02 00 03 00 02 00 00 00 00 00 00 00 00 00 32 05 00 00 02 02 00 00 00 00 00 00 00 00 00 08 00 02
 02 49 03 00 03 00 00 00 00 00 00 02 00 00 00 05 00 00 31 04 49 02 46 02 00 00 00 00 00 11 08 00 02
 02 02 00 02 00 02 00 00 00 00 00 02 00 32 05 00 00 00 05 00 00 00 02 21 02 00 00 00 11 47 02 00 02
 02 00 02 00 02 00 00 00 00 00 00 02 00 05 00 00 31 05 00 00 00 00 00 02 00 00 00 00 00 02 02 00 02
 02 00 37 00 02 00 00 00 00 00 00 02 05 00 00 00 05 00 00 25 00 00 00 00 02 00 00 00 02 00 00 00 02
 02 00 00 00 02 00 00 00 00 00 02 21 02 00 31 05 00 00 00 00 00 00 00 00 00 02 49 02 00 00 00 00 02
 02 00 00 02 00 00 00 00 00 00 00 04 46 02 04 00 00 25 00 00 00 00 00 00 01 19 02 00 00 00 02 00 02
 02 00 02 00 00 00 00 00 00 00 00 00 00 02 58 00 00 00 00 00 00 00 00 01 19 07 00 00 00 00 02 00 02
 02 00 00 00 00 00 00 00 00 00 00 00 00 00 02 00 00 00 00 00 00 00 00 19 07 00 00 00 00 03 02 00 02
 02 00 00 00 00 00 00 00 00 00 00 00 00 00 46 02 00 00 00 00 00 00 00 02 00 00 00 00 00 00 02 00 02
 02 26 00 00 00 00 30 00 00 00 00 00 00 00 02 21 02 00 00 00 01 19 02 00 00 00 00 00 00 00 02 00 02
 02 00 00 00 00 00 00 00 00 00 00 00 00 00 00 02 46 02 00 01 19 07 00 00 00 00 00 00 00 00 02 00 02
 02 29 00 00 00 00 33 00 00 45 00 00 00 00 00 00 00 00 02 19 07 00 00 00 00 00 00 00 00 46 02 00 02
 02 00 00 00 00 00 00 00 00 00 00 00 00 00 00 00 00 00 49 02 00 00 00 00 00 00 10 00 00 00 02 00 02
 02 26 00 00 00 00 00 00 36 00 00 00 00 00 00 00 00 00 02 00 00 00 00 00 00 00 00 00 00 00 02 00 02
 02 00 00 00 00 00 00 00 00 00 00 00 45 00 00 00 00 02 00 00 00 00 00 00 00 00 00 00 00 25 02 00 02
 02 00 00 00 30 00 00 00 00 00 00 00 00 00 00 46 02 00 00 00 00 03 00 00 00 46 00 00 25 07 00 00 02
 02 26 00 00 00 00 00 00 00 00 12 00 09 09 09 09 02 00 00 02 02 02 02 02 02 02 02 02 02 00 00 00 02
 02 16 00 00 26 00 00 00 00 12 47 09 24 00 00 00 00 00 00 00 00 00 00 00 00 00 00 00 00 00 00 15 02
 02 02 02 02 02 02 02 02 02 02 02 02 02 02 02 02 02 02 02 02 02 02 02 02 02 02 02 02 02 02 02 02 02
