Gauntlet II
Maze number: 44
Offset for maze 43: 232080 - 0x038a90
big endian buf: [%!l(uint8=0) %!l(uint8=3) %!l(uint8=138) %!l(uint8=144)]
G:2 Maze real addr: 240272 - 0x03AA90, bank 1, boff: 0x2000
Maze read from: 0x03aa90 - 240272
compresssed: 381
 04 20 00 00 20 2E BE 07 75 84 90 15 31 A0 C4 05
 A0 0C A0 05 1A 80 C1 2F A0 33 15 38 51 35 0E 1A
 81 A0 35 E0 C5 1F A0 04 A0 31 E5 E0 2F C2 0E E3
 04 A0 18 C5 1F 05 1F C6 2E A0 C4 0E E4 E4 E6 E3
 E1 28 C1 0E E1 1D E0 C1 3E C1 A1 E4 E3 E2 28 C1
 0E C4 0E A0 C1 A1 22 E0 35 E1 E3 C7 0E C4 0E C0
 A3 E2 E0 18 E2 C3 A9 0D C4 B5 3E C1 22 81 05 E1
 E3 E8 05 80 E1 C8 05 F0 C0 05 C1 1D C7 23 C1 1C
 80 C5 A3 1B E3 05 C2 B2 C8 A1 C8 1F A0 E4 05 35
 A0 C3 B4 0D 82 62 E9 C1 A4 64 C3 0D AA C0 20 1F
 A1 31 C6 09 C5 38 C1 34 C0 31 25 10 80 60 E4 C6
 09 CB 73 73 B2 1F C0 19 80 C2 09 C8 0F C5 74 A0
 E0 63 09 C1 22 6A 71 2F 77 A2 3E C1 23 CA 72 70
 B5 E5 E2 C1 24 E2 19 60 C3 2F C0 72 09 A0 E3 E3
 C2 B7 19 C2 BB A3 BB A4 09 40 04 A3 C4 2C A0 E2
 C2 1C A0 31 0A C0 08 80 41 05 80 A0 09 41 57 A0
 35 E2 C4 50 08 80 41 A0 04 42 B2 09 B2 A1 0D 81
 C2 A1 C7 0B C0 08 80 41 A0 0C 09 39 43 57 0E C6
 B2 3E B4 08 80 41 09 80 40 51 09 81 B3 C1 B2 C3
 0E C1 1D B2 C2 1E A0 C1 08 41 A5 51 1E C1 05 A7
 E3 C3 A5 B2 A1 B2 B2 E2 32 3E 15 56 A0 C2 1C A0
 31 C3 33 61 C3 A4 05 19 C8 1D A0 C6 1C B4 E3 15
 31 60 E0 E9 E2 1C A0 E1 E0 E1 C2 B2 1A 81 E3 C7
 2F 04 A0 E7 CA 19 31 B3 E5 3E A0 C7 00
  Encoded length: 381 bytes
  Wall pattern: 14, Wall color: 14     Floor pattern: 02, Floor color: 11
  Flags: ODDANGLE_GRUNTS WRAP_H 
  Random food adds: 0
  Secret trick:  4 - Try Transportability (onto secret wall)
 02 02 02 02 02 02 02 02 02 02 02 02 02 02 02 02 02 02 02 02 02 02 02 02 02 02 02 02 02 02 02 02
 21 49 02 00 00 00 00 00 05 02 12 02 05 26 26 00 00 47 02 51 21 56 04 00 00 53 14 26 26 26 02 53
 00 02 00 00 00 00 00 00 31 02 04 02 49 00 00 00 00 00 00 02 00 02 47 00 00 00 14 00 00 00 00 02
 04 02 24 00 00 02 00 00 00 31 05 31 00 00 00 00 00 00 00 46 02 00 00 00 00 00 14 00 00 00 00 00
 02 00 00 00 00 02 02 00 00 00 00 00 00 00 02 00 00 00 00 02 00 00 02 40 00 00 14 00 00 02 29 00
 02 00 00 62 00 02 02 02 00 00 00 00 00 02 00 00 00 00 02 00 00 00 02 40 00 00 14 00 00 00 00 00
 14 02 00 00 02 02 34 00 02 53 00 00 02 00 00 00 00 02 00 00 00 00 00 00 00 00 14 00 00 00 00 00
 14 00 02 02 02 02 00 00 00 02 00 02 24 00 00 00 02 00 00 00 00 02 02 02 02 02 02 02 02 02 02 13
 00 00 00 00 00 02 62 00 00 34 02 34 05 00 00 02 00 00 00 00 02 00 00 00 00 00 00 00 00 00 02 05
 05 00 00 02 00 00 02 00 00 00 02 00 00 05 02 00 00 00 00 02 00 00 00 00 00 00 00 00 00 00 00 02
 00 05 00 00 29 00 02 00 00 00 02 00 00 35 02 00 28 28 00 02 00 00 00 00 02 02 02 02 27 00 00 00
 00 02 05 00 00 00 02 00 00 00 02 00 00 00 02 00 02 02 00 02 00 00 00 00 00 00 00 31 02 00 00 00
 00 00 02 05 53 02 00 00 00 00 02 13 13 13 02 00 00 00 53 02 00 00 00 00 00 00 00 00 00 02 00 00
 02 02 02 02 02 00 00 00 00 02 53 00 00 00 02 13 02 02 02 02 02 02 02 02 02 02 02 00 32 31 02 02
 49 00 00 00 00 00 00 00 09 02 00 00 00 00 02 56 00 00 52 02 49 37 16 16 00 53 02 00 00 00 02 02
 00 00 00 00 00 00 00 09 00 02 00 00 00 00 02 00 00 00 00 02 16 00 00 00 00 16 02 00 00 00 02 31
 00 25 25 00 00 00 09 00 00 02 00 00 00 00 02 00 15 00 00 02 00 00 00 16 00 00 02 00 00 02 00 02
 00 00 00 00 53 09 00 00 34 02 00 00 00 00 02 00 00 00 00 02 53 16 00 00 47 16 02 00 00 00 00 00
 00 00 02 02 02 62 00 00 35 02 00 00 00 00 02 00 00 00 00 02 16 00 00 00 16 00 02 00 00 00 00 00
 00 02 00 00 00 02 00 00 36 02 00 00 02 25 02 53 00 00 00 02 47 00 16 00 00 00 09 02 00 00 00 00
 02 00 00 00 00 02 00 00 00 02 25 00 00 00 02 02 02 02 02 02 02 02 02 02 02 09 07 04 02 02 02 02
 00 00 00 00 00 44 02 00 00 00 02 00 00 00 28 02 49 10 02 08 08 07 07 05 05 02 09 07 02 04 02 00
 02 00 00 00 00 00 02 53 00 00 00 02 00 00 00 00 02 04 02 08 08 07 07 02 04 07 07 07 02 09 02 02
 02 13 13 02 00 00 00 02 02 00 00 00 02 00 00 00 02 11 02 08 08 07 07 02 12 09 57 07 07 07 07 04
 02 00 00 02 00 00 00 00 14 00 00 00 02 00 00 00 02 62 02 08 08 07 07 09 09 07 04 02 02 09 02 02
 02 00 00 02 00 00 00 00 14 00 00 29 02 00 00 00 30 02 00 00 08 07 07 02 02 02 02 02 02 04 02 02
 30 00 00 05 02 02 02 02 02 02 02 02 00 00 00 00 02 00 00 00 00 02 02 02 02 02 02 02 02 02 02 02
 00 00 00 02 50 62 21 04 00 00 00 00 00 00 00 02 00 00 00 28 02 49 00 00 00 00 51 00 02 53 00 00
 00 00 02 02 02 02 02 05 25 00 00 00 00 00 02 00 00 00 29 02 00 00 00 00 00 00 00 28 02 00 00 00
 00 02 21 49 02 53 00 02 00 00 00 00 00 00 02 00 00 00 02 00 00 00 02 28 02 00 00 02 00 02 00 00
 02 00 00 00 02 26 26 26 00 00 00 00 02 00 02 00 00 00 00 00 00 47 04 02 00 00 00 00 00 00 00 00
 02 00 00 00 00 00 00 00 00 00 00 00 25 49 02 00 00 00 00 00 00 02 62 02 00 00 00 00 00 00 00 00
 02 02 02 02 02 02 02 02 02 02 02 02 02 02 02 02 02 02 02 02 02 02 02 02 02 02 02 02 02 02 02 02
