Gauntlet II
Maze number: 56
Offset for maze 55: 235507 - 0x0397f3
big endian buf: [%!l(uint8=0) %!l(uint8=3) %!l(uint8=151) %!l(uint8=243)]
G:2 Maze real addr: 243699 - 0x03B7F3, bank 1, boff: 0x2000
Maze read from: 0x03b7f3 - 243699
compresssed: 153
 0F 00 06 01 00 72 38 0D 6E 5D 89 2E 80 68 C6 32
 52 C6 35 DF C1 20 C1 20 56 D9 1D C1 35 D4 12 84
 44 B4 A1 5B D3 1D DF DF CF 31 DC 1D DF 5F C6 0A
 C1 0C 6B D5 2E C6 BB AB C6 A3 08 68 CD 0B C1 18
 07 C0 73 14 80 D5 07 80 08 A0 07 BF C1 14 80 CA
 0F CA 70 73 14 80 D1 1D C1 B4 08 42 08 60 66 69
 63 70 0E 18 0E C1 AF A1 B6 07 80 A5 42 7F DF DC
 1D DF DF D2 2E 80 D5 1D C6 A5 C1 AF A1 12 84 D3
 2E C1 1E 10 C0 1E 12 83 DF 1C CB 1C DF 62 80 CB
 BE 2E D6 34 BC 32 C2 10 00
  Encoded length: 153 bytes
  Wall pattern: 02, Wall color: 08     Floor pattern: 07, Floor color: 03
  Flags: FAST_GRUNTS FAST_DEMONS 
  Random food adds: 1
  Secret trick: 15 - Be Pushy
 02 02 02 02 02 02 02 02 02 02 02 02 02 02 02 02 02 02 02 02 02 02 02 02 02 02 02 02 02 02 02 02 02
 02 46 00 00 00 00 00 00 00 00 00 46 02 00 00 00 00 00 00 50 00 00 00 29 00 00 00 00 00 00 00 53 02
 02 00 00 00 00 00 00 02 00 00 00 00 02 00 00 00 00 00 00 00 00 00 00 00 00 00 00 00 00 00 00 00 02
 02 00 32 00 00 32 00 02 00 00 00 00 02 29 00 00 00 00 00 00 00 00 00 00 00 00 00 00 00 00 00 00 02
 02 00 00 00 00 00 00 02 29 00 00 53 02 00 00 00 00 00 00 00 00 00 00 00 00 00 00 00 00 00 00 00 02
 02 18 18 18 18 18 18 02 13 13 13 13 02 02 02 00 00 00 00 00 00 00 00 00 00 00 00 29 00 00 00 00 02
 02 00 00 00 00 00 00 02 00 00 00 00 00 00 00 00 29 00 00 00 00 00 00 00 00 00 00 00 00 00 00 00 02
 02 00 00 00 00 00 00 02 00 00 00 00 00 00 00 00 00 00 00 00 00 00 00 00 00 00 00 00 00 00 00 00 02
 02 00 00 00 00 00 00 02 00 00 00 00 00 00 00 00 00 00 00 00 00 00 00 00 00 00 00 00 00 00 00 00 02
 02 49 00 00 00 00 00 02 00 00 00 00 00 00 00 00 00 00 00 00 00 00 00 00 00 00 00 00 00 00 00 29 02
 02 00 00 00 00 00 00 02 00 00 00 00 00 00 00 00 00 00 00 00 00 00 00 00 00 00 00 00 00 00 00 00 02
 02 00 00 00 00 00 00 02 00 00 00 00 00 00 00 00 29 00 00 00 00 00 00 00 10 00 00 12 00 00 00 00 02
 02 00 00 00 00 00 00 02 46 00 00 00 00 00 00 00 00 00 00 00 00 00 00 00 00 00 00 00 00 00 00 46 02
 02 00 00 00 00 00 00 02 02 02 02 02 02 02 02 02 02 02 02 02 00 00 00 00 00 00 02 02 02 02 02 08 02
 02 00 00 00 00 00 00 00 00 46 00 00 00 00 00 00 00 00 00 02 00 00 00 00 11 00 02 24 07 00 09 00 02
 02 00 00 20 20 00 00 00 00 00 00 00 00 00 00 00 00 00 00 02 00 00 00 00 00 00 02 07 07 08 02 07 02
 02 00 00 20 20 00 00 00 00 00 00 00 00 00 00 00 15 00 00 02 00 00 00 00 00 00 02 00 09 00 09 00 02
 02 00 00 20 20 00 00 00 00 00 00 00 00 00 00 00 00 00 00 02 00 00 00 29 00 00 02 08 13 13 13 08 02
 02 46 00 00 00 00 00 00 00 46 00 00 00 00 00 00 00 00 00 02 46 00 00 00 00 46 09 00 14 24 14 00 02
 02 02 02 02 02 02 02 02 02 02 02 02 02 02 02 02 02 02 02 02 07 07 02 02 02 02 02 02 13 13 13 09 02
 02 00 00 00 00 00 00 00 00 00 00 00 00 00 00 00 00 00 00 00 00 00 00 00 00 00 02 00 00 00 00 00 02
 02 00 00 00 00 00 00 00 00 00 00 00 00 00 00 00 00 00 00 00 00 00 00 00 00 00 02 00 00 00 00 00 02
 02 00 00 00 00 00 00 00 00 00 00 00 00 29 00 00 00 00 00 00 00 00 00 00 00 00 02 00 00 00 00 00 02
 02 00 00 00 00 00 00 00 00 00 00 00 00 00 00 00 00 00 00 00 00 00 00 00 00 00 02 00 00 00 00 00 02
 02 00 00 00 00 00 00 00 00 00 00 00 00 00 00 00 00 00 00 00 00 00 00 00 00 00 02 00 00 00 00 00 02
 02 46 46 00 00 00 00 00 00 00 00 00 00 00 00 00 00 00 00 00 00 00 00 00 00 29 02 00 00 00 00 00 02
 02 02 02 02 02 02 02 00 00 02 02 02 02 02 02 02 02 02 02 02 02 02 02 02 02 02 02 18 18 18 18 18 02
 02 00 00 00 00 00 00 00 00 00 00 00 00 00 00 00 00 00 00 00 00 46 00 00 30 16 02 30 18 18 18 18 02
 02 00 00 00 00 00 00 00 00 00 00 00 00 00 00 00 00 00 00 00 00 00 00 00 00 00 02 00 00 00 00 00 02
 02 28 00 00 00 00 00 00 00 00 00 00 00 00 28 00 00 00 00 00 00 00 00 00 00 00 02 00 00 00 00 00 02
 02 00 00 00 00 00 00 00 00 00 00 00 00 00 00 00 00 00 46 46 00 00 00 00 00 00 02 00 00 00 00 00 02
 02 46 00 00 00 00 00 00 00 00 00 00 00 00 00 00 00 00 00 00 00 00 00 00 00 52 02 50 00 00 00 16 02
 02 02 02 02 02 02 02 02 02 02 02 02 02 02 02 02 02 02 02 02 02 02 02 02 02 02 02 02 02 02 02 02 02
