Gauntlet II
Maze number: 68
Offset for maze 67: 230619 - 0x0384db
big endian buf: [%!l(uint8=0) %!l(uint8=3) %!l(uint8=132) %!l(uint8=219)]
G:2 Maze real addr: 247003 - 0x03C4DB, bank 2, boff: 0x4000
Maze read from: 0x03c4db - 247003
compresssed: 222
 09 00 20 00 00 18 F0 75 6E 1C 0E 35 80 CD 0F 64
 07 C0 2C C1 2C C1 2C C5 31 C0 1D C9 10 61 07 D5
 B2 C2 B2 A4 61 62 C3 1D 06 CC 08 42 07 CA 1D 06
 80 A0 04 A1 C7 08 C2 33 07 C0 28 C0 28 C0 28 C0
 28 C2 1D 06 C8 3F C2 3F A4 D4 20 A0 C3 32 19 80
 D3 A3 D6 06 C1 23 DA 06 80 C9 2F 2E D0 06 81 C3
 A8 0A 2E CC 06 81 E3 E6 B5 A4 07 83 09 82 C0 06
 80 E3 33 C0 19 D2 18 C1 06 E3 E0 CA 29 EF CB 72
 43 C0 29 31 C3 BF 0B D0 A9 E3 E1 C2 25 D7 13 83
 42 CA 26 CA 13 82 C0 04 A2 B4 C7 72 43 C0 26 C5
 13 83 CC A9 E3 E1 FB E1 B6 CE 23 C7 18 61 3C 60
 C4 31 C7 72 43 C0 23 31 64 82 CD A9 C8 23 DF CD
 20 D9 5F C1 72 43 C0 20 D7 A9 CC 31 DF C9 1D C9
 BE 19 CD 53 C1 72 43 C0 1D 31 C1 18 0C 00
  Encoded length: 222 bytes
  Wall pattern: 08, Wall color: 00     Floor pattern: 01, Floor color: 15
  Flags: FAST_AUX_GRUNTS 
  Random food adds: 0
  Secret trick:  9 - Don't Get Hit (while killing a dragon)
 02 02 02 02 02 02 02 02 02 02 02 02 02 02 02 02 02 02 02 02 02 02 02 02 02 02 02 02 02 02 02 02 02
 02 53 00 00 00 00 00 00 00 00 00 00 00 00 02 00 15 00 02 00 00 00 46 07 00 44 00 00 44 00 00 44 02
 02 00 00 00 00 00 49 00 29 00 00 00 00 00 02 00 00 00 02 16 00 00 46 07 00 00 00 00 00 00 00 00 02
 02 00 00 00 00 00 00 00 00 00 00 00 00 00 02 00 00 00 02 02 02 02 02 02 00 00 46 00 00 00 46 00 02
 02 00 00 29 06 00 00 00 00 00 00 00 00 00 00 00 00 00 08 00 00 00 53 07 00 00 00 00 00 00 00 00 02
 02 00 00 29 06 06 02 04 02 02 00 00 00 00 00 00 00 00 08 00 00 00 51 07 00 40 00 40 00 40 00 40 02
 02 00 00 29 06 00 00 00 00 00 00 00 00 00 63 00 00 00 63 02 02 02 02 02 00 00 00 00 00 00 00 00 02
 02 00 00 00 00 00 00 00 00 00 00 00 00 32 02 00 00 00 02 50 25 25 00 00 00 00 00 00 00 00 00 00 02
 02 00 00 00 00 00 00 00 00 00 02 02 02 02 00 00 00 00 02 00 00 00 00 00 00 00 00 00 00 00 00 00 02
 02 00 00 00 00 06 00 00 35 00 00 00 00 00 00 00 00 00 02 00 00 00 00 00 00 00 00 00 00 00 00 00 02
 02 00 00 00 06 06 00 00 00 00 00 00 00 00 00 00 47 46 02 00 00 00 00 00 00 00 00 00 00 00 00 00 02
 02 00 00 06 06 06 00 00 00 00 02 02 02 02 02 02 02 02 02 10 46 00 00 00 00 00 00 00 00 00 00 00 02
 02 00 06 06 06 00 00 00 00 02 00 00 00 00 00 00 28 02 02 02 02 02 02 02 07 07 07 07 07 09 09 09 02
 02 00 06 06 00 00 00 00 02 51 00 25 00 00 00 00 28 00 00 14 00 00 00 00 00 00 00 00 00 00 00 24 02
 02 00 06 00 00 00 00 02 00 02 00 00 00 00 00 00 28 00 00 14 00 41 00 00 00 00 00 00 00 00 00 00 02
 02 00 00 00 00 00 02 00 00 00 02 00 00 00 00 00 28 00 00 14 00 00 00 00 53 00 41 49 00 00 00 00 02
 02 11 00 00 00 02 00 00 00 00 02 00 00 00 00 00 28 00 00 02 02 02 02 02 02 02 02 02 02 00 00 00 02
 02 02 00 00 02 02 00 00 37 00 02 00 00 00 00 00 28 00 00 14 00 00 00 00 00 00 00 00 00 00 00 00 02
 02 19 19 19 19 02 00 00 00 53 02 00 00 00 00 00 28 00 00 14 00 38 00 00 00 00 00 00 00 00 00 00 02
 02 19 19 19 19 02 04 02 02 02 02 00 00 00 00 00 28 00 00 14 00 00 00 00 53 00 38 00 00 00 00 00 02
 02 19 19 19 19 02 00 00 00 00 00 00 00 00 00 00 28 00 00 02 02 02 02 02 02 02 02 02 02 00 00 00 02
 02 02 00 00 02 02 00 00 00 00 00 00 00 00 00 00 28 00 00 14 00 00 00 00 00 00 00 00 00 00 00 00 02
 02 02 00 00 02 02 00 00 00 00 00 00 00 00 00 00 28 00 00 14 00 35 00 00 00 00 00 00 00 00 24 00 02
 02 46 60 00 46 00 00 00 00 00 49 00 00 00 00 00 28 00 00 14 00 00 00 00 53 00 35 49 00 00 00 00 02
 02 46 46 46 46 00 00 00 00 00 00 00 00 00 00 00 28 00 00 02 02 02 02 02 02 02 02 02 02 00 00 00 02
 02 00 00 00 00 00 35 00 00 00 00 00 00 00 00 00 28 00 00 14 00 00 00 00 00 00 00 00 00 00 00 00 02
 02 00 00 00 00 00 00 00 00 00 00 00 00 00 00 00 28 00 00 14 00 32 00 00 00 00 00 00 00 00 00 00 02
 02 00 00 00 00 00 00 00 00 00 00 00 00 00 00 00 28 00 00 14 00 00 00 00 53 00 32 00 00 00 00 00 02
 02 00 00 00 00 00 00 00 00 00 00 00 00 00 00 00 28 00 00 02 02 02 02 02 02 02 02 02 02 00 00 00 02
 02 00 00 00 00 00 00 00 00 00 49 00 00 00 00 00 28 00 00 14 00 00 00 00 00 00 00 00 00 00 00 00 02
 02 00 00 00 00 00 00 00 00 00 00 00 00 00 00 00 28 00 00 14 00 29 00 00 00 00 00 00 00 00 00 00 02
 02 25 00 00 00 00 00 00 00 00 00 00 00 00 00 00 28 00 00 14 00 00 00 00 53 00 29 49 00 00 24 12 02
 02 02 02 02 02 02 02 02 02 02 02 02 02 02 02 02 02 02 02 02 02 02 02 02 02 02 02 02 02 02 02 02 02
