Gauntlet II
Maze number: 99
Offset for maze 98: 231924 - 0x0389f4
big endian buf: [%!l(uint8=0) %!l(uint8=3) %!l(uint8=137) %!l(uint8=244)]
G:2 Maze real addr: 256500 - 0x03E9F4, bank 3, boff: 0x6000
Maze read from: 0x03e9f4 - 256500
compresssed: 290
 0E 00 00 00 20 04 7C 06 9C 0E AE 0D CB 6F C1 27
 E1 C7 6F A0 32 C0 0D 52 E1 C0 68 0D C0 66 60 A0
 21 A0 52 32 A0 E2 C0 67 10 E9 C2 A1 E4 C0 65 52
 0D 52 64 60 A0 EB F0 ED E6 C1 61 60 A0 EF C2 15
 2E A0 35 A0 70 15 E1 C8 A2 E5 C1 2E A0 E2 71 A0
 C6 A1 C1 40 18 A0 E5 E0 E4 E0 E6 41 C1 42 A0 C4
 2E A0 74 2E A0 2E 15 E4 42 C1 42 32 C2 15 2E A0
 C1 0D C2 0D E1 74 32 42 C1 44 C1 2E A0 C2 27 C2
 27 E2 70 15 C1 43 C1 42 04 B2 C0 2E A0 C2 52 0D
 52 C0 52 0D 52 E2 71 B2 18 46 18 A0 C0 15 A0 35
 C5 0F C5 35 A0 E2 45 33 A0 C2 2E A0 C3 0D C2 0D
 E3 2E 15 E2 33 43 A0 C4 2E A0 71 27 C2 27 C0 70
 A0 75 A0 18 A2 C5 15 2E A1 52 0D 52 C0 52 0D 52
 A1 2E 15 E6 E9 35 C8 35 A0 D1 1F E0 C1 0D 84 E0
 C0 1F F1 C2 72 72 A0 F1 E0 C8 04 E0 EF C6 27 E6
 ED E2 E8 E2 EB C6 72 76 A0 E9 C6 56 0D 83 56 E6
 E3 E2 E5 E8 E5 C2 31 A0 E0 C9 16 82 EA E0 0D CB
 16 84 CA A1 27 CA 16 86 CB 0D 52 12 86 CD 12 85
 52 00
  Encoded length: 290 bytes
  Wall pattern: 04, Wall color: 12     Floor pattern: 00, Floor color: 07
  Flags: WRAP_H 
  Random food adds: 0
  Secret trick: 14 - Go On a Diet (no food)
 02 02 02 02 02 02 02 02 02 02 02 02 02 02 02 02 02 02 02 02 02 02 02 02 02 02 02 02 02 02 02 02
 13 14 00 00 00 00 00 00 00 00 00 00 00 28 00 00 00 00 00 00 00 00 00 00 00 00 00 00 00 00 00 14
 39 14 00 02 00 00 00 00 00 00 00 00 28 00 00 00 00 00 00 00 00 00 00 00 00 00 00 00 00 02 50 14
 13 14 00 00 02 00 28 00 00 00 00 00 00 00 00 14 13 14 28 00 00 00 00 00 00 00 28 00 02 33 02 14
 50 02 00 00 00 02 00 28 00 00 00 00 00 00 00 14 16 14 00 00 00 00 00 00 00 00 00 02 00 00 00 02
 02 00 00 00 00 00 02 00 28 00 00 00 00 00 00 14 13 14 28 00 00 00 00 00 28 00 02 00 00 00 00 00
 00 00 00 00 00 00 00 02 00 00 00 00 00 00 00 00 00 00 00 00 00 00 00 00 00 02 00 00 00 00 00 00
 00 00 00 00 00 00 00 00 02 00 00 00 00 00 00 00 02 00 00 28 00 00 28 00 02 00 00 00 00 00 00 00
 00 00 00 00 00 00 00 00 00 02 00 00 00 21 46 02 53 02 46 00 21 00 00 02 00 00 00 00 00 00 00 00
 00 02 02 02 00 00 00 00 00 00 02 00 00 46 02 00 00 00 02 46 00 00 02 00 00 00 00 00 00 00 02 02
 00 00 06 24 02 00 00 00 00 00 00 02 00 02 00 00 00 00 00 02 00 02 00 00 00 00 00 00 00 02 06 06
 00 00 06 06 06 02 00 00 00 00 00 46 02 46 00 00 00 00 00 46 02 46 21 00 00 00 00 00 02 06 06 06
 00 00 06 06 06 50 02 00 00 21 46 02 00 14 13 14 00 14 13 14 00 02 46 00 00 00 00 02 50 06 06 06
 00 00 06 06 06 06 02 00 00 46 02 00 00 14 39 14 00 14 39 14 00 00 02 46 00 21 00 02 06 06 06 06
 00 00 06 06 06 04 02 00 46 02 00 00 00 14 13 14 00 14 13 14 00 00 00 02 46 00 00 02 24 06 06 06
 06 06 06 06 24 02 00 21 02 53 00 00 00 00 00 00 15 00 00 00 00 00 00 53 02 00 00 00 02 06 06 06
 06 06 06 51 02 00 00 00 46 02 00 00 00 14 13 14 00 14 13 14 00 00 00 02 46 21 00 00 00 02 51 06
 06 06 06 02 00 00 00 00 00 46 02 46 00 14 39 14 00 14 39 14 46 00 02 46 00 00 00 00 00 00 02 24
 02 02 02 00 00 00 00 00 00 21 46 02 02 14 13 14 00 14 13 14 02 02 46 21 00 00 00 00 00 00 00 02
 00 00 00 00 00 00 00 00 00 00 02 53 00 00 00 00 00 00 00 00 00 53 02 00 00 00 00 00 00 00 00 00
 00 00 00 00 00 00 00 00 00 31 00 02 00 14 13 13 13 13 13 14 00 02 00 31 00 00 00 00 00 00 00 00
 00 00 00 00 00 00 00 00 00 00 02 00 00 14 46 00 00 00 46 14 00 00 02 00 00 00 00 00 00 00 00 00
 00 00 00 00 00 00 00 00 00 02 00 02 00 14 00 00 00 00 00 14 00 04 00 02 00 00 00 00 00 00 00 00
 00 00 00 00 00 00 00 00 02 00 00 00 00 14 00 00 39 00 00 14 00 00 00 00 02 00 00 00 00 00 00 00
 00 00 00 00 00 00 00 02 00 00 00 02 00 14 00 00 00 00 00 14 00 02 00 00 00 02 00 00 00 00 00 00
 00 00 00 00 00 00 02 00 00 00 00 00 00 14 46 00 00 00 46 14 00 00 00 00 00 00 02 00 00 00 00 00
 00 00 00 00 00 02 00 00 00 00 00 00 00 14 13 13 13 13 13 14 00 00 00 00 00 00 00 02 00 00 00 00
 02 00 00 00 02 00 00 00 00 00 00 02 00 00 00 00 00 00 00 00 00 02 00 00 00 00 00 00 02 00 00 00
 49 02 00 02 00 00 00 00 00 00 00 00 00 00 22 22 22 22 00 00 00 00 00 00 00 00 00 00 00 02 00 02
 13 14 00 00 00 00 00 00 00 00 00 00 00 22 22 22 22 22 22 00 00 00 00 00 00 00 00 00 00 00 02 14
 39 14 00 00 00 00 00 00 00 00 00 00 22 22 22 22 22 22 22 22 00 00 00 00 00 00 00 00 00 00 00 14
 13 14 18 18 18 18 18 18 18 18 00 00 00 00 00 00 00 00 00 00 00 00 00 00 18 18 18 18 18 18 18 14
 02 02 02 02 02 02 02 02 02 02 02 02 02 02 02 02 02 02 02 02 02 02 02 02 02 02 02 02 02 02 02 02
