Gauntlet II
Maze number: 2
Offset for maze 1: 229986 - 0x038262
big endian buf: [%!l(uint8=0) %!l(uint8=3) %!l(uint8=130) %!l(uint8=98)]
G:2 Maze real addr: 229986 - 0x038262, bank 0, boff: 0x0000
Maze read from: 0x038262 - 229986
compresssed: 146
 00 00 00 00 00 24 D1 41 FF 55 AE 0F 80 D5 01 41
 C0 32 DC 13 80 DD 13 80 DA 01 C7 63 61 60 AE C1
 1F C3 35 DF DF DF DF DF 20 C1 3F 61 60 AF A5 4D
 45 42 C3 7D 01 43 DB 01 44 40 D2 01 44 41 44 C3
 BF 63 61 60 AF A1 C3 1D 5B 51 52 53 48 42 DF D8
 01 42 DF DC 01 42 D4 74 A5 3F 80 A1 3F 80 A1 3F
 80 A7 0D 83 DF CF 22 C2 22 CA 7F CE A8 3F 80 A1
 3F 80 A1 3F 80 A7 C4 10 47 80 C0 20 44 80 42 D0
 01 4C D3 01 42 CD BE 74 21 44 42 C1 1F 45 80 C1
 2F 00
  Encoded length: 146 bytes
  Wall pattern: 04, Wall color: 01     Floor pattern: 02, Floor color: 13
  Flags: 
  Random food adds: 0
  Secret trick:  0 - No trick
 02 02 02 02 02 02 02 02 02 02 02 02 02 02 02 02 02 02 02 02 02 02 02 02 02 02 02 02 02 02 02 02 02
 02 15 00 00 00 00 00 00 00 00 00 00 00 00 00 00 00 00 00 00 00 00 00 00 01 00 00 01 00 50 00 00 02
 02 00 00 00 00 00 00 00 00 00 00 00 00 00 00 00 00 00 00 00 00 00 00 00 00 00 00 19 19 00 00 00 02
 02 00 00 00 00 00 00 00 00 00 00 00 00 00 00 00 00 00 00 00 00 00 00 00 00 00 00 19 19 00 00 00 02
 02 00 00 00 00 00 00 00 00 00 00 00 00 00 00 00 00 00 00 00 00 00 00 00 01 00 00 00 00 00 00 00 02
 02 02 02 02 02 63 02 02 63 02 63 02 02 02 02 02 02 02 02 02 02 02 02 02 02 02 00 00 31 00 00 00 02
 02 53 00 00 00 00 00 00 00 00 00 00 00 00 00 00 00 00 00 00 00 00 00 00 00 00 00 00 00 00 00 00 02
 02 00 00 00 00 00 00 00 00 00 00 00 00 00 00 00 00 00 00 00 00 00 00 00 00 00 00 00 00 00 00 00 02
 02 00 00 00 00 00 00 00 00 00 00 00 00 00 00 00 00 00 00 00 00 00 00 00 00 00 00 00 00 00 00 00 02
 02 00 00 00 00 00 00 00 00 00 00 00 00 00 00 00 00 00 00 00 00 00 00 00 00 00 00 00 00 00 00 00 02
 02 00 00 00 00 00 00 00 00 00 00 00 00 00 00 00 00 00 00 00 00 00 00 00 00 00 00 00 00 00 00 00 02
 02 00 32 00 00 63 02 02 63 02 63 02 02 02 02 02 02 02 02 02 02 02 02 02 02 02 02 02 02 02 02 02 02
 02 00 00 00 00 00 00 00 00 00 00 00 00 00 00 01 00 00 00 00 00 00 01 00 00 00 01 00 00 00 00 46 02
 02 00 00 00 00 00 00 00 00 00 00 00 00 00 01 00 00 00 00 01 00 00 00 00 00 00 00 00 00 00 00 00 02
 02 00 00 00 00 00 00 00 00 00 00 00 00 00 00 00 01 00 00 00 00 00 01 00 01 00 00 00 00 00 00 00 02
 02 00 00 00 00 00 00 00 00 00 00 00 01 00 00 00 00 00 01 00 00 01 00 00 00 00 00 01 00 00 00 00 02
 02 02 02 02 02 63 02 02 63 02 63 02 02 02 02 02 02 02 02 02 02 02 02 02 02 02 02 02 02 00 00 00 02
 02 29 00 00 00 00 00 00 00 00 00 00 00 00 21 00 00 21 00 00 00 21 00 00 00 00 21 00 00 00 00 00 02
 02 00 00 00 01 00 00 00 01 00 00 00 00 00 00 00 00 00 00 00 00 00 00 00 00 00 00 00 00 00 00 00 02
 02 00 00 00 00 00 00 00 00 00 00 00 00 00 00 00 00 00 00 00 00 00 00 00 00 00 00 00 00 00 00 00 02
 02 00 01 00 00 00 01 00 00 00 00 00 00 00 00 00 00 00 00 00 00 00 00 00 00 00 00 00 00 00 00 00 02
 02 00 00 00 00 00 00 00 00 00 00 00 00 00 00 00 00 00 00 00 00 00 00 00 00 00 00 00 00 00 00 00 02
 02 00 00 00 01 00 00 00 01 00 00 00 00 00 00 00 00 00 00 00 00 00 00 00 00 00 00 00 00 00 46 00 02
 02 00 00 00 02 02 02 02 02 02 63 63 02 02 63 63 02 02 63 63 02 02 02 02 02 02 02 02 13 13 13 13 02
 02 00 00 00 00 00 00 00 00 00 00 00 00 00 00 00 00 00 00 00 00 00 00 00 00 00 00 00 00 00 00 00 02
 02 00 00 00 00 00 00 00 00 00 00 00 00 00 00 00 00 34 00 00 00 34 00 00 00 00 00 00 00 00 00 00 02
 02 46 00 00 00 00 00 00 00 00 00 00 00 00 00 00 00 00 00 00 00 00 00 00 00 00 00 00 00 00 00 00 02
 02 02 02 02 02 02 02 02 02 02 63 63 02 02 63 63 02 02 63 63 02 02 02 02 02 02 02 02 00 00 00 00 02
 02 16 00 00 00 00 00 00 00 00 01 01 00 32 00 00 00 00 00 01 01 00 00 00 01 00 00 00 00 00 00 00 02
 02 00 00 00 00 00 00 00 00 00 01 00 00 00 00 00 00 00 00 00 00 00 00 00 01 00 00 00 00 00 00 00 02
 02 00 00 00 00 00 00 00 00 00 00 00 00 01 00 00 00 01 00 00 00 00 00 00 00 00 00 00 00 00 00 00 02
 02 46 00 00 00 00 00 33 00 00 00 00 00 01 00 00 00 01 00 00 31 00 00 00 00 00 00 01 01 00 00 47 02
 02 02 02 02 02 02 02 02 02 02 02 02 02 02 02 02 02 02 02 02 02 02 02 02 02 02 02 02 02 02 02 02 02
