Gauntlet II
Maze number: 86
Offset for maze 85: 236353 - 0x039b41
big endian buf: [%!l(uint8=0) %!l(uint8=3) %!l(uint8=155) %!l(uint8=65)]
G:2 Maze real addr: 252737 - 0x03DB41, bank 2, boff: 0x4000
Maze read from: 0x03db41 - 252737
compresssed: 245
 07 00 02 00 00 2E A0 0D AE 41 5D 1C 80 C8 07 C3
 32 C0 64 31 C1 20 A0 C0 1E 10 56 80 C1 07 72 18
 C6 18 C2 05 C0 2F C1 68 07 C3 37 B2 51 C2 33 C2
 05 C3 A1 C1 AB 50 C8 05 77 50 54 58 C3 05 83 57
 C7 1F CB 1F 5A D2 2E 42 AB C1 A5 C1 B7 A1 44 C2
 35 80 C6 0A C0 25 C4 32 C0 22 C0 0C C0 31 C6 B2
 A1 CC 27 76 CB 1F C3 66 6F E6 B4 A7 76 C6 05 CB
 08 1D 67 A0 C4 A1 CC 08 C3 22 C4 64 34 A0 60 05
 C2 B3 CD 35 C3 BF C3 21 A0 71 F0 74 C3 35 A0 60
 05 C4 2A D5 21 A0 CD 3A C0 23 C0 1C EC 6B 41 A0
 BB D8 1C D8 2E 81 CD 63 35 1F CF BE 41 A7 D4 09
 C6 22 32 C4 6F 09 D7 26 C9 3A C0 38 C5 BC 1E C5
 1F C1 0B 81 C3 1C C4 B2 A0 C5 60 04 A0 C6 32 35
 C1 20 C8 22 C7 2E 31 C6 A1 BA D2 B2 41 B2 41 B9
 C1 BB C4 BE C1 B4 C2 65 0F CA 0E C4 6A 2E BE CB
 0E C4 6A 35 00
  Encoded length: 245 bytes
  Wall pattern: 14, Wall color: 00     Floor pattern: 02, Floor color: 10
  Flags: FAST_GRUNTS 
  Random food adds: 0
  Secret trick:  7 - Save Super Shots
 02 02 02 02 02 02 02 02 02 02 02 02 02 02 02 02 02 02 02 02 02 02 02 02 02 02 02 02 02 02 02 02 02
 02 28 00 00 00 00 00 00 00 00 00 07 00 00 00 00 50 02 46 00 00 00 00 00 49 02 00 32 02 00 30 16 02
 02 00 00 00 00 00 00 01 01 00 00 07 00 00 00 29 24 02 00 00 00 00 00 00 24 02 00 00 05 00 47 00 02
 02 46 00 00 00 00 00 00 00 00 00 07 00 00 00 00 55 02 00 00 01 00 00 00 51 02 00 00 05 00 00 00 02
 02 02 02 00 00 02 02 02 02 02 02 02 02 02 02 02 02 00 01 00 00 00 00 00 00 02 00 00 05 00 00 00 02
 02 00 00 00 00 29 00 01 00 00 00 00 00 01 00 00 00 00 00 00 00 00 00 01 00 02 00 00 05 05 05 05 02
 02 00 00 00 00 00 00 00 00 01 00 00 00 00 00 00 00 00 31 00 00 00 00 00 00 02 00 00 00 00 00 31 02
 02 00 00 00 00 00 00 00 00 00 00 01 00 00 00 00 00 00 00 00 00 00 00 00 00 02 00 00 00 00 00 46 02
 02 13 13 02 02 02 02 02 02 02 02 02 02 02 02 00 00 02 02 02 02 02 02 00 00 02 02 02 13 13 13 13 02
 02 00 00 02 53 53 00 00 00 00 00 00 00 10 02 37 00 00 00 00 00 50 02 34 00 12 02 49 00 00 00 00 02
 02 00 00 02 02 02 00 00 00 00 00 00 00 00 02 00 00 00 00 39 00 00 02 00 00 00 02 29 00 00 00 00 02
 02 00 00 00 00 00 00 00 31 00 00 00 00 46 02 00 00 00 00 00 00 46 02 00 00 00 02 00 00 00 00 00 02
 02 00 00 00 00 00 00 00 00 00 00 00 02 02 02 02 02 02 02 02 02 02 02 00 00 00 02 00 00 00 29 00 02
 02 00 00 00 00 00 05 00 00 00 00 00 02 00 00 00 00 00 00 08 29 46 02 00 00 00 02 00 00 00 02 00 02
 02 00 00 02 02 02 00 00 00 00 00 00 02 00 00 00 00 00 00 08 00 00 02 00 34 00 02 00 00 00 46 00 02
 02 00 00 02 52 02 46 00 05 00 00 00 02 00 00 00 00 00 00 02 00 00 02 00 00 00 02 53 00 00 00 00 02
 02 00 00 02 00 33 02 00 00 29 00 00 00 00 00 00 00 00 00 02 00 00 02 00 00 00 02 02 00 00 00 00 02
 02 29 00 02 00 00 53 02 46 00 05 00 00 00 00 00 42 00 00 02 00 00 02 00 00 00 02 00 00 00 00 00 02
 02 00 00 02 00 00 00 33 02 00 00 00 00 02 00 00 02 00 00 02 00 00 02 58 00 35 02 28 00 00 00 00 02
 02 00 00 02 00 00 00 00 00 02 46 00 00 02 00 00 02 00 00 02 00 00 02 13 13 02 02 00 00 00 00 00 02
 02 00 00 02 00 00 00 00 00 00 02 00 00 02 00 00 02 00 00 02 28 00 02 00 00 00 00 00 00 00 00 00 02
 02 00 00 02 00 00 00 00 00 00 02 00 00 02 46 46 02 00 00 02 00 00 02 00 00 00 00 00 00 00 00 46 02
 02 00 00 02 53 31 00 00 00 00 02 00 00 02 00 00 02 00 00 02 00 00 02 13 13 02 02 02 02 02 02 02 02
 02 00 00 02 00 00 00 00 00 00 02 00 00 02 00 00 02 00 00 02 00 00 09 00 00 00 00 00 00 00 34 50 02
 02 00 00 02 00 46 00 00 00 00 02 00 00 02 00 00 02 00 00 02 00 00 09 00 00 00 00 02 00 00 00 00 02
 02 00 00 02 00 00 00 00 00 00 02 00 00 02 00 38 02 00 00 02 00 00 02 00 00 00 58 02 56 00 00 00 02
 02 00 00 02 30 00 00 00 00 00 02 31 00 02 11 11 02 00 00 02 00 28 02 00 00 00 00 02 02 00 00 00 02
 02 00 00 46 02 04 02 02 00 00 02 00 00 02 50 53 02 00 32 02 00 00 02 00 00 00 00 00 34 00 00 00 02
 02 00 00 00 02 46 49 02 00 00 02 00 00 02 02 02 02 00 00 02 00 00 02 00 00 00 00 00 00 00 00 00 02
 02 00 00 00 02 13 13 02 13 13 02 00 00 02 00 00 00 00 00 02 00 00 02 00 00 00 46 00 00 00 00 00 02
 02 15 00 00 00 00 00 00 00 00 00 00 00 14 00 00 00 00 00 46 00 00 00 00 00 00 00 00 00 00 00 46 02
 02 00 00 00 00 00 00 00 00 00 00 00 00 14 00 00 00 00 00 46 00 00 00 00 00 00 00 00 00 00 00 53 02
 02 02 02 02 02 02 02 02 02 02 02 02 02 02 02 02 02 02 02 02 02 02 02 02 02 02 02 02 02 02 02 02 02
