Gauntlet II
Maze number: 30
Offset for maze 29: 236346 - 0x039b3a
big endian buf: [%!l(uint8=0) %!l(uint8=3) %!l(uint8=155) %!l(uint8=58)]
G:2 Maze real addr: 236346 - 0x039B3A, bank 0, boff: 0x0000
Maze read from: 0x039b3a - 236346
compresssed: 231
 02 00 00 00 20 61 AF 6E 98 5C 9E 0F 80 C6 27 35
 4A C1 27 C0 05 C0 0C C0 33 D1 27 35 41 C3 05 61
 0C B2 A6 09 80 AE 08 83 A1 35 0E 44 44 C7 20 C6
 0E 60 0E 44 C2 60 2E 31 C2 20 C6 62 0E C0 15 0E
 C0 20 42 44 CB 21 C2 0E 15 AF A8 05 81 A4 7B 1C
 CD 70 60 32 75 1D CD 1E 31 41 70 18 B3 AC 2E 81
 AE 2E 42 46 C4 31 40 48 6A 21 C1 27 C0 27 DF 4E
 D1 2E C1 73 1C C5 1F C7 21 31 DF C0 27 C6 71 2E
 42 D3 6C 05 80 AA B8 C2 B8 AB 05 80 C7 22 59 DF
 C2 1D 41 74 AF AE C3 23 43 58 48 18 3E C5 22 41
 52 C8 1D C2 71 0A C0 07 AB 07 0D 81 07 AE 1E 3E
 40 56 54 4B DF C7 29 40 48 50 40 C0 1D CA 31 D0
 31 E2 0D 82 C5 64 B4 C2 B4 C5 62 0E C3 28 41 C2
 29 40 41 42 41 50 C2 1D C0 0E 35 18 10 B6 33 4A
 C0 2A 40 C9 0E C2 00
  Encoded length: 231 bytes
  Wall pattern: 01, Wall color: 15     Floor pattern: 06, Floor color: 10
  Flags: WRAP_H 
  Random food adds: 0
  Secret trick:  2 - Try Transportability (onto death)
 02 02 02 02 02 02 02 02 02 02 02 02 02 02 02 02 02 02 02 02 02 02 02 02 02 02 02 02 02 02 02 02
 02 15 00 00 00 00 00 00 00 39 53 00 00 00 00 00 00 00 00 00 00 00 46 00 00 39 00 05 00 12 00 51
 02 00 00 00 00 00 00 00 00 00 00 00 00 00 00 00 00 00 39 53 00 00 46 00 00 00 00 05 24 00 00 12
 02 02 02 02 02 02 02 02 09 09 02 02 02 02 02 02 02 02 02 02 02 02 02 02 02 08 08 08 08 08 02 02
 53 14 00 00 00 00 00 46 00 00 00 00 00 46 00 00 00 00 00 00 00 00 32 00 00 00 00 00 00 00 14 24
 00 14 00 00 00 00 00 46 00 00 00 24 00 46 49 00 00 00 32 00 00 00 00 00 00 00 24 00 00 00 14 00
 21 14 00 32 00 00 00 46 00 00 00 00 00 46 00 00 00 00 00 00 00 00 00 00 00 00 33 00 00 00 14 21
 02 02 02 02 02 02 02 02 02 02 02 02 02 02 02 02 02 02 02 02 02 02 02 02 02 05 05 05 02 02 02 02
 02 30 00 00 00 00 00 00 00 00 00 00 00 00 28 00 00 00 00 00 00 00 00 00 00 00 00 00 00 30 00 24
 02 50 30 00 00 00 00 00 00 29 00 00 00 00 00 00 00 00 00 00 00 00 00 00 30 49 00 00 46 30 00 24
 02 02 02 02 02 02 02 02 02 02 02 02 02 02 46 46 46 02 02 02 02 02 02 02 02 02 02 02 02 02 02 02
 46 00 00 00 46 00 00 00 00 00 00 00 46 02 00 00 00 02 49 00 46 00 00 00 00 00 00 00 00 00 46 24
 00 00 00 00 00 00 00 00 00 00 00 33 00 02 39 00 39 02 00 00 00 00 00 00 00 00 00 00 00 00 00 00
 00 00 00 00 00 00 00 00 00 00 00 00 00 02 00 00 00 02 00 00 00 00 00 00 00 00 00 00 00 00 00 00
 46 00 00 00 00 00 00 00 00 00 00 00 00 02 00 00 00 02 00 46 00 00 30 00 00 00 00 28 00 00 00 00
 00 00 31 00 00 00 00 00 00 00 00 33 49 02 00 00 00 02 00 00 00 00 00 00 00 00 00 00 00 00 00 00
 00 00 00 00 00 00 00 00 00 00 00 00 00 02 39 00 00 02 00 00 00 00 30 00 00 46 00 00 00 46 00 00
 00 00 00 00 00 00 00 00 00 00 00 00 00 02 00 00 00 02 24 00 00 00 00 00 00 00 00 00 00 00 00 00
 05 05 02 02 02 02 02 02 02 02 02 02 02 02 00 00 00 02 02 02 02 02 02 02 02 02 02 02 02 02 05 05
 00 00 00 00 00 00 00 00 34 00 00 00 00 00 00 00 00 00 00 28 00 00 00 00 00 00 00 00 00 00 00 00
 00 00 00 00 00 00 00 00 00 00 00 00 00 00 00 00 00 00 00 00 00 00 00 29 00 00 46 30 00 00 00 00
 00 02 02 02 02 02 02 02 02 02 02 02 02 02 02 02 02 02 02 02 02 02 02 02 02 02 02 02 02 02 02 02
 00 00 00 00 35 00 00 00 00 46 00 00 00 00 00 00 00 00 00 28 00 00 00 00 00 00 00 00 00 46 24 62
 00 00 00 00 00 00 34 00 00 46 00 00 00 28 00 00 00 00 00 00 00 00 00 29 00 00 00 30 00 00 10 00
 07 02 02 02 02 02 02 02 02 02 02 02 02 07 13 13 13 07 02 02 02 02 02 02 02 02 02 02 02 02 02 02
 02 30 62 00 46 00 00 00 00 00 00 00 28 02 00 00 00 02 28 00 00 00 00 00 00 00 00 00 00 00 00 46
 02 00 00 00 00 00 00 00 00 00 00 00 00 02 00 00 00 02 00 00 00 00 00 00 00 00 00 00 00 00 00 00
 02 00 00 00 00 00 00 00 41 00 46 00 00 02 00 00 00 02 00 00 46 00 28 00 46 00 29 00 00 00 00 00
 02 00 00 00 00 00 49 00 00 00 00 00 00 02 00 00 00 02 00 00 00 00 00 00 49 00 00 00 02 13 13 13
 02 00 00 00 00 00 00 24 00 00 00 00 00 02 00 00 00 02 00 00 00 00 00 00 24 00 00 00 14 00 00 00
 02 40 00 00 46 00 00 00 41 00 46 00 00 46 00 00 00 46 00 00 46 00 28 00 00 00 29 00 14 53 24 16
 02 51 00 00 00 00 00 00 00 00 00 00 00 46 00 42 00 46 00 00 00 00 00 00 00 00 00 00 14 00 00 00
 02 02 02 02 02 02 02 02 02 02 02 02 02 02 02 02 02 02 02 02 02 02 02 02 02 02 02 02 02 02 02 02
