Gauntlet II
Maze number: 19
Offset for maze 18: 233680 - 0x0390d0
big endian buf: [%!l(uint8=0) %!l(uint8=3) %!l(uint8=144) %!l(uint8=208)]
G:2 Maze real addr: 233680 - 0x0390D0, bank 0, boff: 0x0000
Maze read from: 0x0390d0 - 233680
compresssed: 208
 0C 00 00 4E 00 43 05 6E 59 0E 9D 18 80 35 2A 35
 2A 35 2A C2 20 C0 35 C0 22 C3 2F C0 28 41 29 62
 10 40 DB 19 81 C7 1F C1 33 41 CA 2A C5 70 70 79
 22 CC 2F 4A CB 71 33 C4 20 C0 20 C0 20 C0 20 49
 C0 23 C2 1B CF 72 2E D0 18 41 C0 3B 40 D3 2A DF
 62 CC 20 49 64 10 DE 19 D1 2E C0 23 D5 2E CE 2A
 C2 18 C8 7F C7 0F CB 37 6E BF C6 5F 41 C0 21 5F
 C5 5F C1 72 5F 60 10 D3 23 69 DC 1B DC 2A CC 7F
 C4 18 D0 34 2E C0 23 42 47 40 C0 3B 40 C4 20 CA
 1B 64 DD 19 10 C1 70 70 75 2E CC 2A 62 D0 1B C1
 23 D3 7D 79 24 C0 24 CA 22 CC 2F CC 20 43 DF C0
 23 C5 2A 44 DB 19 80 BE 18 1E 35 1E 35 1E 35 5E
 C1 1F C1 5E 22 C3 35 5E 28 41 29 C0 5E 60 10 00
  Encoded length: 208 bytes
  Wall pattern: 03, Wall color: 05     Floor pattern: 04, Floor color: 00
  Flags: WALLS_CYCLIC EXIT_MOVES 
  Random food adds: 6
  Secret trick: 12 - Don't Be Greedy (no keys or potions)
 02 02 02 02 02 02 02 02 02 02 02 02 02 02 02 02 02 02 02 02 02 02 02 02 02 02 02 02 02 02 02 02 02
 02 24 53 42 53 42 53 42 14 00 00 32 00 53 14 34 00 00 00 00 47 14 40 00 00 46 41 00 14 00 25 16 02
 02 46 00 00 00 00 00 00 14 00 00 00 00 00 14 00 00 00 00 00 00 14 00 00 00 00 00 00 14 00 25 25 02
 02 00 00 00 00 00 00 00 14 31 00 00 51 00 14 46 00 00 00 00 00 14 00 00 00 00 00 42 14 00 00 00 02
 02 00 29 00 29 00 29 00 14 00 00 00 00 00 14 00 00 34 00 00 00 14 00 00 00 00 00 00 14 00 00 47 02
 02 00 00 00 00 00 00 00 14 00 00 46 00 00 14 00 00 00 00 00 00 14 00 00 29 00 00 51 14 00 00 00 02
 02 32 00 32 00 32 00 32 14 00 00 00 00 00 14 00 00 00 46 00 35 14 00 00 27 00 00 00 14 00 00 00 02
 02 00 00 00 00 00 00 00 14 29 00 00 00 46 14 00 00 00 00 00 00 14 00 00 00 00 00 00 14 00 00 24 02
 02 00 46 00 59 00 46 00 14 00 00 00 00 00 14 00 00 00 00 00 00 14 00 00 00 00 00 42 14 00 00 00 02
 02 00 00 00 00 00 00 00 14 00 00 00 00 00 14 00 00 00 00 00 00 14 00 00 00 00 00 00 14 00 00 25 02
 02 00 00 00 00 00 00 00 14 00 00 00 00 32 14 00 00 00 00 00 00 14 00 00 46 00 00 00 14 00 25 16 02
 02 00 00 00 00 00 00 00 14 00 00 00 00 00 14 00 00 00 00 00 00 14 00 00 00 00 00 00 14 00 00 25 02
 02 00 00 00 00 00 00 00 14 00 00 00 00 00 14 00 00 00 46 00 35 14 00 00 00 00 00 00 14 00 00 00 02
 02 00 00 00 00 00 00 00 14 00 00 46 00 00 14 00 00 00 00 00 00 14 00 00 00 00 00 42 14 00 00 24 02
 02 00 00 00 00 00 00 00 14 29 00 00 00 00 14 00 00 00 00 00 00 14 00 00 00 00 00 00 14 00 00 00 02
 02 00 15 00 00 00 00 00 14 00 00 00 00 00 14 55 00 00 00 00 00 14 00 00 00 00 00 00 14 00 00 25 02
 02 00 00 00 00 00 00 00 14 00 00 46 00 33 14 00 00 00 00 00 00 14 00 00 29 00 00 00 14 00 25 16 02
 02 00 00 00 00 00 00 00 14 00 00 00 00 00 14 00 00 00 00 00 35 14 00 00 00 00 00 00 14 00 00 25 02
 02 00 00 00 00 00 00 00 14 00 00 00 00 00 14 00 00 00 00 00 00 14 00 00 00 00 00 00 14 27 00 00 02
 02 00 00 00 00 00 00 00 14 00 00 00 00 00 14 00 00 00 00 00 00 14 00 00 00 00 00 42 14 00 00 00 02
 02 00 00 00 00 00 00 00 14 29 00 00 00 00 14 00 00 00 00 00 00 14 00 00 00 00 00 00 14 00 00 24 02
 02 00 00 00 00 00 00 00 14 00 00 00 00 00 14 00 00 52 46 00 35 14 00 00 46 00 00 00 14 00 00 00 02
 02 46 00 46 00 59 00 46 14 00 00 00 00 32 14 00 00 00 00 00 00 14 00 00 00 27 00 00 14 00 00 25 02
 02 00 00 00 00 00 00 00 14 00 00 00 00 00 14 00 00 00 00 00 00 14 00 00 00 00 00 00 14 00 25 16 02
 02 00 29 00 29 00 29 00 14 00 00 00 00 46 14 00 00 00 00 00 00 14 00 00 00 00 00 42 14 00 00 25 02
 02 00 00 00 00 00 00 00 14 00 00 00 00 00 14 00 00 27 00 00 35 14 00 00 00 00 00 00 14 00 00 00 02
 02 00 00 00 00 00 00 00 14 29 00 00 00 00 14 00 00 00 00 00 00 14 00 00 29 00 00 00 14 00 00 00 02
 02 00 00 36 00 36 00 00 14 00 00 00 00 00 14 00 00 34 00 00 00 14 00 00 00 00 00 00 14 00 00 47 02
 02 00 00 00 00 00 00 00 14 00 00 00 00 32 14 00 00 00 46 00 00 14 00 00 00 00 00 00 14 00 00 00 02
 02 00 00 00 00 00 00 00 14 00 00 00 00 00 14 00 00 00 00 00 35 14 00 00 00 00 00 42 14 00 00 00 02
 02 46 00 00 00 00 00 00 14 00 00 00 00 00 14 00 00 00 00 00 00 14 00 00 00 00 00 00 14 00 25 25 02
 02 24 30 53 30 53 30 53 14 00 00 31 00 00 14 34 00 00 00 00 53 14 40 00 00 46 41 00 14 00 25 16 02
 02 02 02 02 02 02 02 02 02 02 02 02 02 02 02 02 02 02 02 02 02 02 02 02 02 02 02 02 02 02 02 02 02
