Gauntlet II
Maze number: 94
Offset for maze 93: 230583 - 0x0384b7
big endian buf: [%!l(uint8=0) %!l(uint8=3) %!l(uint8=132) %!l(uint8=183)]
G:2 Maze real addr: 255159 - 0x03E4B7, bank 3, boff: 0x6000
Maze read from: 0x03e4b7 - 255159
compresssed: 239
 0A 80 00 00 30 12 1E 0D 43 0E 9E 38 80 C4 3A C0
 35 75 32 24 C3 19 C6 38 E9 E6 E6 DF C0 52 C3 43
 C2 B3 DF CE B4 6C 66 C7 1B 04 35 E3 C1 0F C0 35
 B3 C0 2D F0 3E C1 B3 C0 22 C1 A2 C0 A2 C0 A2 B4
 42 B7 C5 19 05 A2 C5 1D C5 31 CC 3E E9 C5 21 A0
 62 E2 C3 19 C0 22 A0 C2 24 C0 BA E2 CE B7 ED 15
 A0 42 C2 A7 2F C6 A3 DD 2E C2 1D E2 E6 24 E5 E6
 C6 2C C0 B6 35 CC 32 B6 C4 2E C0 A4 C2 05 A6 05
 A6 05 A6 C1 7D 22 C9 09 CB 1E A0 CD 24 C1 09 D6
 52 C6 09 0A C1 08 82 B7 CA B3 CB A2 D7 B4 EC C5
 1D A0 C6 18 C0 05 C3 20 A0 C6 74 B3 35 C9 05 25
 3A 19 C4 A7 C3 A6 B4 A1 04 A4 0B C2 32 73 10 C8
 35 22 C7 0C C0 07 82 E0 62 33 E1 C5 22 A0 64 1D
 CC 10 D2 34 C1 21 C5 A2 BB A3 43 C2 A7 B8 D6 31
 CB 1C A0 EA C5 25 A0 C8 B6 31 CD B7 CD 31 00
  Encoded length: 239 bytes
  Wall pattern: 02, Wall color: 14     Floor pattern: 01, Floor color: 01
  Flags: WRAP_V INVIS_TRAPWALLS WRAP_H 
  Random food adds: 0
  Secret trick: 10 - Try Pushing a Wall
 02 02 02 02 02 02 02 02 02 02 02 02 02 02 02 02 02 02 02 02 02 02 02 02 02 02 02 02 02 02 02 02
 02 56 00 00 00 00 00 58 02 53 30 00 00 00 00 00 02 50 36 00 00 00 00 25 02 00 00 00 14 00 00 56
 02 00 00 00 00 00 00 00 02 00 02 00 00 00 00 00 02 00 02 00 00 00 00 00 02 00 02 00 14 00 00 00
 02 00 00 00 00 00 00 00 02 00 00 00 00 00 00 00 02 00 00 00 00 00 00 00 02 00 00 00 14 00 00 00
 02 13 13 13 02 00 00 00 02 00 00 00 02 00 00 00 02 00 00 00 02 00 00 00 02 00 00 00 02 00 00 00
 02 00 00 00 02 00 00 00 00 00 00 00 02 00 00 00 02 00 00 00 02 00 00 00 02 00 00 00 02 00 00 00
 02 00 00 00 02 00 03 00 00 00 00 00 02 00 03 00 02 00 00 00 02 00 00 27 04 53 00 00 02 00 02 00
 02 15 00 53 02 00 45 00 00 00 00 00 02 00 00 00 02 00 00 00 02 00 00 00 02 62 00 00 02 00 34 00
 02 02 02 02 00 02 02 02 00 02 02 02 02 13 13 13 02 00 00 00 02 00 00 25 05 02 02 02 00 00 00 00
 02 00 29 00 00 00 00 00 02 49 00 00 00 00 00 00 00 00 00 00 02 00 00 62 02 00 00 00 00 00 00 00
 02 00 02 00 00 00 00 00 02 33 02 00 00 00 03 00 00 00 02 00 02 00 00 25 02 34 02 00 00 00 36 00
 02 00 00 00 02 00 00 00 02 00 00 00 00 00 00 00 00 00 00 00 02 00 00 00 02 00 00 00 00 00 00 00
 00 00 00 02 21 02 13 13 02 00 00 00 02 02 02 02 02 02 02 02 47 00 00 00 02 00 00 00 02 02 02 02
 00 00 00 00 02 00 00 00 02 00 00 00 00 00 00 00 00 00 00 00 00 00 00 00 02 00 00 00 00 00 46 00
 00 00 29 00 02 00 02 00 02 00 00 00 00 00 02 36 00 00 00 00 00 00 02 00 02 00 00 00 00 00 02 00
 00 00 00 00 02 00 44 00 02 53 00 00 00 00 00 00 00 00 00 00 00 00 00 50 02 00 00 00 00 00 46 00
 02 02 02 02 02 00 00 00 05 02 02 02 02 02 02 02 05 02 02 02 02 02 02 02 05 02 02 02 02 02 02 02
 00 00 30 00 02 00 00 00 02 00 00 00 00 00 00 00 02 34 00 00 14 00 00 00 02 00 00 00 09 00 00 00
 00 00 00 00 02 00 00 00 02 30 02 00 00 00 00 00 02 00 00 00 14 00 00 00 02 36 00 00 09 00 00 00
 00 00 00 00 02 00 00 00 02 00 00 00 00 00 00 00 02 00 00 00 14 00 00 00 02 00 00 00 09 10 00 00
 08 08 08 08 02 00 00 00 02 00 00 00 02 00 00 00 02 00 00 00 02 00 00 00 02 00 00 00 02 02 02 02
 00 00 00 00 00 00 00 00 02 00 00 00 02 00 00 00 00 00 00 00 02 00 00 00 02 00 00 00 02 00 00 00
 00 00 00 00 00 00 02 00 02 00 00 00 02 29 02 00 00 00 00 00 02 00 24 00 05 00 00 00 02 32 02 00
 00 00 00 00 00 00 30 00 02 00 00 00 02 53 00 00 00 00 00 00 02 00 00 00 05 37 58 25 02 00 00 00
 00 02 02 02 02 02 02 02 02 00 00 00 00 02 02 02 02 02 02 02 02 02 02 04 02 02 02 02 02 11 00 00
 02 50 30 00 00 00 00 16 02 00 00 00 00 00 00 00 02 53 34 00 00 00 00 00 00 00 00 12 02 07 07 07
 02 00 02 00 00 00 03 51 02 00 02 00 00 00 00 00 02 34 02 00 00 00 00 00 03 29 00 00 02 00 00 00
 02 00 00 00 00 00 00 16 02 00 00 00 00 00 00 00 02 00 00 00 00 00 00 00 00 00 00 52 02 00 33 00
 02 00 00 00 00 02 02 02 02 02 02 02 02 13 13 13 02 00 00 00 02 02 02 02 02 02 02 02 02 00 00 00
 02 00 00 00 00 00 00 00 00 00 00 00 00 00 00 00 02 00 00 00 49 00 00 00 00 00 00 00 00 00 00 00
 02 28 02 00 00 00 00 00 00 00 00 00 00 00 02 00 02 00 00 00 00 37 02 00 00 00 00 00 00 00 00 00
 02 49 00 00 00 00 00 00 00 00 00 00 00 00 00 00 02 00 00 00 00 00 00 00 00 00 00 00 00 00 00 49
