Gauntlet II
Maze number: 109
Offset for maze 108: 234033 - 0x039231
big endian buf: [%!l(uint8=0) %!l(uint8=3) %!l(uint8=146) %!l(uint8=49)]
G:2 Maze real addr: 258609 - 0x03F231, bank 3, boff: 0x6000
Maze read from: 0x03f231 - 258609
compresssed: 499
 0F 00 00 81 24 61 95 EE 85 87 4C C0 2E 05 10 A0
 C0 10 2E 09 2F C2 10 05 10 A0 35 C0 10 A0 2E 81
 61 2F A0 10 60 10 A0 C2 09 E0 E4 E2 C0 05 10 E3
 10 62 A1 71 C1 62 0C E0 2E 09 70 C0 09 2E 04 71
 E1 71 C1 2E 04 E2 2E A0 C2 09 C2 05 2F A0 E2 C2
 09 2E A0 C2 09 C1 09 35 A0 C2 09 2E A0 C4 08 C4
 09 2E A0 C2 09 2E A0 70 E1 71 E1 71 C1 05 2E A0
 71 E1 71 C1 08 E3 2E 08 C2 08 2E 09 E2 C2 09 E2
 2E A0 E2 2E 08 C0 2E 08 C2 09 2E A0 E2 2E 08 C4
 08 2E 08 C2 08 2E 09 E2 51 0B E1 C1 0B C1 08 C2
 0B E2 C1 0B E1 C1 0B C1 2E 62 40 52 07 2E A0 C4
 07 2E A0 E2 2E 52 A0 E1 2E 52 40 A0 C2 52 62 07
 2E 52 40 A0 C0 0A E1 C1 0A E1 E4 2E A0 E4 C1 0A
 E1 C3 05 2E 62 04 2E 51 0A E1 C1 0A E1 2E 52 05
 2E 60 2E 62 05 2E 52 A0 C2 05 2E 62 52 40 62 05
 A0 C1 0F E1 E4 2E 62 05 2E A0 E4 C1 0F C1 2E 62
 05 2E A0 E4 C1 0F E1 E4 2E 62 61 05 2E 62 52 40
 62 60 A0 C2 52 05 2E 60 0A E1 C1 0A E1 2E 52 05
 2E 62 07 2E 04 C1 0A E1 E3 2E A0 E4 C1 0A E1 C1
 0A E1 C4 05 2E A0 C0 2E 52 62 07 2E 52 40 52 40
 52 A0 C2 07 61 0B C1 07 2E A0 E2 2E 52 A0 C0 52
 40 51 0B C1 2E 08 E4 C1 0B E1 C1 0B E1 C1 0B C1
 64 61 A0 E2 2E 08 E2 2E 62 08 2E 08 E2 2E A0 C2
 08 E3 2E 08 E2 2E 08 E2 2E A0 E2 2E 08 C2 08 2E
 A0 71 C2 51 0C C1 61 0C C1 08 71 E1 71 C1 09 C5
 05 2E A0 E2 2E 09 C2 05 35 A0 C2 09 2E A0 E2 2E
 A0 E3 C2 08 2E A0 E2 2E 09 C2 09 2E A0 C2 09 2E
 A0 C2 09 C0 2E 09 71 C1 09 71 E1 71 C1 61 0C C1
 09 71 E1 64 40 04 E2 10 62 40 A0 E2 2E 63 2F 10
 A0 C2 62 40 A0 E2 2E A0 C2 05 2E 04 E2 E2 C1 05
 10 40 C2 10 05 2F E3 10 C2 2F 09 10 C2 2E A0 10
 A0 2F 00
  Encoded length: 499 bytes
  Wall pattern: 01, Wall color: 05     Floor pattern: 06, Floor color: 09
  Flags: EXIT_CHOOSE_ONE WRAP_H TRAPS_LOCAL 
  Random food adds: 1
  Secret trick: 15 - Be Pushy
 02 02 02 02 02 02 02 02 02 02 02 02 02 02 02 02 02 02 02 02 02 02 02 02 02 02 02 02 02 02 02 02
 00 46 05 16 02 00 16 46 09 47 00 00 00 16 05 16 02 53 00 16 02 46 46 46 05 00 00 47 02 16 05 00
 16 02 00 00 00 09 00 02 00 00 00 00 00 02 00 00 00 02 00 05 16 00 00 00 00 02 16 05 00 00 00 02
 02 00 00 12 00 00 05 00 00 00 12 00 02 46 09 00 12 00 09 46 04 00 00 12 00 00 02 00 00 12 00 00
 46 04 00 00 00 02 46 02 00 00 00 09 00 00 00 05 47 02 00 00 00 02 00 00 00 09 46 02 00 00 00 09
 00 00 09 53 02 00 00 00 09 46 02 00 00 00 00 00 08 00 00 00 00 00 09 46 02 00 00 00 09 46 02 00
 12 00 00 02 00 00 12 00 00 02 00 00 12 00 00 05 46 02 00 00 12 00 00 02 00 00 12 00 00 08 00 00
 00 00 02 46 08 00 00 00 08 46 09 00 00 00 02 00 00 00 09 00 00 00 02 46 02 00 00 00 02 46 08 00
 46 08 00 00 00 09 46 02 00 00 00 02 46 08 00 00 00 00 00 08 46 08 00 00 00 08 46 09 00 00 00 02
 07 00 00 11 00 00 02 00 00 11 00 00 08 00 00 00 11 00 00 00 02 00 00 11 00 00 02 00 00 11 00 00
 46 05 00 00 00 02 46 07 00 00 00 07 46 02 00 00 00 00 00 07 46 02 00 00 00 02 46 07 00 00 00 02
 00 00 02 46 07 00 00 00 02 46 02 00 00 00 07 00 00 00 05 00 00 00 07 46 07 00 00 00 02 46 02 00
 10 00 00 02 00 00 10 00 00 02 00 00 00 00 00 02 46 02 00 00 00 00 00 02 00 00 10 00 00 02 00 00
 00 00 05 46 05 00 00 00 04 46 07 00 00 10 00 00 02 00 00 10 00 00 02 46 07 00 00 00 05 46 05 00
 46 05 00 00 00 05 46 07 00 00 00 02 00 00 00 05 46 05 00 00 00 07 00 00 00 02 46 05 00 00 00 05
 02 00 00 15 00 00 02 00 00 00 00 00 02 46 05 00 00 00 05 46 02 00 00 00 00 00 02 00 00 15 00 00
 46 05 00 00 00 05 46 02 00 00 00 00 00 02 00 00 15 00 00 02 00 00 00 00 00 02 46 05 00 00 00 05
 00 00 05 46 05 00 00 00 07 00 00 00 02 46 05 00 00 00 05 00 02 00 00 00 07 00 00 00 05 46 05 00
 10 00 00 02 00 00 10 00 00 02 46 07 00 00 00 05 46 05 00 00 00 07 46 04 00 00 10 00 00 02 00 00
 00 00 02 46 02 00 00 00 00 00 02 00 00 10 00 00 02 00 00 10 00 00 02 00 00 00 00 00 05 46 02 00
 46 07 00 00 00 05 00 00 00 07 46 07 00 00 00 02 46 07 00 00 00 02 46 07 00 00 00 02 00 00 00 07
 05 00 00 11 00 00 07 46 02 00 00 00 02 46 07 00 00 00 02 00 07 00 00 00 02 46 07 00 00 11 00 00
 46 08 00 00 00 00 00 02 00 00 11 00 00 02 00 00 11 00 00 02 00 00 11 00 00 05 00 00 00 00 00 05
 00 00 02 00 00 00 02 46 08 00 00 00 02 46 05 00 00 00 08 46 08 00 00 00 02 46 02 00 00 00 08 00
 00 00 00 02 46 08 00 00 00 02 46 08 00 00 00 02 46 02 00 00 00 02 46 08 00 00 00 08 46 02 00 00
 12 00 00 00 07 00 00 12 00 00 05 00 00 12 00 00 08 00 00 12 00 00 02 00 00 12 00 00 09 00 00 00
 00 00 00 05 46 02 00 00 00 02 46 09 00 00 00 05 53 02 00 00 00 09 46 02 00 00 00 02 46 02 00 00
 00 00 02 00 00 00 08 46 02 00 00 00 02 46 09 00 00 00 09 46 02 00 00 00 09 46 02 00 00 00 09 00
 46 09 00 00 12 00 00 09 00 00 12 00 00 02 00 00 12 00 00 05 00 00 12 00 00 09 00 00 12 00 00 02
 05 00 00 00 00 00 02 46 04 00 00 00 02 16 05 00 00 00 02 46 02 00 00 00 02 46 05 00 00 00 00 47
 16 02 00 00 00 05 00 00 00 02 46 02 00 00 00 02 46 02 00 00 00 05 46 04 00 00 00 02 00 00 00 02
 00 00 05 16 02 46 00 00 00 16 05 47 00 00 00 00 02 16 00 00 00 47 09 16 00 00 00 46 02 16 02 47
 02 02 02 02 02 02 02 02 02 02 02 02 02 02 02 02 02 02 02 02 02 02 02 02 02 02 02 02 02 02 02 02
