Gauntlet II
Maze number: 70
Offset for maze 69: 231137 - 0x0386e1
big endian buf: [%!l(uint8=0) %!l(uint8=3) %!l(uint8=134) %!l(uint8=225)]
G:2 Maze real addr: 247521 - 0x03C6E1, bank 2, boff: 0x4000
Maze read from: 0x03c6e1 - 247521
compresssed: 234
 0B 00 00 80 78 01 00 5D 60 99 6E 2E 42 3E C0 0B
 D0 0B C0 3E 1D D2 5F 47 A4 C2 A4 1D CC 2F 60 C2
 23 C8 23 62 C0 2F C5 A3 B4 C8 58 B4 A3 EE E2 DF
 CE A7 B5 CA B5 A7 72 44 C5 50 55 1D 74 72 C8 0A
 C6 0A 78 C0 AD C5 AB 15 04 1A A0 23 C5 08 10 C0
 32 C2 32 C0 10 08 C5 18 09 1A 04 A0 E0 E0 C5 08
 81 C5 08 80 E5 E0 C5 07 F4 C7 04 18 47 35 0C 35
 1D C7 23 A0 73 AA BA A4 BA AA C3 15 CB 35 81 C9
 15 C4 09 80 D6 07 80 C0 31 C2 10 09 18 64 C8 29
 C4 18 07 10 40 C2 AA C4 AB 41 60 66 61 C4 29 C7
 29 C1 0D A0 B6 DA B6 A0 50 0E 72 D2 2E C2 0E C0
 0D 80 A4 68 C9 A3 0D C4 2F 60 EA C4 29 C0 2F 63
 D1 1B A0 CA A2 E7 E8 E8 E9 1B C0 B8 E7 C8 0F C0
 B2 E5 EC C5 B2 E8 1C 4C A0 C6 35 80 C2 3E B7 C4
 24 C3 BF 24 C6 B7 3E C2 35 00
  Encoded length: 234 bytes
  Wall pattern: 01, Wall color: 00     Floor pattern: 00, Floor color: 00
  Flags: EXIT_CHOOSE_ONE WRAP_V EXIT_FAKE WRAP_H TRAPS_RANDOM 
  Random food adds: 0
  Secret trick: 11 - Don't Be Fooled
 02 02 02 02 02 02 02 02 02 02 02 02 02 02 02 02 02 02 02 02 02 02 02 02 02 02 02 02 02 02 02 02
 46 00 00 00 29 62 02 11 00 00 00 00 00 00 00 00 00 00 00 00 00 00 00 00 00 11 02 62 29 00 00 00
 00 00 00 00 00 00 02 00 00 00 00 00 00 00 00 00 25 00 00 00 00 00 00 00 00 00 02 00 00 00 00 00
 00 00 00 00 00 00 02 00 00 29 02 02 02 02 02 00 00 00 02 02 02 02 02 29 00 00 02 00 00 00 00 00
 00 00 00 00 00 47 02 32 00 00 02 35 00 00 00 00 00 00 00 00 00 35 02 00 00 32 02 47 00 00 00 00
 00 00 02 02 02 02 02 00 00 00 02 00 00 00 00 00 25 00 00 00 00 00 02 00 00 00 02 02 02 02 02 00
 00 00 00 00 00 00 00 00 00 00 02 00 00 02 02 00 00 00 02 02 00 00 02 00 00 00 00 00 00 00 00 00
 00 00 00 00 00 00 00 00 00 00 02 00 00 02 00 00 00 00 00 02 00 00 02 00 00 00 00 00 00 00 00 00
 00 00 02 02 02 02 02 02 02 02 02 00 00 02 00 00 00 00 00 02 00 00 02 02 02 02 02 02 02 02 02 00
 00 00 46 00 00 00 00 00 29 00 00 00 00 02 00 25 00 25 00 02 00 00 00 00 29 00 00 00 00 00 46 00
 00 00 46 00 00 00 00 00 00 00 00 00 10 02 00 00 00 00 00 02 10 00 00 00 00 00 00 00 00 00 46 00
 02 02 02 02 02 02 02 02 02 02 02 02 02 02 00 00 00 00 00 02 02 02 02 02 02 02 02 02 02 02 02 02
 21 04 26 02 35 00 00 00 00 00 00 08 16 02 50 00 00 00 50 02 16 08 00 00 00 00 00 00 24 09 26 04
 02 00 02 00 02 00 00 00 00 00 00 08 08 02 00 00 00 00 00 02 08 08 00 00 00 00 00 00 02 00 02 00
 00 00 00 00 00 07 00 00 00 00 00 00 00 02 00 00 00 00 00 02 00 00 00 00 00 00 00 02 00 00 00 00
 00 00 00 00 04 24 00 00 00 00 00 00 00 02 29 53 12 53 29 02 00 00 00 00 00 00 00 35 02 00 00 00
 00 46 02 02 02 02 02 02 02 02 02 02 02 02 02 02 02 02 02 02 02 02 02 02 02 02 02 02 02 02 02 00
 00 00 02 21 00 00 00 00 00 00 00 00 00 00 00 00 53 02 53 00 00 00 00 00 00 00 00 00 00 21 02 00
 00 00 02 09 09 00 00 00 00 00 00 00 00 00 00 00 00 02 00 00 00 00 00 00 00 00 00 00 07 07 02 49
 00 00 02 16 09 24 00 00 00 00 00 32 00 00 00 00 00 02 00 00 00 41 00 00 00 00 00 24 07 16 02 29
 00 00 02 02 02 02 02 02 02 02 02 02 02 02 00 00 00 02 00 02 02 02 02 02 02 02 02 02 02 02 02 00
 00 29 02 32 00 00 00 00 00 00 00 32 00 02 32 00 00 02 00 00 41 00 00 00 00 00 00 00 00 41 02 00
 13 02 02 00 00 00 00 00 00 00 00 00 00 02 00 00 00 02 00 00 00 00 00 00 00 00 00 00 00 00 02 02
 25 00 14 00 00 00 46 00 00 00 00 00 00 02 00 00 00 02 00 00 00 00 00 00 00 00 46 00 00 00 14 00
 13 13 02 02 02 02 02 00 00 00 00 00 00 02 00 00 32 02 00 00 00 00 00 00 00 00 02 02 02 02 02 13
 00 00 00 00 00 47 02 32 00 00 00 00 00 02 00 00 00 02 00 02 00 00 00 00 00 41 02 47 00 00 00 00
 32 00 00 00 00 00 02 00 00 00 00 00 00 02 00 00 00 02 00 27 02 00 00 00 00 00 02 00 00 00 00 00
 02 02 02 00 00 00 02 00 00 00 00 02 00 02 00 00 00 02 00 00 00 02 00 00 00 00 02 00 00 00 02 02
 00 00 02 00 00 00 02 00 00 00 02 27 00 02 00 00 00 02 00 00 00 00 02 00 00 00 02 00 00 00 02 00
 15 00 02 00 00 00 02 00 00 02 00 00 00 00 00 00 00 02 00 00 00 00 00 02 00 00 02 00 00 00 02 00
 00 00 00 00 00 00 02 00 02 28 00 00 00 00 00 00 00 02 00 00 00 00 00 29 02 00 02 00 00 00 00 00
 53 53 00 00 00 62 02 00 00 00 00 00 36 00 00 00 00 02 36 00 00 00 00 00 00 00 02 62 00 00 00 53
