Gauntlet II
Maze number: 18
Offset for maze 17: 233489 - 0x039011
big endian buf: [%!l(uint8=0) %!l(uint8=3) %!l(uint8=144) %!l(uint8=17)]
G:2 Maze real addr: 233489 - 0x039011, bank 0, boff: 0x0000
Maze read from: 0x039011 - 233489
compresssed: 191
 04 00 00 03 20 33 2F 60 9A 0E AE C6 2E A0 10 C4
 3F 80 E5 31 0A 81 6A A0 39 CD A4 CB A3 3C CE A1
 20 A1 20 18 53 C3 04 A0 04 A2 3F 80 ED C1 A2 C9
 A8 CB 2E A2 CF A1 CD A2 EE CF A3 C0 21 C9 A2 C1
 15 CD A4 68 A2 D2 A2 29 46 80 A6 CE A5 67 1F A6
 40 EC CA 71 20 A6 C9 A5 4E A4 C9 22 A1 D2 A2 C8
 22 A5 CF A2 E0 EA 45 49 A0 E0 CA AD 45 A1 44 F0
 C7 A5 D1 A1 CA 1F A8 72 20 80 C4 A3 6C 0F C1 A5
 E8 7F C3 1F A2 15 64 AB CB 23 A0 C9 15 C6 A1 38
 A0 C8 23 A4 EE 3E A5 C7 29 A9 C2 1D C0 07 81 E3
 D0 1C 1D A2 CA 3E A3 CF A4 C4 B2 A1 71 A5 CD 33
 A2 C8 31 A0 35 C3 1D CB 18 3E A0 C4 1D C2 00
  Encoded length: 191 bytes
  Wall pattern: 03, Wall color: 15     Floor pattern: 03, Floor color: 02
  Flags: WRAP_H 
  Random food adds: 3
  Secret trick:  4 - Try Transportability (onto secret wall)
 02 02 02 02 02 02 02 02 02 02 02 02 02 02 02 02 02 02 02 02 02 02 02 02 02 02 02 02 02 02 02 02
 00 00 00 00 14 00 00 46 02 16 00 00 00 00 00 63 63 00 00 00 00 00 00 02 49 10 10 10 26 00 00 00
 00 00 00 00 14 00 00 00 02 57 00 00 00 00 00 00 00 00 00 00 00 00 00 00 02 02 02 02 02 00 00 00
 00 00 00 00 14 00 00 00 00 02 02 02 02 60 00 00 00 00 00 00 00 00 00 00 00 00 00 00 00 02 02 32
 02 02 32 24 14 00 00 00 00 04 02 04 02 02 02 63 63 00 00 00 00 00 00 00 00 00 00 00 00 00 00 02
 00 00 02 02 02 00 00 00 00 00 00 00 00 00 00 02 02 02 02 02 02 02 02 02 00 00 00 00 00 00 00 00
 00 00 00 00 46 02 02 02 00 00 00 00 00 00 00 00 00 00 00 00 00 00 00 00 02 02 00 00 00 00 00 00
 00 00 00 00 00 00 00 00 02 02 02 00 00 00 00 00 00 00 00 00 00 00 00 00 00 00 02 00 00 00 00 00
 00 00 00 00 00 00 00 00 00 00 00 02 02 02 02 00 33 00 00 00 00 00 00 00 00 00 00 02 02 02 00 00
 21 00 00 00 00 00 00 00 00 00 00 00 00 00 00 02 02 02 02 02 26 00 00 00 00 00 00 00 00 00 02 02
 02 00 00 00 00 00 00 00 00 00 00 00 00 00 00 00 00 00 00 00 02 02 02 41 00 00 00 00 00 00 00 32
 32 02 02 02 02 02 02 02 00 00 00 00 00 00 00 00 00 00 00 00 00 00 00 02 02 02 02 02 02 26 00 00
 00 00 00 00 00 00 31 02 02 02 02 02 02 02 00 32 00 00 00 00 00 00 00 00 00 00 00 00 00 02 00 00
 00 00 00 00 00 00 00 00 00 46 00 00 32 02 02 02 02 02 02 02 00 00 00 00 00 00 00 00 00 00 02 02
 02 02 02 02 00 00 00 00 00 00 00 00 00 00 00 00 00 00 00 32 02 02 02 02 02 00 00 00 00 00 00 00
 00 00 00 34 02 02 00 00 00 00 00 00 00 00 00 00 00 00 00 00 00 00 00 00 00 02 02 02 00 00 00 00
 00 00 00 00 00 34 02 02 02 02 02 02 00 00 00 00 00 00 00 00 00 00 00 00 00 00 00 00 02 02 02 00
 02 00 00 00 00 00 00 00 00 00 00 00 02 00 00 00 00 00 00 32 00 00 00 00 00 00 00 00 00 00 32 02
 00 02 00 00 00 00 00 00 00 00 00 00 00 02 02 02 02 02 02 02 02 02 02 02 02 02 02 00 00 00 00 00
 00 32 02 02 00 00 00 00 00 32 00 00 00 00 00 00 00 00 00 00 00 00 00 00 00 00 00 02 00 00 00 00
 00 00 00 00 02 02 02 02 02 02 00 00 00 00 00 00 00 00 00 00 00 00 00 00 00 00 00 00 02 02 00 00
 00 00 00 00 00 00 00 00 00 31 02 02 02 02 02 02 02 02 02 46 00 00 00 32 32 00 00 00 00 00 02 02
 02 02 26 00 00 00 00 00 00 00 00 00 00 00 00 00 15 00 00 02 02 02 02 02 02 00 00 00 00 00 00 00
 00 00 02 46 00 00 00 00 00 00 00 00 00 00 00 00 00 00 00 00 00 00 00 00 31 02 02 02 21 26 00 00
 00 00 00 02 02 02 02 02 02 02 02 02 02 02 02 00 00 00 00 00 00 00 00 00 00 00 00 35 02 00 00 00
 00 00 00 00 00 00 00 21 00 00 00 00 00 00 00 02 02 56 02 00 00 00 00 00 00 00 00 00 35 02 02 02
 02 02 00 00 00 00 00 00 00 00 00 00 00 00 00 00 00 02 62 02 02 02 02 02 02 00 00 00 00 00 00 00
 00 41 02 02 02 02 02 02 02 02 02 02 00 00 00 29 00 07 07 07 00 00 00 00 02 02 00 00 00 00 00 00
 00 00 00 00 00 00 00 00 00 00 28 29 02 02 02 00 00 00 00 00 00 00 00 00 00 02 62 02 02 02 02 00
 00 00 00 00 00 00 00 00 00 00 00 00 00 00 00 02 02 02 02 02 00 00 00 00 00 02 02 02 46 00 00 02
 02 02 02 02 02 00 00 00 00 00 00 00 00 00 00 00 00 00 00 51 02 02 02 00 00 00 00 00 00 00 00 00
 49 02 53 00 00 00 00 29 00 00 00 00 00 00 00 00 00 00 00 00 24 62 02 00 00 00 00 00 29 00 00 00
 02 02 02 02 02 02 02 02 02 02 02 02 02 02 02 02 02 02 02 02 02 02 02 02 02 02 02 02 02 02 02 02
