Gauntlet II
Maze number: 59
Offset for maze 58: 236117 - 0x039a55
big endian buf: [%!l(uint8=0) %!l(uint8=3) %!l(uint8=154) %!l(uint8=85)]
G:2 Maze real addr: 244309 - 0x03BA55, bank 1, boff: 0x2000
Maze read from: 0x03ba55 - 244309
compresssed: 250
 01 00 00 10 00 81 3F 52 5D 5A 41 2E 80 23 CB 23
 C3 3B A0 24 C1 23 51 31 01 10 F4 76 82 C3 A4 2E
 A1 E8 C1 23 71 83 E2 2E E3 C1 A3 03 E4 72 1A 51
 E3 EB 61 E2 70 E7 ED EF C3 A5 C1 28 C1 A1 CD 3E
 19 C2 19 3E E3 C1 29 E2 CB B2 A0 19 E9 C1 2A C1
 3B EC 2E A1 B3 A2 E4 D0 19 2F A0 C0 3E E3 C9 B2
 C1 B5 C6 3E A1 F0 C2 2E 08 E5 1D 62 C2 03 81 C5
 26 A0 C1 1E C1 08 C3 21 49 80 C0 2D C2 B3 31 E0
 C4 08 C2 21 A0 C2 A1 44 81 C4 A1 2E C1 1E C4 20
 09 C0 BF C1 1C 80 44 81 C6 A3 C3 20 09 F9 B2 07
 1F 09 DD 07 CB 31 B5 C1 B7 31 03 19 C4 1E CA A1
 C1 A3 C3 AA 48 C7 0F 48 4B D1 12 C9 21 C2 A5 C3
 A7 C4 1E C2 20 C8 31 C3 31 68 B3 C2 B6 1F FA 32
 A0 FD 53 D9 2E A0 E7 F4 3B 03 64 A0 1D C3 B5 C1
 B5 E6 E3 60 64 A0 C5 03 C1 03 E5 E3 55 BE 33 47
 80 C4 1C A0 3A 60 51 54 35 00
  Encoded length: 250 bytes
  Wall pattern: 01, Wall color: 15     Floor pattern: 08, Floor color: 03
  Flags: WALLS_DELETABLE1 
  Random food adds: 0
  Secret trick:  1 - Try Transportability (onto demon)
 02 02 02 02 02 02 02 02 02 02 02 02 02 02 02 02 02 02 02 02 02 02 02 02 02 02 02 02 02 02 02 02 02
 02 46 35 00 00 00 00 00 00 00 00 00 00 00 00 35 00 00 00 00 59 02 36 00 00 35 00 00 26 49 01 16 02
 02 00 00 00 00 00 00 00 00 00 00 00 00 00 00 00 00 00 00 00 00 02 00 00 00 00 00 00 00 01 01 01 02
 02 00 00 00 00 02 02 02 02 02 46 02 02 00 00 00 00 00 00 00 00 00 02 00 00 35 00 00 01 01 01 01 02
 02 00 00 00 02 46 00 00 00 00 02 00 00 02 02 02 02 03 00 00 00 00 00 02 00 00 00 01 26 00 00 26 02
 02 00 00 00 02 00 00 00 00 00 00 00 00 00 00 00 00 02 00 00 29 00 00 00 02 00 01 00 00 00 00 00 02
 02 00 00 02 00 00 00 00 00 00 00 00 00 00 00 00 00 00 02 00 00 00 00 00 00 02 00 00 00 00 00 00 02
 02 00 02 02 00 00 00 02 02 02 02 02 02 02 00 00 40 00 00 02 02 00 00 00 00 02 00 00 00 00 00 00 02
 02 00 02 62 25 00 00 02 25 62 00 00 00 00 02 00 00 41 00 00 00 02 00 00 00 02 00 00 00 00 00 00 02
 02 00 02 02 25 00 00 02 00 00 00 00 00 00 00 02 00 00 42 00 00 59 02 00 00 02 00 00 00 00 00 00 02
 02 00 00 02 46 02 02 02 02 02 02 00 00 00 00 00 02 00 00 00 00 00 02 00 00 02 00 00 00 00 00 00 02
 02 00 25 47 02 00 62 00 00 00 00 02 00 00 00 00 00 02 00 00 00 00 02 00 00 02 00 00 00 00 00 00 02
 02 62 02 02 00 00 00 00 00 00 00 00 02 00 00 00 00 02 00 00 00 02 00 00 00 46 08 00 00 00 00 00 02
 02 02 29 00 00 00 29 00 00 00 03 03 02 00 00 00 00 02 00 38 02 00 00 30 00 00 08 00 00 00 00 33 02
 02 00 00 00 00 00 00 00 00 02 18 18 02 45 00 00 00 02 49 00 02 00 00 00 00 00 08 00 00 00 33 02 02
 02 00 00 02 02 00 00 00 00 02 18 18 02 00 00 00 00 00 02 02 46 00 00 30 00 02 00 00 00 32 09 00 02
 02 00 00 28 28 00 00 00 00 02 18 18 02 00 00 00 00 00 00 00 02 02 02 02 00 02 00 00 32 09 00 00 02
 02 00 00 00 00 00 00 00 00 02 00 00 02 00 00 00 00 00 00 00 00 00 00 00 02 02 07 31 09 00 00 00 02
 02 00 00 00 00 00 00 00 00 02 00 00 02 00 00 00 00 00 00 00 00 00 00 00 00 00 00 07 02 00 00 00 02
 02 00 00 00 00 00 00 00 49 02 00 00 02 49 03 25 00 00 00 00 00 30 00 00 00 00 00 00 02 00 00 00 02
 02 02 02 00 00 02 02 02 02 00 00 00 00 02 02 02 02 02 02 02 02 02 02 02 00 00 00 00 02 00 00 00 02
 02 18 00 00 00 00 00 00 00 00 15 00 00 00 00 00 00 00 00 00 18 00 00 00 02 00 00 00 02 00 00 00 02
 02 18 00 00 00 00 00 00 00 00 00 00 00 00 00 00 00 00 00 00 18 00 00 00 02 00 00 00 02 00 00 33 02
 02 00 00 02 02 02 02 02 02 00 00 00 00 02 02 02 02 02 02 02 02 00 00 00 02 00 30 00 02 00 32 00 02
 02 00 00 00 00 00 00 00 49 02 00 00 02 49 00 00 00 00 00 00 00 00 00 29 02 00 00 00 02 31 00 00 02
 02 00 00 00 00 00 00 00 00 02 00 00 02 00 00 00 00 00 00 00 00 00 00 00 00 02 50 02 00 00 00 00 02
 02 00 00 00 00 00 00 00 00 02 00 00 02 00 00 00 00 00 00 00 00 00 00 00 00 00 02 00 00 00 00 26 02
 02 00 00 00 00 00 00 00 00 02 00 00 02 00 00 00 00 00 00 00 00 00 00 00 00 00 46 02 00 00 00 00 02
 02 00 00 00 02 00 00 00 00 02 00 00 02 00 00 00 00 00 00 00 00 00 00 00 00 00 02 59 03 00 00 00 02
 02 00 29 02 29 00 00 00 00 02 00 00 02 00 00 00 00 00 00 00 02 00 00 00 00 02 00 29 00 00 00 00 02
 02 29 02 00 00 00 00 00 00 03 00 00 03 00 00 00 00 00 00 02 00 00 00 00 02 00 00 00 00 00 00 26 02
 02 51 00 00 00 00 00 00 00 00 18 18 00 00 00 00 00 28 02 58 00 29 00 00 26 00 00 00 00 00 26 53 02
 02 02 02 02 02 02 02 02 02 02 02 02 02 02 02 02 02 02 02 02 02 02 02 02 02 02 02 02 02 02 02 02 02
