Gauntlet II
Maze number: 87
Offset for maze 86: 236598 - 0x039c36
big endian buf: [%!l(uint8=0) %!l(uint8=3) %!l(uint8=156) %!l(uint8=54)]
G:2 Maze real addr: 252982 - 0x03DC36, bank 2, boff: 0x4000
Maze read from: 0x03dc36 - 252982
compresssed: 317
 03 00 00 00 00 51 04 AE 48 0E 9C 18 80 44 07 31
 0A E5 15 A0 3A E1 C1 23 C2 23 40 32 C5 07 0A E6
 15 A0 63 07 C6 75 07 1D E7 C1 52 62 C4 23 C7 01
 07 82 35 C6 A1 62 07 D0 07 E5 E1 62 C4 1D C3 A3
 C0 1E C1 07 E3 C2 25 A0 62 C1 32 E4 35 1F E1 C7
 3B A4 C4 A4 2E A0 E0 E3 C1 7C 0B C0 3A 81 E1 E2
 C3 A2 B2 C0 1F CA B2 C2 0F D3 05 82 C2 22 CF 51
 C6 15 82 E8 E0 E0 C3 A5 B5 C2 15 82 C6 A1 E0 E0
 1F E2 33 0C E0 15 C4 15 82 C6 28 E0 2A A0 E0 35
 E0 14 A0 2A A0 10 A0 B2 C3 A3 E2 0D 80 A1 C0 2E
 A0 2A A0 C0 A1 35 A0 C2 A1 C3 B5 18 31 43 22 C1
 BF C2 31 A0 C1 2A A0 C3 A1 E3 C4 1F 81 CE 28 C0
 35 E0 28 A1 CF 2A D0 B2 CC A1 E2 C7 B2 E3 3E CA
 1F E0 C0 28 A1 40 B3 E4 E3 CD A1 C1 A1 19 C9 1E
 C0 3E 22 DC BC A1 BD A0 C4 B4 A0 CC A4 EF E2 C2
 A2 C2 31 C6 51 E7 C8 1F C0 2A C3 78 2E 18 E1 C4
 70 35 B2 C1 B2 E2 B3 C3 0D 80 C0 2E 35 A4 71 A1
 B2 A2 E6 38 C0 44 A2 2F 20 E1 37 A0 C2 22 A0 C9
 B2 A1 B3 C2 2F E6 39 C1 51 D1 B4 C2 09 80 E6 D3
 1D BE 10 A0 E7 C3 19 2E B2 40 A0 C9 00
  Encoded length: 317 bytes
  Wall pattern: 01, Wall color: 04     Floor pattern: 05, Floor color: 00
  Flags: 
  Random food adds: 0
  Secret trick:  3 - Try Transportability (into exit)
 02 02 02 02 02 02 02 02 02 02 02 02 02 02 02 02 02 02 02 02 02 02 02 02 02 02 02 02 02 02 02 02 02
 02 24 46 00 00 00 00 00 07 49 10 00 00 00 00 00 00 02 21 02 58 14 00 02 00 00 35 00 00 00 35 46 02
 02 50 00 00 00 00 00 00 07 10 00 00 00 00 00 00 00 02 21 02 00 14 00 00 08 07 00 00 00 00 00 00 02
 02 28 00 00 00 00 00 00 07 29 00 00 00 00 00 00 00 00 02 00 00 14 00 00 00 08 00 00 00 00 00 35 02
 02 00 00 00 00 00 00 00 01 07 07 07 07 53 00 00 00 00 00 00 00 02 02 00 00 00 08 07 00 00 00 00 02
 02 00 00 00 00 00 00 00 00 00 00 00 00 07 00 00 00 00 00 00 02 00 00 02 00 00 00 08 00 00 00 00 02
 02 29 00 00 00 00 02 02 02 02 00 30 00 00 07 00 00 00 00 02 00 00 00 37 02 00 00 00 08 00 00 50 02
 02 00 00 00 00 02 53 31 00 00 02 00 00 00 00 02 00 00 02 59 02 02 02 02 02 00 00 00 00 02 02 02 02
 02 02 02 46 02 00 02 00 00 00 00 02 00 00 28 02 00 00 02 00 00 00 00 00 00 00 00 00 11 02 58 58 02
 02 00 00 02 00 00 00 02 00 00 00 00 02 02 02 02 00 31 02 00 00 00 00 00 00 00 00 00 02 02 00 00 02
 02 15 00 00 00 00 00 00 00 00 00 00 00 00 14 00 00 00 02 00 00 02 05 05 05 02 00 00 02 34 00 00 02
 02 00 00 00 00 00 00 00 00 00 00 00 00 00 14 00 00 00 02 00 00 02 21 21 21 02 00 00 02 00 00 00 02
 02 00 00 02 00 02 00 02 00 00 00 00 02 02 02 02 02 02 02 00 00 02 21 21 21 02 00 00 02 00 00 00 02
 02 02 02 00 02 00 02 31 00 00 00 02 51 12 00 02 21 02 00 00 00 02 21 21 21 02 00 00 02 00 00 00 02
 02 40 00 02 42 02 00 02 53 00 02 20 02 42 02 16 02 02 00 00 00 02 02 02 02 02 00 00 02 02 13 13 02
 02 02 00 46 02 42 02 00 02 02 53 02 00 00 00 02 02 00 00 00 00 02 24 49 46 02 00 00 02 34 00 00 02
 02 00 00 00 49 02 00 00 42 02 00 00 00 00 02 02 00 00 00 00 02 00 02 00 00 02 31 31 02 00 00 00 02
 02 00 00 00 00 00 00 00 00 00 00 00 40 02 53 00 02 40 02 02 00 00 02 00 00 02 00 00 02 00 00 00 02
 02 00 00 00 42 00 00 00 00 00 00 00 00 02 00 00 00 00 02 00 00 00 02 00 00 02 00 00 02 00 00 00 02
 02 00 00 02 02 02 00 00 00 02 00 00 00 02 00 00 00 00 02 00 00 00 00 02 62 02 00 00 02 00 00 00 02
 02 00 00 02 31 00 02 00 40 02 02 46 00 02 00 00 00 00 00 02 00 00 00 00 02 02 00 00 02 00 00 00 02
 02 00 00 02 00 00 00 02 02 00 00 02 02 25 00 00 00 00 00 00 00 00 00 00 30 02 62 34 02 00 00 00 02
 02 00 00 02 00 00 00 00 00 00 00 00 00 00 00 00 00 00 00 00 00 00 00 00 00 02 02 02 02 02 00 00 02
 02 00 00 02 02 00 00 00 00 00 00 00 00 00 00 00 00 00 02 02 02 02 02 00 00 00 00 00 00 14 00 00 02
 02 00 00 00 00 00 00 02 00 00 00 02 00 00 02 02 02 02 00 00 00 49 02 00 00 00 00 00 00 14 00 00 02
 02 00 00 00 00 00 02 00 00 00 02 00 00 00 02 00 31 02 42 00 00 00 02 28 00 00 02 00 00 02 00 00 02
 02 46 24 00 00 02 00 00 00 00 02 28 00 53 02 00 00 02 00 00 00 02 02 02 00 00 02 13 13 02 46 53 02
 02 02 02 02 02 28 00 00 02 02 02 02 02 02 00 00 00 00 00 00 00 02 56 02 46 00 02 00 00 02 02 02 02
 02 47 32 00 00 02 55 02 00 00 14 34 02 00 00 00 00 00 00 00 00 00 00 02 02 02 02 00 00 02 47 00 02
 02 00 00 00 00 00 02 57 00 00 14 00 00 00 00 00 00 00 02 00 00 00 00 00 00 00 00 00 00 02 00 00 02
 02 09 09 00 00 00 00 00 00 00 02 00 00 00 00 00 00 00 02 00 00 00 00 00 00 00 00 00 00 00 00 29 02
 02 16 02 00 00 00 00 00 00 00 00 02 00 00 00 00 25 46 02 46 00 02 00 00 00 00 00 00 00 00 00 00 02
 02 02 02 02 02 02 02 02 02 02 02 02 02 02 02 02 02 02 02 02 02 02 02 02 02 02 02 02 02 02 02 02 02
