Gauntlet II
Maze number: 28
Offset for maze 27: 235901 - 0x03997d
big endian buf: [%!l(uint8=0) %!l(uint8=3) %!l(uint8=153) %!l(uint8=125)]
G:2 Maze real addr: 235901 - 0x03997D, bank 0, boff: 0x0000
Maze read from: 0x03997d - 235901
compresssed: 267
 07 00 00 00 20 80 C0 9D 9C 09 62 C1 0C 80 A0 3A
 81 A0 2E 78 A0 C2 05 80 C4 29 E2 C0 25 C0 0B 80
 C9 35 A0 E2 15 A0 E6 7E A0 C1 A4 E5 6E A0 E1 E4
 31 C1 28 A3 C7 A3 04 A0 E1 25 C0 3A C3 A3 C1 45
 B2 E5 C3 A3 C8 31 C6 A2 E3 ED C5 31 C1 40 26 A0
 C2 1D 05 C4 B3 E3 1D A0 E0 C3 B8 A3 B2 E1 C2 1D
 A4 E3 E0 C3 20 C9 1F EB 4E A0 C4 A3 E3 CF 08 C0
 A1 B2 E9 CF 08 71 C0 A3 CD B4 C8 A1 74 75 F2 D1
 A2 BA 1C A1 C6 A1 C4 B4 EB 62 A0 CB 25 E9 C5 27
 E0 C2 A1 78 B5 0D 81 A2 32 C3 31 E1 C3 15 80 A0
 C3 B3 A3 E2 63 2E 33 C1 B4 A0 C4 A1 EB 63 B3 A1
 B3 4F E3 D7 0F E4 D2 49 A0 C6 AB 56 A3 B7 E4 C0
 A5 04 10 C1 25 C3 32 E8 2E 35 2E A0 C5 2E 1D A0
 CC A1 E3 18 A0 C6 A2 E5 C5 31 E5 C1 25 C5 35 C9
 B4 D3 35 C1 B5 C4 A1 C6 34 C9 0A C7 45 62 B3 18
 C6 07 81 32 07 80 A1 43 B3 C0 41 60 B4 2F C0 05
 80 B4 2E C3 1C A0 18 83 B2 C0 00
  Encoded length: 267 bytes
  Wall pattern: 00, Wall color: 00     Floor pattern: 08, Floor color: 12
  Flags: WRAP_H 
  Random food adds: 0
  Secret trick:  7 - Save Super Shots
 02 02 02 02 02 02 02 02 02 02 02 02 02 02 02 02 02 02 02 02 02 02 02 02 02 02 02 02 02 02 02 02
 00 00 12 12 02 58 02 58 02 46 00 00 00 00 00 00 00 00 00 34 02 00 00 00 05 05 00 00 00 00 00 41
 00 00 00 02 00 37 02 11 11 00 00 00 00 00 00 00 00 00 00 53 02 00 00 00 02 21 02 00 00 00 00 00
 00 00 02 00 00 00 02 00 00 00 00 00 00 00 00 00 00 00 34 02 00 00 02 02 02 02 02 00 00 00 00 00
 00 02 28 00 00 00 02 00 00 02 00 00 00 00 00 00 00 00 02 00 00 02 00 00 00 00 00 02 49 00 00 40
 02 02 02 02 00 00 02 00 00 02 00 00 02 02 02 02 04 02 00 00 02 37 00 58 02 00 00 00 02 02 02 02
 00 00 29 00 02 00 02 00 00 02 00 00 00 00 00 00 02 00 00 00 00 02 02 02 02 00 00 00 00 00 00 00
 00 00 49 00 02 00 02 00 00 00 02 02 02 00 00 00 00 02 00 00 00 00 00 00 02 00 00 00 00 00 00 00
 02 00 00 00 02 00 02 49 00 00 29 02 38 02 00 00 00 29 05 00 00 00 00 00 02 00 00 00 00 02 29 02
 00 02 00 00 02 00 02 02 02 02 02 02 00 00 02 00 00 00 29 02 02 02 02 02 00 00 00 00 02 00 02 00
 00 00 02 32 02 00 00 00 00 00 00 00 00 00 31 02 00 00 00 00 00 00 00 00 00 00 00 02 29 00 00 00
 00 00 02 00 02 00 00 00 00 00 00 00 02 00 00 02 00 00 02 02 02 02 00 00 00 00 02 00 00 00 00 00
 00 00 02 00 02 00 00 00 00 00 00 08 00 02 02 02 00 00 00 00 00 00 02 00 00 00 02 00 00 00 00 00
 00 00 02 00 02 00 00 00 00 00 00 08 00 00 34 00 02 02 02 02 00 00 02 00 00 02 00 00 00 00 00 00
 00 00 02 00 02 00 00 00 00 00 00 00 02 02 00 00 00 00 00 34 00 00 02 00 00 02 34 00 00 00 00 00
 00 00 00 00 02 00 00 00 00 00 00 00 00 00 02 00 00 00 00 00 00 00 02 00 00 02 00 00 00 00 00 00
 00 02 02 02 02 28 02 02 00 00 00 00 00 00 00 02 02 00 00 00 02 00 02 00 00 02 00 00 00 00 00 00
 00 00 00 02 28 00 02 00 02 00 00 00 00 00 00 00 00 02 00 00 02 37 00 00 00 02 00 00 00 00 00 00
 02 02 00 00 02 00 02 39 00 02 00 00 09 02 02 00 00 02 00 00 02 00 00 00 34 02 13 13 13 02 02 02
 50 02 00 00 02 49 02 00 02 00 00 00 09 21 21 02 00 02 00 00 02 02 02 02 02 00 00 00 02 28 00 00
 00 02 46 51 02 00 02 02 00 00 00 00 09 02 02 00 00 02 00 00 00 00 00 00 00 00 00 02 28 00 00 00
 00 02 02 02 02 29 00 00 00 00 00 00 09 00 00 00 00 02 00 00 00 00 00 00 00 00 02 00 00 00 00 00
 00 00 00 00 00 00 00 00 00 00 00 00 09 00 00 00 00 02 00 15 00 00 00 00 00 02 00 00 00 00 00 00
 00 00 00 00 00 00 00 00 00 00 00 00 09 29 00 00 00 02 00 00 00 00 00 00 02 00 00 00 00 00 00 00
 02 02 02 02 02 02 02 02 02 02 02 02 09 02 02 02 02 02 00 00 00 00 00 02 00 02 02 02 02 02 02 04
 16 02 00 37 00 00 00 00 50 02 00 00 00 00 00 00 00 00 02 46 53 46 02 00 00 00 00 00 00 46 29 02
 00 02 00 00 00 00 00 00 00 02 00 00 00 02 02 00 00 00 00 02 24 02 00 00 00 00 00 00 00 02 02 02
 00 02 00 00 00 00 02 00 00 02 00 00 02 49 00 02 00 02 00 00 02 00 00 37 00 00 00 00 00 00 53 00
 00 02 00 00 00 02 00 00 00 02 00 00 02 00 00 02 00 02 00 00 00 00 00 00 00 00 00 00 00 00 53 00
 00 02 00 00 00 02 00 02 02 00 00 00 02 00 00 02 52 02 00 00 00 00 00 00 00 00 00 10 00 00 02 00
 00 00 00 00 29 02 00 00 00 00 00 28 02 00 00 02 24 02 00 00 00 00 00 00 07 07 07 50 07 07 02 02
 29 00 00 00 00 02 00 29 00 00 28 00 02 47 00 05 05 02 46 00 00 00 00 28 02 24 24 24 24 24 02 00
 02 02 02 02 02 02 02 02 02 02 02 02 02 02 02 02 02 02 02 02 02 02 02 02 02 02 02 02 02 02 02 02
