Gauntlet II
Maze number: 96
Offset for maze 95: 231067 - 0x03869b
big endian buf: [%!l(uint8=0) %!l(uint8=3) %!l(uint8=134) %!l(uint8=155)]
G:2 Maze real addr: 255643 - 0x03E69B, bank 3, boff: 0x6000
Maze read from: 0x03e69b - 255643
compresssed: 235
 02 00 00 00 29 2C C0 6E 5D 5C 81 C0 33 C1 1A 81
 47 81 0B 80 1A 81 E4 2E D7 22 E4 53 C2 76 23 CD
 0E 47 61 7F C1 0E D1 0A 63 C6 0E D1 0A 45 C0 03
 5A C7 3E A2 CD 03 C4 77 09 10 CF 0D A3 C4 72 18
 80 40 C8 A2 0D 80 42 C8 B2 A1 B9 E8 35 40 D1 31
 56 C1 31 CC 20 CB A5 B6 D9 35 C8 22 C1 B5 F1 B2
 C4 1F E5 2E C2 74 21 B5 A0 0D 80 C0 31 1D 58 18
 E2 60 D6 AF A5 E9 2E C4 1E CB 31 EB 31 D2 25 CA
 A4 05 A1 C7 1F 6D A0 1C E4 51 F3 0E 61 E1 04 EF
 C6 0E 43 0C F4 41 A0 E2 35 0C 69 E8 E2 E0 C1 2A
 A1 B2 C0 1F D2 1D E0 E1 C3 0E C9 2F 40 C8 0D 05
 C0 0F C0 AF BF A7 0D 80 C0 05 E0 43 C0 35 C0 0E
 C8 05 C0 19 E7 C6 B2 C1 0E E8 C0 19 C7 14 A0 67
 A5 50 E0 C0 05 A4 50 C0 35 2E 14 A0 25 45 A0 32
 18 E5 1D C1 35 04 15 A0 1F C1 00
  Encoded length: 235 bytes
  Wall pattern: 12, Wall color: 00     Floor pattern: 02, Floor color: 12
  Flags: TRAPS_RANDOM SHOTS_STUN WRAP_H 
  Random food adds: 0
  Secret trick:  2 - Try Transportability (onto death)
 02 02 02 02 02 02 02 02 02 02 02 02 02 02 02 02 02 02 02 02 02 02 02 02 02 02 02 02 02 02 02 02
 00 51 00 00 26 26 26 00 00 00 00 00 00 00 00 46 02 46 11 11 26 26 26 00 00 00 00 00 02 46 00 00
 00 00 00 00 00 00 00 00 00 00 00 00 00 00 00 00 02 00 00 00 00 00 34 00 00 00 00 00 02 00 00 00
 00 28 00 00 00 01 00 00 00 00 00 00 00 35 00 00 02 00 00 00 00 00 00 00 00 00 00 00 14 00 00 00
 00 00 00 00 00 46 00 00 29 01 00 00 00 00 00 00 02 00 00 00 00 00 00 00 00 00 00 00 14 00 00 00
 00 00 00 00 00 00 00 00 00 00 00 00 00 00 00 10 02 00 00 00 29 00 00 00 00 00 00 00 14 00 00 00
 00 00 00 00 00 00 00 00 00 00 00 00 00 00 00 10 02 00 00 00 00 00 46 00 03 00 00 00 02 00 00 00
 00 00 00 00 28 00 00 00 00 00 00 00 00 62 02 02 02 00 00 00 00 00 00 00 00 00 00 00 02 00 00 03
 00 00 00 00 00 01 00 00 00 00 00 00 00 02 09 16 02 00 00 00 00 00 00 00 00 00 00 00 02 00 00 00
 13 02 02 02 02 00 00 00 00 00 01 00 00 02 24 24 02 46 00 00 00 00 00 00 00 00 00 02 02 02 13 13
 00 00 00 46 02 00 00 00 00 00 00 00 00 02 02 02 02 02 00 00 00 00 00 00 00 00 02 53 02 46 00 00
 00 00 00 00 02 00 00 00 00 00 00 00 00 00 00 00 49 02 00 00 00 00 00 00 28 00 00 49 02 00 00 00
 00 00 00 00 02 00 00 00 00 32 00 00 00 00 00 00 00 02 00 00 00 02 02 02 02 02 02 02 02 00 00 00
 00 00 00 00 02 00 00 00 00 00 00 00 00 00 00 00 00 02 00 00 00 02 00 53 02 00 00 00 00 00 00 00
 00 34 00 00 02 00 00 00 00 00 00 00 00 00 00 00 00 02 00 00 00 02 00 02 02 00 00 00 00 00 31 00
 00 00 00 00 00 02 46 00 00 00 01 00 00 00 00 00 33 02 02 13 13 02 49 29 00 00 00 00 00 00 00 00
 00 28 24 00 00 00 02 00 29 00 00 00 00 00 00 00 00 00 00 00 00 02 00 00 00 00 00 00 00 00 00 00
 02 02 02 02 02 02 02 02 02 02 02 02 02 02 02 02 02 02 02 02 02 02 00 00 00 00 00 00 00 00 00 00
 02 46 00 00 00 00 00 30 00 00 00 00 00 00 00 00 00 00 00 00 49 02 00 00 00 00 00 00 00 00 00 00
 00 02 49 00 00 00 00 00 00 00 00 00 00 00 00 00 00 00 00 00 00 02 37 00 00 00 00 00 00 00 00 00
 00 00 02 02 02 02 02 05 02 02 00 00 00 00 00 00 00 00 31 00 00 02 00 00 00 00 00 00 00 00 00 00
 00 29 02 28 00 00 00 00 00 02 00 00 28 00 00 00 00 00 00 00 00 02 00 00 00 00 00 00 00 00 00 00
 00 02 14 00 00 29 00 00 02 04 00 00 00 00 00 00 00 00 00 00 00 02 00 00 00 00 02 00 00 00 00 00
 00 00 14 00 00 00 00 46 12 02 00 00 00 00 00 00 00 00 00 00 00 02 00 00 00 00 00 00 00 00 02 00
 00 46 02 00 00 00 02 53 12 02 00 00 00 00 00 00 00 00 00 29 00 02 00 00 00 00 00 00 00 02 00 00
 00 02 00 02 00 00 42 02 02 02 00 31 00 00 00 00 00 00 00 00 00 02 00 00 00 00 00 00 00 00 00 29
 00 02 00 00 02 00 00 00 00 14 00 00 00 00 00 00 00 00 00 00 47 02 46 00 00 00 00 00 00 00 00 00
 13 05 00 15 00 02 02 02 02 02 02 02 02 02 02 02 02 02 02 02 02 02 02 02 02 02 02 02 02 02 13 13
 00 05 00 02 00 00 00 00 46 02 53 00 14 00 00 00 00 00 00 00 00 00 05 00 25 00 00 00 00 00 00 00
 00 02 00 00 00 00 00 00 00 02 00 00 14 00 00 00 00 00 00 00 00 00 02 00 25 00 00 00 00 00 00 00
 00 20 02 00 00 00 00 00 00 00 00 29 02 02 02 02 02 02 00 28 00 02 00 05 02 02 02 02 02 00 28 00
 53 46 20 02 37 00 00 00 00 00 00 46 02 50 24 00 00 00 00 00 00 02 29 00 00 53 04 21 02 31 00 00
 02 02 02 02 02 02 02 02 02 02 02 02 02 02 02 02 02 02 02 02 02 02 02 02 02 02 02 02 02 02 02 02
