Gauntlet II
Maze number: 35
Offset for maze 34: 229554 - 0x0380b2
big endian buf: [%!l(uint8=0) %!l(uint8=3) %!l(uint8=128) %!l(uint8=178)]
G:2 Maze real addr: 237746 - 0x03A0B2, bank 1, boff: 0x2000
Maze read from: 0x03a0b2 - 237746
compresssed: 333
 05 00 00 00 00 33 06 6E 45 09 5E 38 80 C4 0E 35
 C1 20 C1 38 60 2E 05 CA 0A 35 C6 0E 68 2E 05 CA
 35 C4 1C C0 A5 1C E3 15 A1 07 81 A0 07 81 A0 07
 81 C3 1C 31 A0 0E E2 CB 31 C2 31 42 80 C0 A2 C0
 0E 71 E0 D9 0E 71 E0 2E D1 1E 81 C0 24 C1 0E C7
 22 C0 B3 F3 C8 07 1D 70 72 72 45 81 36 A0 35 C2
 0F C4 07 D3 05 0D 80 A0 B3 A1 B9 C4 A6 6C C0 0E
 35 41 44 C4 0E 42 C3 20 C0 20 C7 A4 B2 A0 0D 84
 A4 CF 32 EA 1E 2E 43 82 47 18 2E 47 A0 C5 B9 C1
 35 72 45 E3 E3 1E C2 BF 22 80 60 C1 B6 D0 2E A0
 45 80 05 E1 C7 25 E8 1E C5 A1 E1 1C C0 1D C0 31
 C2 B6 05 80 A7 C7 31 1D E1 C3 18 E1 EA C6 A3 C0
 A2 B8 A0 B8 A0 E5 C0 A1 44 B3 C2 33 18 60 C9 A1
 B3 C2 2A C0 A5 C3 A1 C0 A4 C3 25 70 70 A0 CD 0B
 80 09 2E C5 A2 B2 C4 B2 E2 1C A0 1C A0 1C A4 C0
 A4 65 D0 05 C6 35 C0 18 E0 E6 C1 A4 0C 80 C2 A7
 B2 32 A0 C3 B3 C2 1C 41 31 E7 2A A0 C7 27 C4 53
 E0 C5 09 83 C0 0E A0 CD 09 C1 1C C0 B3 C9 0E C7
 B2 A0 C1 54 24 A0 E2 C0 0C C4 18 82 C0 0E 63 A0
 05 42 60 08 05 24 C3 0C C4 18 05 80 BE C0 0E 42
 A0 33 A0 E4 31 A0 C8 54 C0 18 05 10 00
  Encoded length: 333 bytes
  Wall pattern: 03, Wall color: 06     Floor pattern: 03, Floor color: 00
  Flags: 
  Random food adds: 0
  Secret trick:  5 - Watch What You Shoot (shoot foods)
 02 02 02 02 02 02 02 02 02 02 02 02 02 02 02 02 02 02 02 02 02 02 02 02 02 02 02 02 02 02 02 02
 02 56 00 00 00 00 00 14 53 00 00 32 00 00 56 02 05 46 05 00 00 00 00 00 00 00 00 00 00 00 10 53
 02 00 00 00 00 00 00 14 00 00 00 00 00 00 00 02 00 05 46 05 00 00 00 00 00 00 00 00 00 00 00 53
 02 00 00 00 00 28 00 02 02 02 02 02 02 28 00 02 00 00 02 21 02 02 07 07 07 02 07 07 07 02 07 07
 02 00 00 00 00 28 49 02 14 00 00 00 02 00 00 02 00 00 00 02 00 00 00 00 00 49 00 00 00 49 00 00
 02 46 46 00 02 02 02 00 14 00 00 30 00 02 00 02 00 00 00 02 00 00 00 00 00 00 00 00 00 00 00 00
 02 00 00 02 00 00 00 00 14 00 00 30 00 02 46 02 00 00 00 02 00 00 00 00 00 00 00 00 00 00 00 00
 02 30 30 02 00 36 00 00 14 00 00 00 02 00 00 02 00 34 00 02 00 00 00 00 00 00 00 00 00 00 00 00
 02 00 00 02 00 00 00 00 02 00 00 00 02 00 00 02 00 00 07 29 00 30 00 00 00 30 00 00 00 30 00 00
 02 00 00 02 46 46 46 54 02 53 00 00 02 15 00 02 00 00 00 07 00 00 00 00 00 00 00 00 00 00 00 00
 02 00 00 02 00 00 00 02 05 13 13 02 02 02 02 02 00 00 00 00 02 02 02 02 02 02 02 02 00 00 00 00
 02 00 00 02 00 00 00 02 00 05 00 14 53 00 00 46 00 00 00 00 02 46 00 00 00 00 00 14 00 00 00 46
 02 00 00 02 32 00 32 02 00 02 00 02 00 00 02 02 02 02 02 02 02 02 13 13 13 13 13 13 02 02 02 02
 02 00 00 02 00 00 00 02 00 02 00 02 00 00 02 00 00 50 00 00 00 00 00 00 00 00 00 00 00 02 30 46
 02 00 00 02 46 46 46 02 00 02 00 02 00 00 02 00 46 24 46 00 00 00 00 00 00 00 00 46 02 00 00 00
 02 00 00 02 00 00 53 02 00 02 30 02 00 00 02 00 00 46 00 00 00 00 02 00 00 00 00 02 30 00 00 00
 02 34 34 00 05 00 00 02 00 02 00 02 00 00 02 00 00 00 00 00 00 00 00 00 00 46 02 00 00 00 00 00
 02 46 46 05 00 00 02 00 00 02 00 02 00 00 02 37 00 00 00 00 00 00 00 00 00 02 30 00 00 02 00 00
 02 02 02 00 00 02 28 00 29 02 49 02 00 00 02 05 05 02 02 02 02 02 02 02 02 00 00 00 00 02 00 00
 02 49 29 00 00 02 00 00 00 02 24 02 00 02 00 00 00 02 00 00 00 00 00 00 00 02 00 00 00 02 00 00
 02 02 02 02 02 00 02 02 02 02 02 02 02 00 00 00 00 02 00 02 00 02 02 00 00 00 00 00 46 02 00 00
 02 51 24 00 05 00 00 00 00 00 00 00 00 00 02 02 02 02 00 00 02 42 00 02 02 02 02 02 02 00 00 00
 02 02 02 00 02 02 02 02 02 00 00 00 00 37 02 30 00 30 02 00 02 00 00 00 00 00 00 00 00 00 00 00
 02 11 11 09 46 00 00 00 00 00 00 02 02 02 02 00 00 02 00 00 02 00 00 00 02 28 02 28 02 28 02 02
 02 02 02 00 02 02 02 02 02 00 02 00 00 00 00 05 00 02 00 09 00 00 00 00 00 00 00 00 00 00 00 00
 02 05 00 00 00 00 00 00 00 53 02 24 00 02 00 09 00 02 00 09 00 02 00 02 02 02 02 02 02 12 12 00
 02 00 02 02 02 02 02 02 02 02 02 50 02 00 00 09 00 02 00 09 00 28 00 02 46 49 00 00 00 00 00 00
 02 00 02 42 02 00 00 00 00 00 00 02 00 39 00 09 00 00 00 09 00 02 00 02 00 00 00 09 09 09 09 09
 02 00 14 02 00 00 00 00 00 00 00 02 00 00 00 09 00 00 09 00 00 28 00 02 00 00 00 09 00 00 00 00
 02 00 14 00 00 00 00 00 00 00 00 02 02 00 00 09 36 02 00 00 00 02 00 12 00 00 00 09 00 24 24 24
 02 00 14 00 00 00 00 05 02 05 00 00 00 46 00 05 08 05 36 00 00 00 00 12 00 00 00 09 00 24 05 05
 02 00 14 00 00 00 46 02 51 02 00 00 00 00 00 02 49 02 00 00 00 00 00 00 00 00 00 09 00 24 05 16
 02 02 02 02 02 02 02 02 02 02 02 02 02 02 02 02 02 02 02 02 02 02 02 02 02 02 02 02 02 02 02 02
