Gauntlet II
Maze number: 81
Offset for maze 80: 234604 - 0x03946c
big endian buf: [%!l(uint8=0) %!l(uint8=3) %!l(uint8=148) %!l(uint8=108)]
G:2 Maze real addr: 250988 - 0x03D46C, bank 2, boff: 0x4000
Maze read from: 0x03d46c - 250988
compresssed: 395
 02 00 00 00 26 62 32 49 85 7F 47 CB 2F A0 18 E0
 51 56 E5 C0 27 0B E0 50 80 A1 EA E8 E2 22 E4 E4
 2F 15 07 E1 2E E1 08 80 18 A0 C0 A1 CD 1C A0 71
 0A E0 71 18 10 18 EC 77 74 18 2E C4 A3 3F 80 C0
 A1 15 C1 B2 CC 08 C0 A1 C0 2E A0 C7 A2 C2 A5 50
 51 C3 A1 C1 A3 E7 2E 3B 54 51 46 C3 A1 05 80 E1
 E0 C0 A3 E0 C4 A2 C1 61 61 A0 35 E1 E1 E1 CA 0B
 C0 1C 61 05 2E 24 C1 A1 E0 E3 3E 18 C4 1E 48 76
 3F 53 C0 A1 C0 A1 49 80 52 80 07 81 C3 A1 E1 4C
 C0 2E 07 80 C2 3B CA A1 E0 B5 C2 B3 42 E9 E8 C3
 B4 0C C4 37 C5 2E C4 27 A1 19 E1 C0 A1 E3 32 41
 80 B2 05 80 3F 80 A1 B3 09 81 08 E0 E3 E1 05 80
 09 E1 B6 CE 08 C0 08 C1 0B E7 C3 A2 C1 22 C0 05
 0A A0 E0 C2 08 C1 19 C3 1E C2 2E A3 E2 C4 31 C2
 A2 C1 36 C8 35 E3 3E A0 E2 E3 C3 B3 05 80 A0 C3
 0C 62 A0 09 C0 0C C2 A1 15 A0 C0 B2 C0 0C 32 3F
 A1 05 2E 80 61 07 A0 C0 2E C0 3E C2 A1 E0 E6 C5
 A1 C0 A1 C0 60 A0 B3 1E B2 C6 05 20 E4 CA 60 0A
 E4 C1 A1 C0 08 81 E0 2E 07 05 3F 09 80 C1 28 40
 40 C3 A1 E0 C0 05 A0 C3 08 C0 0C E0 33 A1 2F 2E
 A0 41 41 E2 CA 08 28 61 A0 32 08 A1 41 E9 41 E2
 C1 08 C0 A1 1F C3 A1 C6 2E 0C E0 33 05 A0 2E 60
 35 A0 0B C0 0C 18 0B C4 67 B2 05 0E C0 0E 0C 19
 E0 0D 80 A0 C7 B2 A1 72 82 C2 0F 0E 35 0E C4 3E
 31 E1 C4 0A E3 2E 19 81 07 C1 00
  Encoded length: 395 bytes
  Wall pattern: 02, Wall color: 02     Floor pattern: 06, Floor color: 03
  Flags: TRAPS_LOCAL SHOTS_HURT WRAP_H 
  Random food adds: 0
  Secret trick:  2 - Try Transportability (onto death)
 02 02 02 02 02 02 02 02 02 02 02 02 02 02 02 02 02 02 02 02 02 02 02 02 02 02 02 02 02 02 02 02
 00 00 00 00 00 00 00 00 00 00 00 00 47 02 24 00 02 00 00 63 00 00 00 00 00 00 00 63 00 00 00 00
 00 00 02 00 39 11 00 02 00 63 63 02 02 00 00 00 00 00 00 00 00 00 00 00 02 00 00 00 00 00 00 00
 00 00 02 00 00 00 02 34 00 00 00 00 00 02 00 00 00 00 00 02 47 21 07 00 00 02 46 00 00 02 08 08
 24 02 00 02 02 00 00 00 00 00 00 00 00 00 00 00 00 02 00 28 02 00 00 07 10 00 02 00 00 07 24 16
 24 00 00 00 00 00 00 00 00 00 00 00 00 00 02 00 00 02 00 00 00 00 00 07 00 00 00 00 00 07 24 46
 00 00 00 00 00 02 02 02 02 63 63 00 02 02 21 00 00 02 00 00 00 00 00 00 00 00 00 00 00 00 00 08
 00 02 02 00 46 02 00 00 00 00 00 00 00 00 02 02 02 00 00 00 02 02 02 02 02 02 00 63 00 00 63 00
 00 00 00 02 02 00 00 02 02 02 02 00 00 00 00 00 00 00 00 02 46 59 00 00 00 00 00 63 00 00 63 00
 00 00 00 00 00 00 09 00 00 00 00 02 02 05 05 00 00 02 00 02 00 02 02 02 02 00 02 00 00 02 00 00
 02 02 02 00 00 05 00 00 05 00 00 02 53 00 00 02 00 00 02 00 00 02 00 00 00 00 00 00 00 02 00 00
 00 11 00 28 05 00 00 05 46 36 00 00 02 02 00 02 00 00 00 00 02 62 24 00 00 00 00 00 30 02 00 02
 00 02 00 02 00 00 09 00 00 00 00 00 00 00 07 63 00 00 00 00 63 00 02 02 00 02 02 00 00 02 00 02
 00 02 00 02 00 09 09 00 00 00 63 63 07 07 07 00 00 00 00 02 02 00 00 02 00 00 00 00 00 02 00 02
 00 02 00 02 00 09 00 46 07 07 00 00 00 59 02 00 00 00 00 00 00 00 00 00 00 02 02 00 02 02 00 02
 00 02 00 02 00 09 00 02 00 00 00 00 00 00 02 00 02 00 00 00 00 00 00 00 00 00 02 00 00 00 00 02
 12 00 00 02 00 00 55 02 00 00 00 00 00 46 02 00 00 00 00 39 02 02 25 00 00 02 00 02 02 00 00 00
 00 02 50 02 00 09 09 02 05 05 63 63 02 02 02 09 09 09 08 00 02 00 00 00 00 02 00 00 02 05 05 09
 00 00 02 02 00 00 00 00 00 00 00 00 00 00 00 00 00 00 00 08 00 08 00 02 11 00 00 00 00 00 00 00
 00 02 00 00 00 00 02 02 02 00 00 34 00 05 10 02 00 02 00 00 00 08 00 02 25 00 00 00 00 30 00 00
 00 46 02 02 02 02 00 00 00 02 00 00 00 00 00 49 02 00 00 02 02 02 00 02 54 00 00 00 00 00 00 00
 00 02 53 00 00 00 00 02 62 02 00 00 00 02 00 00 02 00 02 00 00 00 00 02 05 05 02 00 00 00 00 12
 05 02 00 02 02 09 00 12 00 00 00 02 02 21 02 00 02 00 12 50 63 02 02 05 46 46 05 00 00 07 02 00
 46 02 62 02 00 00 02 02 00 02 00 00 00 00 00 00 00 02 00 00 00 00 00 00 02 02 00 02 02 00 05 00
 02 02 30 02 00 00 00 00 00 00 00 05 32 00 00 00 00 00 02 00 00 00 00 00 00 00 00 00 00 00 05 00
 10 00 00 00 00 00 02 00 00 02 02 00 08 08 08 00 02 46 07 05 63 09 09 00 00 40 00 09 00 09 00 00
 00 00 02 02 00 02 00 05 02 00 00 00 00 08 00 12 00 02 51 02 02 47 46 02 00 00 09 00 00 09 00 00
 00 02 00 00 00 00 00 00 00 00 00 00 00 08 40 05 00 00 02 50 08 02 02 00 00 09 00 00 00 00 00 02
 00 00 00 00 02 00 00 09 00 00 00 02 00 00 08 00 02 02 31 02 00 00 00 02 02 00 00 00 00 00 00 02
 46 12 00 02 51 05 02 46 05 00 53 02 11 00 12 24 11 00 00 02 00 00 05 00 00 00 00 00 00 00 00 02
 05 14 00 14 12 25 00 02 13 13 02 00 00 00 00 00 00 00 00 02 02 02 00 00 00 07 07 07 07 00 00 00
 15 14 53 14 00 00 00 00 00 62 49 00 00 02 00 00 00 00 00 10 00 00 00 00 02 46 25 25 25 07 00 00
 02 02 02 02 02 02 02 02 02 02 02 02 02 02 02 02 02 02 02 02 02 02 02 02 02 02 02 02 02 02 02 02
