Gauntlet II
Maze number: 114
Offset for maze 113: 236015 - 0x0399ef
big endian buf: [%!l(uint8=0) %!l(uint8=3) %!l(uint8=153) %!l(uint8=239)]
G:2 Maze real addr: 260591 - 0x03F9EF, bank 3, boff: 0x6000
Maze read from: 0x03f9ef - 260591
compresssed: 474
 06 00 00 80 00 61 95 6E 45 90 87 2E 80 10 A0 C3
 2F 05 2E C3 10 05 50 2E C4 50 2E 50 2E 52 A0 2E
 60 80 C0 A7 2E E2 2E 41 4B E1 2E 43 C4 A4 B2 C9
 B2 A0 10 A0 05 10 A3 45 43 69 2E A1 2E 05 A0 40
 C7 A4 42 C3 10 2E A0 40 70 05 2E C1 B2 C0 B4 C0
 B5 2E 41 41 A0 2E 35 A1 05 81 B5 A1 04 60 2E 05
 60 60 2E 05 2E 05 2E 05 C0 B2 C0 08 60 2E 04 A0
 B6 40 81 63 C0 70 A0 2E 07 0C 09 0A 08 0B 04 2E
 05 2E 07 2E 05 60 C3 10 A5 2E 09 2E 05 C0 09 60
 2E 05 2E 05 C0 08 2E 05 0B 09 0C 07 2E A5 53 05
 0A 05 4D 05 60 43 C2 A2 2E 07 2E 09 CC 09 2E 07
 2E A3 C3 10 2E 60 60 0B 6D 60 41 C4 A1 04 2E 08
 2E 72 05 85 C2 08 0A A0 2E 05 40 B2 52 35 61 0C
 64 64 42 05 0B 05 83 04 C1 B4 A2 2E 09 60 62 64
 C2 70 09 2E 05 42 BF 2E 63 2E 05 2E 62 C1 0F 61
 C2 0C 05 60 41 E2 E2 2E 07 0A 08 62 64 C2 09 2E
 08 2E A3 10 82 41 61 63 64 42 05 C0 71 2E B2 A0
 E4 2E 08 C0 09 62 85 C2 08 0A 07 2E 05 C2 2F 42
 61 0B 05 2E CC 0B 05 2E 05 41 A2 C0 B4 A2 2E 09
 C0 08 EC C0 09 C0 04 A2 50 2E 63 60 2E 4C 05 60
 43 A5 2E 07 0C 09 2E 05 60 2E 05 0C 05 0B 05 60
 2E 05 0C 07 2E A5 2E 63 60 C0 08 0A 70 09 C0 08
 C0 09 2E A0 0A 09 E0 2E 73 2E C2 A1 04 2E A0 2E
 05 60 2E 05 C0 07 2E 05 C0 70 05 2E 05 C6 55 05
 2E A0 41 A0 E6 60 C0 04 41 A2 05 C0 50 2F C2 A1
 05 A1 04 2E 42 40 A0 60 C0 A4 50 2E A1 B3 A1 41
 60 35 2E A0 C2 B2 A1 05 04 60 2E 05 41 B2 C3 52
 2E 62 C1 50 2E C3 10 A0 60 E0 2E C2 35 62 A3 B3
 C1 A3 B2 05 80 A4 60 C0 A5 B4 C0 BE 55 2E A0 53
 2E A0 52 2E 05 10 05 54 2E 00
  Encoded length: 474 bytes
  Wall pattern: 01, Wall color: 05     Floor pattern: 06, Floor color: 09
  Flags: EXIT_CHOOSE_ONE 
  Random food adds: 0
  Secret trick:  6 - Watch What You Shoot (shoot secret walls)
 02 02 02 02 02 02 02 02 02 02 02 02 02 02 02 02 02 02 02 02 02 02 02 02 02 02 02 02 02 02 02 02 02
 02 46 16 02 00 00 00 00 47 05 46 00 00 00 00 16 05 16 02 46 00 00 00 00 00 16 02 46 16 02 46 16 02
 02 00 02 02 46 02 05 05 00 02 02 02 02 02 02 02 02 46 02 00 00 02 46 00 00 46 02 00 00 02 00 00 02
 02 00 02 00 00 02 46 00 00 02 46 00 00 00 00 46 02 00 02 00 00 02 02 02 02 02 02 00 00 02 00 00 02
 02 00 02 00 00 02 02 16 02 05 16 02 02 02 02 00 02 00 02 00 00 46 00 00 00 00 46 00 00 02 00 00 02
 02 00 02 00 00 05 46 02 02 46 05 02 00 46 02 00 02 00 02 00 00 02 02 02 02 02 02 00 00 02 46 00 02
 02 00 02 16 46 02 00 46 07 00 05 46 00 00 02 00 02 00 02 46 00 02 46 00 00 46 02 46 53 02 02 05 02
 02 05 02 02 02 04 00 05 46 05 00 05 00 05 46 05 46 05 46 05 00 02 00 08 00 05 46 04 02 02 00 46 02
 02 46 00 00 00 00 05 00 07 00 02 46 07 12 09 10 08 11 04 46 05 46 07 46 05 00 05 00 00 00 00 16 02
 02 02 02 02 02 02 46 09 46 05 00 09 00 05 46 05 46 05 00 08 46 05 11 09 12 07 46 02 02 02 02 02 02
 02 16 00 00 00 00 05 10 05 00 00 00 00 00 00 00 00 00 00 00 00 00 00 46 05 00 05 00 00 00 00 46 02
 02 00 02 02 02 02 46 07 46 09 00 00 00 00 00 00 00 00 00 00 00 00 00 09 46 07 46 02 02 02 02 00 02
 02 00 02 16 46 00 05 00 05 11 00 00 00 00 00 00 00 00 00 00 00 00 00 00 05 00 05 00 00 46 02 00 02
 02 00 02 02 02 04 46 08 46 07 00 00 00 05 05 05 05 05 05 05 00 00 00 08 10 02 46 05 00 46 02 16 02
 02 00 02 53 00 00 05 12 00 00 00 00 00 05 00 00 00 00 00 05 00 00 00 46 05 11 05 05 05 05 05 04 02
 02 00 02 02 02 02 46 09 00 05 00 00 00 05 00 00 00 00 00 05 00 00 00 07 00 09 46 05 00 00 00 46 02
 02 46 00 00 00 00 05 46 05 46 00 00 00 05 00 00 15 00 00 05 00 00 00 12 05 00 05 00 00 46 02 00 02
 02 02 02 00 00 02 46 07 10 08 00 00 00 05 00 00 00 00 00 05 00 00 00 09 46 08 46 02 02 02 02 16 02
 02 16 02 00 00 46 00 00 05 00 00 00 00 05 00 00 00 00 00 05 00 00 00 46 05 00 07 00 00 46 02 02 02
 02 00 02 00 00 02 46 08 00 09 00 00 00 05 05 05 05 05 05 05 00 00 00 08 10 07 46 05 00 00 00 47 02
 02 00 02 46 00 00 05 11 05 46 00 00 00 00 00 00 00 00 00 00 00 00 00 11 05 46 05 00 00 46 02 02 02
 02 00 02 02 02 02 46 09 00 08 00 00 00 00 00 00 00 00 00 00 00 00 00 02 00 09 00 04 02 02 02 16 02
 02 46 00 00 00 00 05 00 05 46 00 00 00 00 00 00 00 00 00 00 00 00 00 46 05 00 05 00 00 00 00 46 02
 02 02 02 02 02 02 46 07 12 09 46 05 00 05 46 05 12 05 11 05 00 05 46 05 12 07 46 02 02 02 02 02 02
 02 46 00 00 00 00 05 00 05 00 08 10 07 00 09 00 08 00 09 46 02 10 09 00 02 46 07 00 00 00 00 46 02
 02 00 02 02 02 04 46 02 46 05 00 05 46 05 00 07 46 05 00 07 00 05 46 05 00 00 00 00 00 00 00 16 02
 02 00 02 00 00 00 05 46 02 00 00 46 02 00 00 00 02 00 00 00 02 00 05 00 04 00 00 46 02 02 02 05 02
 02 16 02 47 00 00 02 02 02 05 02 02 04 46 00 00 02 46 00 46 02 00 05 00 02 02 02 02 02 16 02 46 02
 02 02 02 02 02 00 02 46 00 05 53 46 02 02 00 00 02 02 02 05 04 00 05 46 05 00 00 46 02 00 02 00 02
 02 16 00 00 00 46 02 00 00 05 00 00 16 02 46 00 00 00 00 16 02 00 05 00 02 46 00 00 00 53 02 00 02
 02 05 02 02 02 02 02 00 00 02 02 02 02 02 05 05 02 02 02 02 02 00 05 00 02 02 02 02 02 02 02 00 02
 02 16 00 00 00 00 00 00 46 02 16 00 00 00 00 46 02 16 00 00 00 46 05 16 05 16 00 00 00 00 00 46 02
 02 02 02 02 02 02 02 02 02 02 02 02 02 02 02 02 02 02 02 02 02 02 02 02 02 02 02 02 02 02 02 02 02
