Gauntlet II
Maze number: 51
Offset for maze 50: 234123 - 0x03928b
big endian buf: [%!l(uint8=0) %!l(uint8=3) %!l(uint8=146) %!l(uint8=139)]
G:2 Maze real addr: 242315 - 0x03B28B, bank 1, boff: 0x2000
Maze read from: 0x03b28b - 242315
compresssed: 244
 10 00 00 00 20 64 69 06 43 3F 99 18 C1 0A CA 18
 C0 32 42 0A 3F 81 44 0E 35 C2 0A 3C CB 44 C2 44
 0E C3 A5 C7 44 C2 45 C3 33 A4 76 40 1D 42 C2 40
 20 43 D0 B4 44 C2 44 B2 DF DF C9 75 52 CC 52 D1
 44 C2 45 C3 7C 44 C2 45 C2 BA CD 44 C2 44 B2 C0
 2E 80 3F C8 75 1B 41 C2 44 3F 2E E1 CC B4 C2 41
 C2 43 35 A0 E2 CC 07 C2 41 C2 40 23 41 A1 C2 20
 C0 18 C9 0F 07 0F C1 41 C2 42 32 C0 2F C0 10 C0
 0B AA 07 80 04 07 80 A2 3F 81 A4 0B C2 2F C0 2E
 C9 0F 07 0F C9 32 C0 1D E2 B4 CB 07 62 C7 B4 A0
 E2 25 C3 1D A4 64 1B C1 24 C4 35 A0 C0 2E 80 3F
 E4 C2 0A 64 60 C8 3F 2E E7 CB A1 D1 05 C1 29 C0
 1F E5 0A D1 1B A0 C1 B4 D8 1A C1 32 A1 35 CE 29
 C4 23 C2 1A 80 DF C0 2E DF DF D6 B8 CD 26 C4 21
 C5 B8 C2 0E DA 0E C0 18 C0 0E C2 23 C7 20 BC 32
 CB 0E 35 00
  Encoded length: 244 bytes
  Wall pattern: 04, Wall color: 09     Floor pattern: 06, Floor color: 06
  Flags: WRAP_H 
  Random food adds: 0
  Secret trick: 16 - IT Could Be Nice
 02 02 02 02 02 02 02 02 02 02 02 02 02 02 02 02 02 02 02 02 02 02 02 02 02 02 02 02 02 02 02 02
 24 00 02 10 00 00 00 00 00 00 00 00 00 00 00 24 02 50 06 06 06 10 63 63 63 06 06 06 06 06 14 53
 00 00 02 10 60 00 00 00 00 00 00 00 00 00 00 00 02 06 06 06 06 06 00 00 00 06 06 06 06 06 14 00
 00 00 02 02 02 02 02 02 02 00 00 00 00 00 00 00 02 06 06 06 06 06 00 00 00 06 06 06 06 06 02 00
 00 00 02 51 02 02 02 02 02 25 00 00 00 00 00 00 02 06 29 06 06 06 00 00 00 06 32 06 06 06 02 00
 00 00 02 00 00 00 00 00 00 00 00 00 00 00 00 00 02 06 06 06 06 06 00 00 00 06 06 06 06 06 02 00
 00 00 02 00 00 00 00 00 00 00 00 00 00 00 00 00 63 00 00 00 00 00 00 00 00 00 00 00 00 00 63 00
 00 00 02 00 00 00 00 00 00 00 00 00 00 00 00 00 63 00 00 00 00 00 00 00 00 00 00 00 00 00 63 00
 00 00 02 00 00 00 00 00 00 25 00 00 00 00 00 00 63 00 00 00 00 00 00 00 00 00 00 00 00 00 63 00
 00 00 02 00 00 00 00 00 00 00 00 00 00 00 00 00 02 06 06 06 06 06 00 00 00 06 06 06 06 06 02 00
 00 00 02 25 00 00 00 00 00 00 00 00 00 00 00 00 02 06 06 06 06 06 00 00 00 06 06 06 06 06 02 00
 00 00 02 00 00 00 00 00 00 00 00 00 00 00 00 00 02 06 06 06 06 06 00 00 00 06 06 06 06 06 02 00
 46 46 63 00 00 00 00 00 00 00 00 00 25 00 00 00 02 00 00 27 06 06 00 00 00 06 06 06 06 06 63 46
 00 00 02 00 00 00 00 00 00 00 00 00 00 00 00 00 02 00 00 00 06 06 00 00 00 06 06 06 06 53 02 00
 00 00 02 02 00 00 00 00 00 00 00 00 00 00 00 00 07 00 00 00 06 06 00 00 00 06 35 06 06 02 02 00
 00 00 32 02 24 00 00 00 00 00 00 00 00 00 00 15 07 15 00 00 06 06 00 00 00 06 06 06 50 02 47 00
 16 00 11 02 02 02 02 02 02 02 02 02 02 02 07 07 04 07 07 02 02 02 63 63 63 02 02 02 02 02 11 00
 00 00 47 02 46 00 00 00 00 00 00 00 00 00 00 15 07 15 00 00 00 00 00 00 00 00 00 00 50 02 29 00
 00 00 02 02 00 00 00 00 00 00 00 00 00 00 00 00 07 00 00 00 03 00 00 00 00 00 00 00 00 02 02 00
 00 00 02 37 00 00 00 00 29 02 02 02 02 02 00 00 02 00 00 03 27 00 00 36 00 00 00 00 00 53 02 00
 46 46 63 00 00 00 00 00 02 00 00 00 10 02 00 00 02 00 03 00 03 00 00 00 00 00 00 00 00 00 63 46
 00 00 02 00 00 00 00 00 02 00 00 00 00 02 00 00 02 00 00 00 00 02 02 00 00 00 00 00 00 00 02 00
 00 00 02 00 00 00 00 00 00 05 00 00 41 02 31 00 02 00 00 00 00 02 10 00 00 00 00 00 00 00 02 00
 00 00 02 00 00 00 00 00 00 27 02 00 00 02 00 00 02 00 00 00 00 00 00 00 00 00 00 00 00 00 02 00
 00 00 02 00 00 00 00 26 00 00 50 02 02 53 00 00 02 00 00 00 00 00 00 00 00 00 00 00 00 41 02 00
 00 00 02 35 00 00 00 26 26 00 00 00 00 00 00 00 02 00 00 00 00 00 00 00 00 00 00 00 00 00 02 00
 00 00 02 00 00 00 00 00 00 00 46 00 00 00 00 00 02 00 00 00 00 00 00 00 00 00 00 00 00 00 02 00
 00 00 02 00 00 00 00 00 00 00 00 00 00 00 00 00 02 00 00 00 00 00 00 00 00 00 00 00 00 00 02 00
 00 00 02 00 00 00 00 00 00 00 00 00 00 00 00 00 02 00 00 00 00 00 00 00 00 00 00 00 00 00 02 00
 00 00 02 00 00 00 00 00 00 00 00 00 00 00 00 00 02 38 00 00 00 00 00 33 00 00 00 00 00 00 02 00
 00 00 14 00 00 00 00 00 00 00 00 00 00 00 00 00 02 00 00 00 00 00 00 00 00 00 00 00 00 00 14 00
 24 00 14 00 00 00 35 00 00 00 00 00 00 00 00 32 02 50 00 00 00 00 00 00 00 00 00 00 00 00 14 53
 02 02 02 02 02 02 02 02 02 02 02 02 02 02 02 02 02 02 02 02 02 02 02 02 02 02 02 02 02 02 02 02
