Gauntlet II
Maze number: 12
Offset for maze 11: 231806 - 0x03897e
big endian buf: [%!l(uint8=0) %!l(uint8=3) %!l(uint8=137) %!l(uint8=126)]
G:2 Maze real addr: 231806 - 0x03897E, bank 0, boff: 0x0000
Maze read from: 0x03897e - 231806
compresssed: 248
 05 00 00 80 00 71 6E 5C 9D 0E AE 10 80 C0 31 C1
 70 1C C5 A1 74 1F C2 31 C1 10 47 E5 35 E0 45 C7
 73 2C E5 61 1D A0 74 6A 65 A0 E5 C5 20 C2 74 65
 A0 E7 74 64 31 C0 2C C2 0D 81 A0 C0 03 E7 0D 82
 C1 64 1C D9 1F 42 DB 1C C6 53 C2 A4 0D 80 A5 C1
 53 EB CD 35 E2 79 A0 45 45 E5 E8 68 A2 E8 75 A0
 C9 51 35 EB E4 C5 B5 C1 0D 80 A0 C1 51 0D C2 B5
 E5 31 A2 E9 C1 0F CD A1 BF A0 C6 51 E1 C5 B2 C1
 51 E6 BF 2E 80 A0 C8 0D 80 A0 E1 0D 80 C7 1D A0
 C0 04 E2 C9 0E 35 EB C5 2E A0 67 A2 51 E8 E8 45
 45 E5 EA C2 35 ED CE B5 A4 0D 80 A4 B5 C9 28 DB
 1C 42 C2 52 D5 1C C2 70 61 0D 82 A0 C0 03 E7 0D
 81 53 C1 60 31 C4 29 E5 C6 1D A0 C5 68 65 A0 E5
 C5 23 CA 64 2E A0 62 A0 C5 63 71 31 C4 28 E5 C0
 35 A0 45 C7 10 72 31 40 C4 2E A1 45 C0 31 C1 70
 10 80 BE AC 04 AF BD 00
  Encoded length: 248 bytes
  Wall pattern: 01, Wall color: 14     Floor pattern: 07, Floor color: 06
  Flags: EXIT_CHOOSE_ONE 
  Random food adds: 0
  Secret trick:  5 - Watch What You Shoot (shoot foods)
 02 02 02 02 02 02 02 02 02 02 02 02 02 02 02 02 02 02 02 02 02 02 02 02 02 02 02 02 02 02 02 02 02
 02 16 00 49 00 00 46 00 28 00 00 00 00 00 00 02 02 46 00 00 00 00 00 31 00 00 00 49 00 00 16 02 02
 02 00 00 00 00 00 00 28 00 00 00 00 00 00 02 53 00 02 00 00 00 00 00 00 28 00 00 00 00 00 00 02 02
 02 46 00 00 00 00 44 00 00 00 00 00 00 02 29 00 00 29 02 46 00 00 00 00 00 29 00 00 00 00 00 02 02
 02 00 00 00 00 29 00 00 00 00 00 00 02 00 00 00 00 00 00 02 00 00 00 00 00 00 32 00 00 00 46 02 02
 02 00 00 00 29 00 00 00 00 00 00 02 00 00 00 00 00 00 00 00 02 46 00 00 00 00 00 29 00 00 00 02 02
 02 49 00 44 00 00 14 13 13 13 02 00 03 00 00 00 00 00 00 00 00 02 13 13 13 14 00 00 29 00 00 02 02
 02 00 28 00 00 00 14 00 00 00 00 00 00 00 00 00 00 00 00 00 00 00 00 00 00 14 00 00 00 31 00 02 02
 02 28 00 00 00 00 14 00 00 00 00 00 00 00 00 00 00 00 00 00 00 00 00 00 00 14 00 00 00 00 28 02 02
 02 00 00 00 00 00 14 00 00 02 02 02 02 02 02 13 13 02 02 02 02 02 02 00 00 14 00 00 00 00 00 02 02
 02 00 00 00 00 00 02 00 00 02 00 00 00 00 00 00 00 00 00 00 00 53 02 00 00 02 46 00 00 00 00 02 02
 02 00 00 00 00 02 00 00 00 02 00 00 28 00 00 00 00 00 00 28 00 00 02 00 00 00 02 00 00 00 00 02 02
 02 00 00 00 02 29 00 00 00 02 00 00 00 00 14 02 02 02 00 00 00 00 02 00 00 00 00 02 46 00 00 02 02
 02 00 00 02 00 00 00 00 00 02 00 00 00 00 14 53 00 14 00 00 00 00 02 00 00 00 00 00 02 00 00 02 02
 02 00 02 00 00 00 00 00 00 02 00 00 13 13 02 00 00 14 13 02 00 00 02 00 00 00 00 00 00 02 49 02 02
 02 02 00 00 00 00 00 00 00 14 00 00 02 00 00 15 00 00 00 02 00 00 14 00 00 00 00 00 00 00 02 02 02
 02 02 00 00 00 00 00 00 00 14 00 00 02 00 00 00 00 00 00 02 00 00 14 00 00 00 00 00 00 00 02 02 02
 02 46 02 00 00 00 00 00 00 02 00 00 13 13 02 00 00 02 13 13 00 00 02 00 00 00 00 00 29 02 00 04 02
 02 00 00 02 00 00 00 00 00 02 00 00 00 00 14 53 00 14 00 00 00 00 02 00 00 00 00 00 02 00 00 02 02
 02 00 00 46 02 29 00 00 00 02 00 00 00 00 02 02 02 14 00 00 00 00 02 00 00 00 00 02 00 00 00 02 02
 02 00 00 00 00 02 00 00 00 02 00 00 28 00 00 00 00 00 00 28 00 00 02 00 00 00 02 00 00 00 00 02 02
 02 00 00 00 00 00 02 00 00 02 53 00 00 00 00 00 00 00 00 00 00 00 02 00 00 02 00 00 00 00 00 02 02
 02 00 00 00 00 00 14 00 00 02 02 02 02 02 02 13 13 02 02 02 02 02 02 00 00 14 00 00 00 00 00 02 02
 02 40 00 00 00 00 14 00 00 00 00 00 00 00 00 00 00 00 00 00 00 00 00 00 00 14 00 00 00 00 28 02 02
 02 00 28 00 00 00 14 00 00 00 00 00 00 00 00 00 00 00 00 00 00 00 00 00 00 14 00 00 00 28 00 02 02
 02 46 00 29 00 00 13 13 13 13 02 00 03 00 00 00 00 00 00 00 00 02 13 13 13 14 00 00 29 00 49 02 02
 02 00 00 00 41 00 00 00 00 00 00 02 00 00 00 00 00 00 00 29 02 00 00 00 00 00 00 29 00 00 00 02 02
 02 00 00 00 00 29 00 00 00 00 00 00 02 00 00 00 00 00 00 02 00 00 00 00 00 00 35 00 00 00 00 02 02
 02 00 00 00 00 00 29 00 00 00 00 00 46 02 29 00 00 00 02 00 00 00 00 00 00 29 00 00 00 00 46 02 02
 02 49 00 00 00 00 00 40 00 00 00 00 00 00 02 00 53 02 00 00 00 00 00 00 28 00 00 00 00 00 00 02 02
 02 16 46 00 00 00 49 00 28 00 00 00 00 00 46 02 02 00 00 00 00 00 00 28 00 49 00 00 46 00 16 02 02
 02 02 02 02 02 02 02 02 02 02 02 02 02 02 04 02 02 02 02 02 02 02 02 02 02 02 02 02 02 02 02 02 02
 02 02 02 02 02 02 02 02 02 02 02 02 02 02 02 02 02 02 02 02 02 02 02 02 02 02 02 02 02 02 02 02 02
