Gauntlet II
Maze number: 46
Offset for maze 45: 232812 - 0x038d6c
big endian buf: [%!l(uint8=0) %!l(uint8=3) %!l(uint8=141) %!l(uint8=108)]
G:2 Maze real addr: 241004 - 0x03AD6C, bank 1, boff: 0x2000
Maze read from: 0x03ad6c - 241004
compresssed: 205
 0E 00 00 02 22 11 9A 6E 52 0E 5D E2 60 D3 14 E0
 C1 20 E4 C9 0F E8 E7 60 D3 14 E0 E7 F3 C4 20 E1
 60 D3 14 E0 E7 F3 E7 60 D3 14 E0 E7 F3 E7 60 D3
 14 C0 04 C0 20 E5 F3 47 60 C7 19 83 C6 14 40 C2
 33 A0 E0 E0 E0 E0 E0 E0 E0 E0 E0 E0 E0 E0 E0 E0
 E0 FF E0 E0 E0 E0 E0 E0 E0 E0 E0 E0 C0 04 E0 E0
 E0 E0 DF 71 E1 35 61 82 1D 12 82 74 C2 35 A0 70
 C1 0D 9E CC 35 DF DF DF DF D1 1D 73 C0 35 71 C4
 1E 41 C1 1E 73 DF C5 23 40 C1 20 41 C1 20 41 C1
 21 41 C0 20 40 C1 20 40 DF 0D 9E DF C0 0D 82 C6
 0D 82 CC 0D C3 19 81 41 81 C2 1E 44 43 80 C2 18
 C2 51 31 19 52 C0 19 2E 18 2E C0 19 51 C0 31 52
 19 40 18 2E C2 1E 80 C1 52 10 52 19 00
  Encoded length: 205 bytes
  Wall pattern: 01, Wall color: 10     Floor pattern: 01, Floor color: 09
  Flags: WRAP_H SHOTS_HURT 
  Random food adds: 2
  Secret trick: 14 - Go On a Diet (no food)
 02 02 02 02 02 02 02 02 02 02 02 02 02 02 02 02 02 02 02 02 02 02 02 02 02 02 02 02 02 02 02 02
 00 00 00 02 00 18 00 00 00 00 00 00 00 00 00 00 00 00 00 00 00 00 00 00 00 00 20 00 02 00 00 32
 00 00 00 00 00 02 00 00 00 00 00 00 00 00 00 00 15 00 00 00 00 00 00 00 00 00 02 00 00 00 00 00
 00 00 00 02 00 18 00 00 00 00 00 00 00 00 00 00 00 00 00 00 00 00 00 00 00 00 20 00 02 00 00 00
 00 00 00 00 00 02 00 00 00 00 00 00 00 00 00 00 00 00 00 00 00 00 00 00 00 00 02 00 00 00 00 00
 32 00 00 02 00 18 00 00 00 00 00 00 00 00 00 00 00 00 00 00 00 00 00 00 00 00 20 00 02 00 00 00
 00 00 00 00 00 02 00 00 00 00 00 00 00 00 00 00 00 00 00 00 00 00 00 00 00 00 02 00 00 00 00 00
 00 00 00 02 00 18 00 00 00 00 00 00 00 00 00 00 00 00 00 00 00 00 00 00 00 00 20 00 02 00 00 00
 00 00 00 00 00 02 00 00 00 00 00 00 00 00 00 00 00 00 00 00 00 00 00 00 00 00 02 00 00 00 00 00
 00 00 00 02 00 18 00 00 00 00 00 00 00 00 00 00 00 00 00 00 00 00 00 00 00 00 20 00 04 00 32 00
 00 00 00 00 00 02 00 00 00 00 00 00 00 00 00 00 00 00 00 00 00 00 00 00 00 00 02 00 00 00 00 00
 00 00 00 46 00 18 00 00 00 00 00 00 00 00 25 25 25 25 25 00 00 00 00 00 00 00 20 00 46 00 00 00
 51 02 00 02 00 02 00 02 00 02 00 02 00 02 00 02 00 02 00 02 00 02 00 02 00 02 00 02 00 02 00 02
 00 00 00 00 00 00 00 00 00 00 00 00 00 00 00 00 00 00 00 00 00 00 00 00 00 00 00 00 00 00 00 00
 02 00 02 00 02 00 02 00 02 00 02 00 02 00 02 00 02 00 02 00 02 00 04 00 02 00 02 00 02 00 02 00
 00 00 00 00 00 00 00 00 00 00 00 00 00 00 00 00 00 00 00 00 00 00 00 00 00 00 00 00 00 00 00 00
 00 29 00 00 02 53 00 00 18 18 18 18 29 18 18 18 18 00 00 00 00 00 29 00 00 00 53 02 00 29 00 00
 13 13 13 13 13 13 13 13 13 13 13 13 13 13 13 13 13 13 13 13 13 13 13 13 13 13 13 13 13 13 13 13
 00 00 00 00 00 00 00 00 00 00 00 00 00 53 00 00 00 00 00 00 00 00 00 00 00 00 00 00 00 00 00 00
 00 00 00 00 00 00 00 00 00 00 00 00 00 00 00 00 00 00 00 00 00 00 00 00 00 00 00 00 00 00 00 00
 00 00 00 00 00 00 00 00 00 00 00 00 00 00 00 00 00 00 00 00 00 00 00 00 00 00 00 00 00 00 00 00
 00 00 00 00 00 00 00 00 00 00 00 00 00 00 00 00 00 00 00 00 00 00 00 00 00 00 00 00 00 00 00 00
 00 00 00 00 00 00 00 00 00 00 00 00 00 00 00 00 00 00 00 00 00 00 00 00 00 00 00 00 00 00 00 00
 29 00 00 00 00 29 00 53 00 00 29 00 00 00 00 00 30 00 00 46 00 00 30 00 00 00 00 29 00 00 00 00
 00 00 00 00 00 00 00 00 00 00 00 00 00 00 00 00 00 00 00 00 00 00 00 00 00 00 00 00 00 00 00 00
 00 00 35 00 46 00 00 32 00 00 46 00 00 32 00 00 46 00 00 33 00 00 46 00 32 00 46 00 00 32 00 46
 00 00 00 00 00 00 00 00 00 00 00 00 00 00 00 00 00 00 00 00 00 00 00 00 00 00 00 00 00 00 00 00
 13 13 13 13 13 13 13 13 13 13 13 13 13 13 13 13 13 13 13 13 13 13 13 13 13 13 13 13 13 13 13 13
 00 00 00 00 00 00 00 00 00 00 00 00 00 00 00 00 00 00 00 00 00 00 00 00 00 00 00 00 00 00 00 00
 00 13 13 13 14 00 00 00 00 00 00 00 13 13 13 14 00 00 00 00 00 00 00 00 00 00 00 00 14 13 14 00
 00 14 25 25 14 00 00 46 46 46 00 00 14 30 00 14 00 00 00 46 00 00 00 00 46 46 00 00 14 24 14 00
 00 14 49 25 14 00 25 46 24 46 00 25 14 00 49 14 25 00 46 24 46 00 00 00 30 30 00 00 14 16 14 25
 02 02 02 02 02 02 02 02 02 02 02 02 02 02 02 02 02 02 02 02 02 02 02 02 02 02 02 02 02 02 02 02
