Gauntlet II
Maze number: 85
Offset for maze 84: 236079 - 0x039a2f
big endian buf: [%!l(uint8=0) %!l(uint8=3) %!l(uint8=154) %!l(uint8=47)]
G:2 Maze real addr: 252463 - 0x03DA2F, bank 2, boff: 0x4000
Maze read from: 0x03da2f - 252463
compresssed: 274
 08 00 01 00 08 81 8F 41 55 07 99 10 80 08 1E 08
 1A 81 01 C4 0E C0 36 43 31 C0 35 1D C4 32 C0 09
 80 2F 08 74 01 C1 0E 44 C7 1D 1A 80 40 82 DF 40
 C9 1C CA 19 80 1D C0 3C C5 07 C6 1C 09 81 C2 B4
 48 82 C2 1E C7 09 24 09 C2 0E CE 52 07 52 C6 09
 81 C2 0E 43 C5 B5 B5 D7 01 44 45 43 48 7F C1 76
 01 4A C8 09 81 C0 08 81 C3 2E C9 2E 01 C1 32 C4
 09 23 80 C0 1D 80 2E C1 33 C0 35 C7 1A AF A6 B5
 0D 80 A6 31 C2 33 0A 71 01 C1 1F C0 33 1A C0 1E
 C6 1A C0 35 C1 1E C0 22 40 DB BF CD 2E DF 46 D0
 01 C1 3B 35 BF 43 C5 19 81 63 42 C1 18 CC 1A C7
 1A 60 80 D2 32 47 61 80 D5 36 C2 2E 63 80 01 42
 4C C3 07 81 41 61 80 CD 1D C6 1C 81 65 80 45 CD
 1C 81 66 80 D0 29 0C 53 1C 80 53 43 62 80 C5 0D
 80 AD 0D 67 80 C1 2E 80 C0 35 1A C4 1C C2 0B C3
 37 68 81 48 C5 18 C1 1D 45 62 C2 BA C2 74 1C D4
 0E CF 18 BE 0F C7 2E B6 70 0E 43 C5 1C 01 C1 32
 35 00
  Encoded length: 274 bytes
  Wall pattern: 01, Wall color: 15     Floor pattern: 08, Floor color: 08
  Flags: TRAPS_RANDOM FAST_GHOSTS 
  Random food adds: 0
  Secret trick:  8 - Don't Use Invulnerability
 02 02 02 02 02 02 02 02 02 02 02 02 02 02 02 02 02 02 02 02 02 02 02 02 02 02 02 02 02 02 02 02 02
 02 16 08 30 08 26 26 26 01 00 00 00 00 00 14 00 54 00 00 00 00 01 49 02 53 29 00 00 00 00 00 50 02
 02 09 09 47 08 25 00 00 00 00 00 01 00 00 14 00 00 00 00 00 01 00 00 02 00 00 00 00 00 29 26 26 02
 02 01 01 02 02 00 00 00 00 00 00 00 00 00 02 00 00 00 00 00 00 00 00 02 00 00 00 00 00 00 00 00 02
 02 00 00 02 02 00 01 00 00 00 00 00 00 00 02 00 00 28 00 00 00 00 00 02 00 00 00 00 00 25 25 29 02
 02 60 00 02 02 00 00 07 07 07 00 00 00 00 02 00 28 09 09 09 00 00 00 02 00 00 00 00 00 00 00 00 02
 02 01 01 02 02 00 00 07 30 07 00 00 00 00 02 00 00 09 36 09 00 00 00 14 00 00 00 00 00 00 00 00 02
 02 00 00 02 02 00 00 07 07 07 00 00 00 00 02 00 00 09 09 09 00 00 00 14 00 00 00 00 01 00 00 00 02
 02 00 00 02 02 00 00 00 00 00 00 00 00 00 02 00 00 00 00 00 00 00 00 02 00 00 00 00 00 01 00 00 02
 02 00 00 01 00 00 00 00 00 00 01 00 00 00 02 01 00 00 00 00 00 00 00 02 00 01 25 00 00 00 00 00 02
 02 00 00 00 00 00 00 00 00 00 00 00 00 25 02 00 00 00 00 00 00 01 00 02 00 00 00 00 00 00 00 00 02
 02 01 00 00 00 00 00 00 00 00 00 09 09 09 02 08 08 08 00 00 00 00 46 02 00 00 00 00 00 00 00 00 02
 02 46 01 00 00 50 00 00 00 00 00 09 35 35 02 29 29 46 00 00 51 00 53 02 00 00 00 00 00 00 00 26 02
 02 02 02 02 02 02 02 02 02 02 02 02 02 02 02 02 02 02 02 02 02 02 02 02 13 13 02 02 02 02 02 02 02
 02 49 00 00 00 51 10 25 00 00 01 00 00 31 02 51 26 00 30 00 00 00 00 00 00 00 26 00 53 00 00 30 02
 02 34 00 01 00 00 00 00 00 00 00 00 00 00 02 00 00 00 00 00 00 00 00 00 00 00 00 00 00 00 00 00 02
 02 00 00 00 00 00 00 00 00 00 00 00 00 00 02 46 00 00 00 00 00 00 00 00 00 00 00 00 00 00 00 00 02
 02 00 00 00 00 00 00 00 00 00 00 00 00 00 02 00 00 00 00 00 00 00 00 01 00 00 00 00 00 00 00 00 02
 02 00 00 00 00 00 00 00 00 01 00 00 59 53 02 00 00 00 00 01 00 00 00 00 00 00 25 25 25 00 00 00 02
 02 21 00 00 00 01 00 00 24 00 00 00 00 00 02 00 00 00 00 00 00 00 26 00 00 00 00 00 00 00 00 26 02
 02 21 21 00 00 00 00 00 00 00 00 00 00 00 02 00 00 00 00 00 00 00 50 00 00 00 00 00 00 00 00 01 02
 02 00 21 21 00 00 00 00 00 00 00 00 00 00 02 00 00 00 00 00 00 00 00 00 00 00 54 00 00 00 46 00 02
 02 00 00 21 21 01 00 00 00 01 00 00 00 00 02 00 00 00 00 00 00 00 00 01 00 00 00 07 07 07 07 00 02
 02 01 00 00 21 21 00 00 00 00 00 00 00 00 02 00 00 00 00 00 29 00 00 00 00 00 00 07 28 28 07 00 02
 02 00 00 00 00 21 21 00 00 00 00 00 00 01 02 00 00 00 00 00 00 00 00 00 00 00 00 07 28 28 07 00 02
 02 00 00 00 00 00 21 21 00 00 00 02 00 00 02 00 00 00 00 00 00 00 00 00 00 41 12 07 28 28 07 00 02
 02 00 00 01 00 00 00 21 21 00 00 02 00 00 02 13 13 02 02 02 02 02 02 02 02 02 02 02 02 02 02 13 02
 02 00 00 00 00 00 00 00 21 21 00 02 46 46 02 53 26 00 00 00 00 00 28 00 00 00 11 00 00 00 00 55 02
 02 00 00 00 00 00 00 00 00 21 21 02 00 00 02 00 00 00 00 00 00 01 00 00 00 00 00 00 24 00 00 29 02
 02 00 00 00 00 00 01 00 00 00 21 02 00 00 02 00 00 00 25 00 00 00 00 00 28 00 00 00 00 00 00 00 02
 02 00 00 00 00 00 00 00 00 00 00 02 00 00 14 00 00 00 00 00 00 00 00 00 00 00 00 00 00 00 00 24 02
 02 15 00 00 00 00 00 00 00 00 46 02 25 00 14 00 00 00 00 01 00 00 00 00 00 00 28 01 00 00 50 53 02
 02 02 02 02 02 02 02 02 02 02 02 02 02 02 02 02 02 02 02 02 02 02 02 02 02 02 02 02 02 02 02 02 02
