Gauntlet II
Maze number: 107
Offset for maze 106: 233601 - 0x039081
big endian buf: [%!l(uint8=0) %!l(uint8=3) %!l(uint8=144) %!l(uint8=129)]
G:2 Maze real addr: 258177 - 0x03F081, bank 3, boff: 0x6000
Maze read from: 0x03f081 - 258177
compresssed: 218
 06 00 00 40 00 61 95 6E 90 44 4F 10 81 41 82 4B
 81 40 A0 2E 80 C1 64 2E 81 C2 A5 C7 A5 C2 B2 C1
 A1 B2 43 81 E3 48 46 C3 A2 B2 C1 A1 2E A0 C1 B3
 E3 44 C1 B2 5D 46 E4 47 E7 41 C4 B2 43 CA A3 E1
 C9 B5 DF 79 45 76 C9 B2 C2 B4 CD B3 C1 B5 40 A2
 2E A1 DF 41 A0 44 81 C1 B2 42 4B E1 2E C1 A1 B5
 A1 B3 51 C1 B3 A3 C2 A3 C1 A3 D7 2E 83 47 C3 10
 81 CB B2 A0 BF C9 A1 04 A6 C1 A1 C1 A1 41 4A C2
 10 81 2E 81 43 DE A1 04 A1 46 81 DC 04 A0 D9 2E
 40 83 F3 2E 40 A3 B5 48 81 CA A4 77 C2 B4 A1 B9
 C1 B7 73 45 C6 B7 C1 B8 CA B5 DE 04 4B C8 A6 45
 C8 B2 C1 A3 40 45 C7 B2 46 DF CA A3 C4 B8 C9 A3
 C1 A2 04 ED 41 BE 60 B4 2E 81 43 80 A0 2E 40 A0
 2E 41 B3 2E 42 A0 2E B5 10 00
  Encoded length: 218 bytes
  Wall pattern: 01, Wall color: 05     Floor pattern: 06, Floor color: 09
  Flags: EXIT_MOVES 
  Random food adds: 0
  Secret trick:  6 - Watch What You Shoot (shoot secret walls)
 02 02 02 02 02 02 02 02 02 02 02 02 02 02 02 02 02 02 02 02 02 02 02 02 02 02 02 02 02 02 02 02 02
 02 16 02 00 00 46 46 02 46 00 00 00 00 00 00 00 00 00 00 00 00 46 02 46 00 46 02 46 46 00 00 16 02
 02 00 02 00 00 46 46 02 00 00 00 02 02 02 02 02 02 00 00 00 00 00 02 00 00 02 02 02 02 02 02 00 02
 02 00 02 00 02 02 02 02 00 00 00 00 46 02 46 00 00 00 00 02 00 00 02 00 00 00 00 00 00 46 02 00 02
 02 00 00 00 02 46 00 00 00 00 02 02 02 02 00 00 02 02 46 02 00 00 02 00 00 00 00 02 02 00 02 00 02
 02 46 00 00 02 00 00 00 00 00 00 00 00 00 00 00 00 00 00 04 00 00 00 00 00 02 00 46 02 00 02 00 02
 02 02 00 00 00 00 00 02 00 00 46 00 00 00 00 00 00 00 00 02 00 00 46 00 00 02 00 00 02 00 02 00 02
 02 46 00 00 00 00 00 02 00 00 00 00 00 02 02 02 02 00 00 02 00 00 02 00 00 02 00 00 00 00 02 00 02
 02 00 00 02 00 00 00 02 00 00 02 00 00 00 00 00 00 00 00 00 00 00 02 00 00 02 00 00 00 00 00 00 02
 02 00 00 02 00 00 00 02 00 15 02 00 00 00 00 00 46 00 00 00 00 00 02 00 15 02 00 00 00 00 00 00 02
 02 00 00 02 00 00 00 02 00 00 02 00 00 02 00 00 02 00 00 02 00 00 02 00 00 02 00 46 02 02 02 46 02
 02 02 00 00 00 00 00 00 00 00 02 00 00 02 00 00 02 00 00 02 00 00 00 00 00 00 00 00 00 00 00 00 02
 02 00 00 00 46 02 00 00 00 00 02 46 46 02 00 00 02 00 00 02 46 00 00 00 00 00 00 00 00 00 00 00 02
 02 46 00 00 02 46 00 00 02 02 02 02 02 02 00 00 04 00 00 02 02 02 02 02 00 00 00 02 02 02 02 00 02
 02 02 02 02 02 00 00 00 00 00 00 00 00 00 00 00 02 00 00 00 00 00 00 00 00 00 00 00 00 46 02 46 02
 02 46 00 00 00 00 00 00 00 00 46 00 00 00 00 16 02 16 00 00 00 00 00 00 00 00 00 00 00 00 02 02 02
 02 00 00 00 00 00 00 00 00 00 02 02 02 04 02 02 02 02 02 02 02 00 00 02 02 00 00 02 02 00 00 46 02
 02 00 00 00 02 00 00 02 00 00 02 46 00 00 00 16 02 16 46 02 46 00 00 00 00 46 00 00 00 00 00 00 02
 02 00 00 00 02 00 00 02 00 00 02 00 00 00 00 00 02 00 00 02 00 00 00 00 00 02 02 04 02 02 00 00 02
 02 00 00 00 02 46 46 02 00 00 02 00 00 02 00 00 02 00 00 02 00 00 02 00 00 00 00 00 00 00 00 00 02
 02 00 00 00 02 04 02 02 00 00 02 00 00 02 00 00 02 00 00 02 00 00 02 00 00 00 00 00 00 00 00 00 02
 02 46 00 46 02 46 46 02 00 00 02 00 00 02 00 00 02 00 00 02 00 00 02 00 00 02 00 00 02 46 00 46 02
 02 02 02 02 02 00 00 02 00 00 02 00 00 02 46 46 02 00 00 02 00 00 02 00 00 02 00 00 02 02 02 02 02
 02 00 00 00 00 00 00 02 00 15 02 00 00 02 02 02 02 00 00 02 00 00 02 00 15 02 00 00 00 00 00 46 02
 02 00 00 00 00 00 00 02 00 00 02 00 00 00 00 00 00 00 00 00 00 00 02 00 00 02 00 00 00 00 00 00 02
 02 00 00 00 02 00 00 00 00 00 00 00 00 00 00 00 00 00 00 00 00 00 04 00 00 02 00 00 02 00 00 00 02
 02 00 00 46 02 00 00 00 00 00 00 00 00 02 02 02 02 02 02 02 00 00 00 00 00 02 46 00 02 00 02 00 02
 02 00 00 02 02 00 00 02 02 02 02 00 46 00 00 00 00 00 00 46 00 00 00 00 00 02 00 00 02 00 02 00 02
 02 00 00 02 46 00 00 00 00 00 00 00 00 00 00 00 00 00 00 00 00 00 02 00 00 02 00 00 00 00 02 00 02
 02 00 00 02 00 00 00 00 00 00 00 00 00 00 00 00 02 02 02 02 00 00 02 00 00 02 00 00 00 00 02 00 02
 02 00 00 02 02 02 02 02 00 00 02 02 02 04 00 00 00 00 00 00 00 00 02 00 00 00 00 00 02 00 02 46 02
 02 16 00 02 46 46 46 00 00 00 00 46 46 02 46 00 46 02 46 00 00 46 02 46 00 00 00 46 02 46 02 16 02
 02 02 02 02 02 02 02 02 02 02 02 02 02 02 02 02 02 02 02 02 02 02 02 02 02 02 02 02 02 02 02 02 02
