Gauntlet II
Maze number: 4
Offset for maze 3: 230270 - 0x03837e
big endian buf: [%!l(uint8=0) %!l(uint8=3) %!l(uint8=131) %!l(uint8=126)]
G:2 Maze real addr: 230270 - 0x03837E, bank 0, boff: 0x0000
Maze read from: 0x03837e - 230270
compresssed: 134
 00 00 41 42 00 32 0D 0D B5 43 5D 10 80 2E 1E 1A
 60 2E 1A 10 C0 20 35 81 C0 1A 10 20 C0 2E C0 35
 1A 10 23 2E C0 1A 35 26 10 DF DF DF DF DF DF DF
 DF DF C0 44 BA 45 BA 46 BA 44 BA 44 DF DF 71 D9
 1D DF C0 BF 5C 51 DF DF D0 1D 57 55 79 DF DF C1
 2F DC 2F AD 43 AE 31 D7 07 18 07 DC 07 81 C0 0C
 6F CD 09 81 DC 09 18 C0 28 DB 09 81 DF D7 08 81
 C2 0B BE 61 28 C6 2E B4 C1 0F C0 B4 2E C3 2E 08
 18 08 C1 0A 33 00
  Encoded length: 134 bytes
  Wall pattern: 02, Wall color: 13     Floor pattern: 03, Floor color: 00
  Flags: FAST_DEATHS EXIT_MOVES FAST_GHOSTS 
  Random food adds: 2
  Secret trick:  0 - No trick
 02 02 02 02 02 02 02 02 02 02 02 02 02 02 02 02 02 02 02 02 02 02 02 02 02 02 02 02 02 02 02 02 02
 02 16 46 30 26 53 02 46 26 16 00 32 53 02 53 00 26 16 32 00 46 02 53 26 16 35 46 02 26 53 38 16 02
 02 00 00 00 00 00 02 00 00 00 00 00 00 02 00 00 00 00 00 00 00 02 00 00 00 00 00 02 00 00 00 00 02
 02 00 00 00 00 00 02 00 00 00 00 00 00 02 00 00 00 00 00 00 00 02 00 00 00 00 00 02 00 00 00 00 02
 02 00 00 00 00 00 02 00 00 00 00 00 00 02 00 00 00 00 00 00 00 02 00 00 00 00 00 02 00 00 00 00 02
 02 00 00 00 00 00 02 00 00 00 00 00 00 02 00 00 00 00 00 00 00 02 00 00 00 00 00 02 00 00 00 00 02
 02 00 00 00 00 00 02 00 00 00 00 00 00 02 00 00 00 00 00 00 00 02 00 00 00 00 00 02 00 00 00 00 02
 02 00 00 00 00 00 02 00 00 00 00 00 00 02 00 00 00 00 00 00 00 02 00 00 00 00 00 02 00 00 00 00 02
 02 00 00 00 00 00 02 00 00 00 00 00 00 02 00 00 00 00 00 00 00 02 00 00 00 00 00 02 00 00 00 00 02
 02 00 00 00 00 00 02 00 00 00 00 00 00 02 00 00 00 00 00 00 00 02 00 00 00 00 00 02 00 00 00 00 02
 02 00 00 00 00 00 02 00 00 00 00 00 00 02 00 00 00 00 00 00 00 02 00 00 00 00 00 02 00 00 00 00 02
 02 13 13 13 13 13 02 13 13 13 13 13 13 02 13 13 13 13 13 13 13 02 13 13 13 13 13 02 13 13 13 13 02
 02 00 00 00 00 00 00 00 00 00 00 00 00 00 00 00 00 00 00 00 00 00 00 00 00 00 00 00 00 00 00 00 02
 02 00 00 00 00 00 00 00 00 00 00 00 00 00 00 00 00 00 00 00 00 00 00 00 00 00 00 00 00 00 00 00 02
 02 00 00 29 00 00 00 00 00 00 00 00 00 00 00 00 00 00 00 00 00 00 00 00 00 00 00 00 00 00 29 00 02
 02 00 00 00 00 00 00 00 00 00 00 00 00 00 00 00 00 00 00 00 00 00 00 00 00 00 00 00 00 00 00 00 02
 02 00 00 00 00 00 00 00 00 00 00 00 00 00 03 00 00 03 00 00 00 00 00 00 00 00 00 00 00 00 00 00 02
 02 00 00 00 00 00 00 00 00 00 00 00 00 00 00 00 00 00 00 00 00 00 00 00 00 00 00 00 00 00 00 00 02
 02 00 00 00 00 00 00 00 00 00 00 00 00 00 00 00 00 00 00 00 00 00 00 00 00 00 00 00 00 00 00 00 02
 02 00 00 29 00 00 00 00 00 00 00 00 03 00 00 00 00 00 00 03 00 00 00 00 00 00 00 00 00 00 29 00 02
 02 00 00 00 00 00 00 00 00 00 00 00 00 00 00 00 00 00 00 00 00 00 00 00 00 00 00 00 00 00 00 00 02
 02 00 00 00 00 00 00 00 00 00 00 00 00 00 00 00 00 00 00 00 00 00 00 00 00 00 00 00 00 00 00 00 02
 02 47 00 00 00 00 00 00 00 00 00 00 00 00 00 00 00 00 00 00 00 00 00 00 00 00 00 00 00 00 00 47 02
 02 02 02 02 02 02 02 02 02 02 02 02 02 02 13 13 13 13 02 02 02 02 02 02 02 02 02 02 02 02 02 02 02
 02 49 00 00 00 00 00 00 00 00 00 00 00 00 00 00 00 00 00 00 00 00 00 00 00 00 07 24 07 00 00 00 02
 02 00 00 00 00 00 00 00 00 00 00 00 00 00 00 00 00 00 00 00 00 00 00 00 00 00 07 07 07 00 12 53 02
 02 00 00 00 00 00 00 00 00 00 00 00 00 00 00 00 00 00 00 00 00 00 00 00 00 00 00 00 00 00 09 09 02
 02 00 00 00 00 00 00 00 00 00 00 00 00 02 00 00 00 00 02 00 00 00 00 00 00 00 00 00 00 00 09 24 02
 02 40 00 00 00 00 00 00 00 00 00 00 00 02 00 00 00 00 02 00 00 00 00 00 00 00 00 00 00 00 09 09 02
 02 00 00 00 00 00 00 00 00 00 00 00 00 02 00 00 00 00 02 00 00 00 00 00 00 00 00 00 00 00 00 00 02
 02 00 00 00 00 00 00 00 00 00 00 00 00 02 00 00 00 00 02 00 00 00 00 00 00 08 08 08 00 00 00 11 02
 02 53 00 00 40 00 00 00 00 00 00 00 46 02 00 00 15 00 02 46 00 00 00 00 46 08 24 08 00 00 10 51 02
 02 02 02 02 02 02 02 02 02 02 02 02 02 02 02 02 02 02 02 02 02 02 02 02 02 02 02 02 02 02 02 02 02
