Gauntlet II
Maze number: 66
Offset for maze 65: 230036 - 0x038294
big endian buf: [%!l(uint8=0) %!l(uint8=3) %!l(uint8=130) %!l(uint8=148)]
G:2 Maze real addr: 246420 - 0x03C294, bank 2, boff: 0x4000
Maze read from: 0x03c294 - 246420
compresssed: 238
 02 00 00 00 00 44 70 12 6E 5E A4 32 80 C8 3A C2
 0F C2 39 CA 35 DF 52 CC 35 59 CE B3 A0 0D 81 A0
 B3 D1 1D C2 42 2E 64 42 C2 1D 66 C6 42 2E 64 42
 67 C1 AC 0D 81 AF 13 82 35 13 83 2E 66 13 83 31
 13 86 A3 05 80 A4 C4 A4 05 80 A5 13 44 2E C6 A4
 66 45 AA 21 C6 21 AC C1 16 C5 27 A2 0D 81 A2 27
 C9 35 C1 35 29 E1 63 66 E4 18 61 C3 32 29 E1 63
 66 E4 18 61 C4 16 C6 A2 0D 81 A2 C9 32 C0 BF A9
 C8 AC 2E C0 1F C7 74 78 1C 61 C2 1F 64 C4 3E CB
 1C C5 1F C7 A7 C7 1C C5 1F 67 C1 3E 61 81 C6 1C
 C5 A8 C0 18 C2 18 C1 A8 C5 0E C3 70 2F C8 31 75
 0E C5 0E C3 72 2E C1 3E C1 34 C1 75 0E C5 A7 B5
 A6 B5 A8 69 51 C3 3E 53 61 6E 51 C3 36 53 61 D3
 A7 D5 04 60 C1 10 61 A1 CD A7 B2 1E 54 B2 A8 C5
 05 D7 05 C2 BE 1C 80 05 D7 05 1C C0 1C 00
  Encoded length: 238 bytes
  Wall pattern: 04, Wall color: 00     Floor pattern: 04, Floor color: 07
  Flags: 
  Random food adds: 0
  Secret trick:  2 - Try Transportability (onto death)
 02 02 02 02 02 02 02 02 02 02 02 02 02 02 02 02 02 02 02 02 02 02 02 02 02 02 02 02 02 02 02 02 02
 02 50 00 00 00 00 00 00 00 00 00 58 02 00 00 15 00 00 02 57 00 00 00 00 00 00 00 00 00 00 00 53 02
 02 00 00 00 00 00 00 00 00 00 00 00 02 00 00 00 00 00 02 00 00 00 00 00 00 00 00 00 00 00 00 00 02
 02 00 00 30 00 00 00 00 00 00 00 00 02 00 00 00 00 53 02 00 00 00 00 00 00 00 00 00 30 00 00 00 02
 02 00 00 00 00 00 00 00 00 00 00 00 02 02 13 13 13 02 02 00 00 00 00 00 00 00 00 00 00 00 00 00 02
 02 00 00 00 00 29 00 00 00 18 18 18 46 00 00 00 00 00 46 18 18 18 00 00 00 29 00 00 00 00 00 00 02
 02 46 00 00 00 00 00 00 00 18 18 18 46 00 00 00 00 00 46 18 18 18 00 00 00 00 00 00 00 00 46 00 02
 02 02 02 02 02 02 02 02 02 02 02 02 02 02 13 13 13 02 02 02 02 02 02 02 02 02 02 02 02 02 02 02 02
 02 19 19 19 19 53 19 19 19 19 19 46 00 00 00 00 00 00 00 46 19 19 19 19 19 49 19 19 19 19 19 19 02
 02 19 02 02 02 02 05 05 02 02 02 02 02 00 00 00 00 00 02 02 02 02 02 05 05 02 02 02 02 02 02 19 02
 02 18 18 18 18 46 00 00 00 00 00 00 00 02 02 02 02 02 00 00 00 00 00 00 00 46 18 18 18 18 18 18 02
 02 02 02 02 02 02 02 02 02 02 02 33 00 00 00 00 00 00 00 33 02 02 02 02 02 02 02 02 02 02 02 02 02
 02 00 00 22 00 00 00 00 00 00 39 02 02 02 13 13 13 02 02 02 39 00 00 00 00 00 00 00 00 00 00 53 02
 02 00 53 41 00 00 02 00 00 00 00 46 00 00 00 00 00 00 00 46 00 00 00 00 00 02 24 00 00 46 00 00 02
 02 00 50 41 00 00 02 00 00 00 00 46 00 00 00 00 00 00 00 46 00 00 00 00 00 02 24 00 00 46 00 00 02
 02 00 00 22 00 00 00 00 00 00 00 02 02 02 13 13 13 02 02 02 00 00 00 00 00 00 00 00 00 00 50 00 02
 02 02 02 02 02 02 02 02 02 02 02 00 00 00 00 00 00 00 00 00 02 02 02 02 02 02 02 02 02 02 02 02 02
 02 46 00 31 00 00 00 00 00 00 00 00 36 00 00 00 00 00 36 00 00 00 00 00 00 00 00 00 28 00 00 46 02
 02 00 00 31 00 00 00 00 00 46 00 00 00 00 00 62 00 00 00 00 00 00 00 00 00 00 00 00 28 00 00 00 02
 02 00 00 31 00 00 00 00 00 00 00 02 02 02 02 02 02 02 02 02 00 00 00 00 00 00 00 00 28 00 00 00 02
 02 00 00 31 00 00 00 00 00 00 00 02 46 00 00 62 00 00 46 02 46 00 00 00 00 00 00 00 28 00 00 00 02
 02 00 00 02 02 02 02 02 02 02 02 02 00 24 00 00 00 24 00 02 02 02 02 02 02 02 02 02 02 00 00 00 02
 02 00 00 14 00 00 00 00 36 00 47 02 00 00 00 00 00 00 00 02 49 36 00 00 00 00 00 00 14 00 00 00 02
 02 00 00 14 00 00 00 00 36 00 00 02 46 00 00 62 00 00 52 02 00 36 00 00 00 00 00 00 14 00 00 00 02
 02 00 00 02 02 02 02 02 02 02 02 02 02 02 02 02 02 02 02 02 02 02 02 02 02 02 02 02 02 00 00 00 02
 02 00 00 00 00 00 00 46 00 00 30 00 00 00 00 62 00 00 00 00 30 00 00 46 00 00 00 00 00 00 00 00 02
 02 00 00 00 00 00 00 46 00 00 30 00 00 00 00 54 00 00 00 00 30 00 00 46 00 00 00 00 00 00 00 00 02
 02 00 00 00 00 00 00 00 00 00 00 02 02 02 02 02 02 02 02 02 00 00 00 00 00 00 00 00 00 00 00 00 02
 02 00 00 00 00 00 00 00 00 00 04 02 46 00 00 16 00 00 46 02 02 00 00 00 00 00 00 00 00 00 00 00 02
 02 00 00 02 02 02 02 02 02 02 02 02 30 00 00 00 00 00 30 02 02 02 02 02 02 02 02 02 02 00 00 00 02
 02 00 00 05 00 00 00 00 00 00 00 00 00 00 00 00 00 00 00 00 00 00 00 00 00 00 00 00 05 00 00 00 02
 02 28 28 05 00 00 00 00 00 00 00 00 00 00 00 00 00 00 00 00 00 00 00 00 00 00 00 00 05 28 00 28 02
 02 02 02 02 02 02 02 02 02 02 02 02 02 02 02 02 02 02 02 02 02 02 02 02 02 02 02 02 02 02 02 02 02
