Gauntlet II
Maze number: 71
Offset for maze 70: 231371 - 0x0387cb
big endian buf: [%!l(uint8=0) %!l(uint8=3) %!l(uint8=135) %!l(uint8=203)]
G:2 Maze real addr: 247755 - 0x03C7CB, bank 2, boff: 0x4000
Maze read from: 0x03c7cb - 247755
compresssed: 359
 06 00 00 00 20 50 9E 6E 9D 5C A8 2E CC 23 C3 0E
 35 74 0E 0F E6 35 CB A1 0D 80 A1 C0 A2 ED C2 A3
 2E E1 2F 41 C1 35 E4 04 2E A0 35 A0 2E A0 2E A0
 C3 31 C3 05 24 C3 B2 A2 B3 A0 C3 1E C0 1E C0 1E
 45 B2 21 E0 C0 A1 B2 E6 C0 21 A0 E7 04 60 A0 E1
 2E C7 B2 C0 1D 36 E0 E0 E5 28 A0 E1 C2 66 A0 E2
 C0 1D A0 E8 E0 C1 A2 E6 0D 81 A0 C7 22 CD 25 C5
 33 32 E1 E4 C9 B2 77 A2 35 40 54 C6 A2 C9 10 81
 45 C0 15 40 E3 15 C0 73 2E 40 C2 09 81 C0 B2 C3
 1F C0 15 C0 1F E4 B2 A0 55 40 B2 C1 B3 C0 73 2E
 B3 1C B3 2E E4 2F E0 31 51 C5 29 2E C2 B4 E3 46
 04 29 E0 E8 E1 35 C4 22 E6 29 C1 0E C4 20 B2 E0
 2E E1 EC C3 0E E4 E1 33 C1 22 C1 B2 E2 C5 0E C3
 0E A0 2E 81 A0 E1 C4 B2 E1 C4 35 A2 0E E2 32 A0
 C0 1E C3 0E 18 C0 B4 E4 0D 83 A0 C3 A2 15 A0 C4
 A3 18 2E CC A1 62 A0 04 E4 C1 31 A1 64 72 28 A0
 C1 1D A2 E2 43 A0 E2 EB E4 2E A0 C0 A2 E2 41 C0
 B5 54 35 1C E8 C3 B5 20 44 C0 6F C6 A2 42 7F E2
 1C E5 CF 08 81 E4 40 E3 61 34 C0 31 35 E1 E2 1C
 35 08 24 08 50 A0 C2 A2 61 31 A0 C0 B2 A0 B3 A3
 2E A2 2E A0 C0 08 C0 08 41 A2 C0 22 31 A1 2E A0
 C2 05 C4 0C C2 0B C1 08 81 C4 0E 53 A0 C3 05 22
 E1 62 1C CA 0E C8 00
  Encoded length: 359 bytes
  Wall pattern: 00, Wall color: 14     Floor pattern: 05, Floor color: 09
  Flags: WRAP_H 
  Random food adds: 0
  Secret trick:  6 - Watch What You Shoot (shoot secret walls)
 02 02 02 02 02 02 02 02 02 02 02 02 02 02 02 02 02 02 02 02 02 02 02 02 02 02 02 02 02 02 02 02
 46 00 00 00 00 00 00 00 00 00 00 00 00 00 35 00 00 00 00 14 53 40 00 00 00 00 00 14 15 00 00 02
 00 00 00 00 02 53 00 00 00 00 00 00 00 00 00 00 00 00 02 02 13 13 02 02 00 02 02 02 00 00 00 02
 00 00 00 00 00 00 00 00 00 00 02 00 00 00 02 02 02 02 46 00 00 02 47 00 02 46 00 02 53 00 00 02
 00 00 02 04 46 02 53 02 46 02 46 02 00 00 00 00 49 02 00 00 00 05 36 00 02 00 00 02 02 02 02 02
 02 00 00 00 00 30 00 30 00 30 00 00 00 00 00 00 46 02 33 00 02 00 02 02 02 00 00 00 00 02 00 00
 02 00 33 02 00 00 00 00 00 00 00 00 02 04 29 00 02 00 00 02 46 00 00 00 00 00 00 00 00 02 00 29
 54 00 02 00 02 00 00 00 00 00 00 02 40 02 00 00 02 00 00 00 29 00 00 00 00 00 00 00 02 00 00 00
 02 00 29 02 00 00 00 00 00 00 00 00 00 02 00 02 00 00 02 02 02 00 00 00 00 00 00 00 02 13 13 13
 02 00 00 00 00 00 00 00 00 34 00 00 00 00 00 00 00 00 00 00 02 00 00 00 37 00 00 00 00 00 00 51
 50 00 00 02 00 00 00 00 00 02 00 00 00 00 00 00 00 00 00 00 02 40 00 00 00 00 00 00 00 00 02 02
 02 53 02 46 02 00 00 00 02 28 02 00 00 00 00 00 00 02 02 02 00 00 00 00 00 00 00 00 00 02 16 16
 02 00 02 00 02 00 00 46 02 21 02 46 00 00 00 00 02 21 02 40 00 00 00 00 46 00 46 00 00 02 09 09
 02 00 02 00 02 00 00 31 02 21 02 31 00 00 00 00 00 02 02 02 00 00 00 00 00 00 28 00 46 02 00 00
 02 00 40 00 02 00 00 46 02 28 02 46 00 00 00 00 00 02 47 00 02 49 00 00 28 00 00 00 02 00 00 41
 46 00 00 00 02 00 00 00 00 02 00 00 00 00 00 00 00 46 04 41 00 02 00 00 00 00 00 00 02 00 00 02
 02 00 02 53 00 02 00 00 00 34 00 00 00 00 00 00 00 02 41 00 00 14 00 00 00 00 00 32 02 00 02 46
 02 00 02 02 00 02 00 00 00 00 00 00 00 00 00 00 02 00 00 00 00 14 00 00 00 00 00 02 00 00 02 51
 02 00 34 02 00 02 00 00 00 02 00 00 00 00 00 00 14 00 00 00 00 14 02 46 46 46 02 00 00 02 00 00
 02 00 02 02 00 00 02 00 00 00 00 00 53 02 02 02 14 00 00 00 02 50 02 00 30 02 00 00 00 14 24 00
 02 00 02 00 00 00 02 13 13 13 13 13 02 00 00 00 00 02 02 02 21 02 00 00 00 02 00 02 02 02 02 24
 46 00 02 00 00 00 00 00 00 00 00 00 00 00 02 02 29 00 00 00 02 04 00 00 00 02 00 02 00 00 49 02
 02 29 02 00 00 00 00 40 00 00 00 40 02 00 00 29 02 02 02 00 00 00 02 00 00 02 00 46 02 00 00 00
 02 00 02 00 00 00 00 00 00 00 00 00 00 02 00 00 00 00 00 02 46 02 00 02 02 02 00 00 00 02 00 00
 46 00 02 00 00 00 00 00 28 53 28 00 00 00 00 00 00 00 00 00 02 00 00 00 00 02 32 00 00 00 00 00
 46 00 29 00 00 00 00 00 00 00 00 00 00 00 00 00 00 00 00 00 00 00 00 00 00 00 02 02 02 00 00 00
 46 40 02 00 00 00 00 00 00 00 00 00 00 00 00 00 00 00 00 00 00 02 28 00 00 00 00 00 00 02 00 00
 02 00 02 00 00 00 00 00 00 00 00 00 00 00 08 08 08 00 00 00 00 00 02 00 46 00 00 00 00 02 29 00
 02 52 02 49 53 00 00 02 00 00 00 02 28 53 08 36 08 00 28 02 00 00 00 02 02 02 29 00 00 49 02 00
 02 02 02 02 02 02 02 46 02 02 02 46 02 00 08 00 08 00 00 46 02 02 02 00 34 49 02 02 46 02 00 00
 00 05 00 00 00 00 00 12 00 00 00 11 00 00 08 08 08 00 00 00 00 00 14 00 00 00 00 28 02 00 00 00
 00 05 34 00 00 02 29 00 00 00 28 00 00 00 00 00 00 00 00 00 00 00 14 00 00 00 00 00 00 00 00 00
 02 02 02 02 02 02 02 02 02 02 02 02 02 02 02 02 02 02 02 02 02 02 02 02 02 02 02 02 02 02 02 02
