Gauntlet II
Maze number: 25
Offset for maze 24: 235145 - 0x039689
big endian buf: [%!l(uint8=0) %!l(uint8=3) %!l(uint8=150) %!l(uint8=137)]
G:2 Maze real addr: 235145 - 0x039689, bank 0, boff: 0x0000
Maze read from: 0x039689 - 235145
compresssed: 256
 05 00 00 13 00 50 C1 6E 5D 49 63 35 80 71 08 C4
 33 A0 50 31 C1 18 A0 76 C1 35 A1 14 81 31 08 C4
 07 C1 2A A0 E3 C1 2A 44 A0 C4 04 A0 C3 07 54 E3
 E2 E2 EA C2 A4 E3 E4 48 E1 E7 C9 20 E7 52 C7 A1
 E3 E2 C6 2C 54 C0 1F 74 E0 E1 33 A0 ED C1 A2 E3
 1E C0 A1 E2 14 87 C4 2C E3 C0 07 80 74 41 A0 E8
 C7 1C A0 C7 A3 C8 2C E9 D1 B8 E3 66 A0 E1 C4 1F
 E8 C3 20 B5 1E E0 E3 20 E5 E4 E3 E7 D0 32 A1 E2
 0D 83 E2 CA A3 BF C1 35 A0 C6 B2 C2 1E 6B 62 E1
 23 65 A0 EE E2 C2 A1 E5 0D 82 C1 B4 C2 B7 C2 31
 C4 29 E2 E4 1D E0 C0 B3 61 A0 C1 22 A3 E4 40 A0
 21 E4 E4 E2 C3 1F E7 C6 04 A0 1C E2 C2 1C A0 CF
 B6 C4 A1 E2 E3 ED E0 E5 61 A0 C1 10 A0 41 B4 E9
 E1 1C C8 A2 E2 E9 C3 A9 CC 20 D6 28 C7 B5 24 CD
 22 42 A0 E1 C1 A2 C2 AF A3 C6 3A C0 13 86 D7 13
 86 C1 18 43 E8 C2 0F C0 BE 13 86 F0 3A C2 2F 00
  Encoded length: 256 bytes
  Wall pattern: 00, Wall color: 01     Floor pattern: 05, Floor color: 12
  Flags: WALLS_DELETABLE1 
  Random food adds: 3
  Secret trick:  5 - Watch What You Shoot (shoot foods)
 02 02 02 02 02 02 02 02 02 02 02 02 02 02 02 02 02 02 02 02 02 02 02 02 02 02 02 02 02 02 02 02 02
 02 53 00 00 35 08 00 00 00 00 00 51 02 00 09 49 00 00 24 02 00 00 00 00 00 00 00 35 00 00 53 02 02
 02 20 20 20 49 08 00 00 00 00 00 07 00 00 42 02 00 00 00 00 02 00 00 42 00 00 00 00 00 46 02 00 02
 02 00 00 00 04 02 00 00 00 00 07 00 00 00 00 00 09 00 00 00 00 02 00 00 00 02 00 00 00 02 00 00 02
 02 00 00 00 02 00 00 00 00 02 00 00 00 02 02 02 02 02 00 00 00 00 02 00 00 00 00 00 02 00 00 00 02
 02 00 00 00 02 00 46 00 00 02 00 00 00 00 00 00 00 00 02 00 00 00 00 00 00 00 00 00 00 32 00 00 02
 02 00 00 00 02 00 02 00 00 00 09 00 00 00 00 00 00 00 00 02 02 00 00 00 00 02 00 00 00 02 00 00 02
 02 00 00 00 02 44 00 00 00 00 00 09 00 31 00 00 00 00 00 35 00 02 00 00 02 51 02 00 00 00 00 00 02
 02 00 00 00 02 00 00 00 00 02 00 02 02 02 02 00 00 00 00 02 30 00 02 02 00 00 00 02 20 20 20 20 02
 02 20 20 20 02 00 00 00 00 00 44 02 00 00 00 02 00 07 07 00 00 00 00 00 35 00 00 46 02 00 00 00 02
 02 00 00 00 02 00 02 00 00 00 00 02 00 00 00 28 02 00 00 00 00 00 00 00 00 02 02 02 02 00 00 00 02
 02 00 00 00 02 00 44 00 00 00 00 02 00 00 00 00 00 02 00 00 00 00 00 00 02 00 00 00 00 00 00 00 02
 02 00 00 00 02 00 00 00 00 02 00 02 00 00 00 00 00 29 02 00 00 02 00 00 02 00 00 31 00 00 00 00 02
 02 00 00 00 00 02 00 00 00 00 32 02 30 00 02 00 00 00 00 02 32 00 00 00 02 00 00 02 00 00 00 00 02
 02 02 00 00 00 00 02 00 00 00 00 00 02 00 00 02 00 00 00 00 02 00 00 00 02 00 00 00 00 00 00 00 02
 02 50 02 02 00 00 00 02 13 13 13 13 02 00 00 00 02 00 00 00 02 00 00 00 02 00 00 00 02 02 02 02 02
 02 00 00 53 02 00 00 00 02 00 00 00 02 00 00 00 30 02 00 00 02 00 00 00 02 00 00 00 00 29 00 00 02
 02 29 00 00 02 35 00 00 02 00 00 00 29 02 00 00 00 02 00 00 02 00 00 00 02 00 00 00 00 02 00 00 02
 02 02 00 00 00 02 02 00 02 00 00 00 00 02 13 13 13 02 00 00 02 00 00 00 02 00 00 00 49 00 00 00 02
 02 00 41 00 00 00 02 00 02 00 00 00 02 29 00 02 00 02 00 00 29 02 00 00 34 02 02 02 02 00 00 00 02
 02 00 02 00 46 02 33 00 02 00 00 00 02 00 00 00 00 00 02 00 00 00 02 00 00 00 00 31 02 00 00 00 02
 02 00 00 00 02 00 00 00 02 00 00 00 04 02 28 00 00 00 02 00 00 00 28 02 00 00 00 00 02 00 00 00 02
 02 00 00 02 00 00 00 00 02 00 00 00 00 00 02 02 00 00 00 02 00 00 00 00 02 00 00 00 02 00 00 00 02
 02 00 00 02 00 00 00 02 00 02 00 00 00 00 00 00 02 00 00 29 02 00 00 16 02 00 00 46 02 00 00 00 02
 02 00 00 02 00 00 00 02 00 00 02 28 00 00 00 00 00 00 00 00 00 02 02 02 00 00 00 02 00 00 00 00 02
 02 00 00 02 00 00 02 00 00 00 00 02 02 02 02 02 02 02 02 02 02 00 00 00 00 00 00 00 00 00 00 00 02
 02 00 32 02 00 00 00 00 00 00 00 00 00 00 00 00 00 00 00 00 00 00 00 00 00 00 40 00 00 00 00 00 02
 02 00 00 02 36 00 00 00 00 00 00 00 00 00 00 00 00 00 00 34 00 00 00 46 02 00 00 02 00 00 02 02 02
 02 00 00 00 02 02 02 02 02 02 02 02 02 02 02 02 02 02 02 02 02 02 02 02 00 00 00 00 00 00 00 58 02
 02 19 19 19 19 19 19 19 19 00 00 00 00 00 00 00 00 00 00 00 00 00 00 00 00 00 00 00 00 00 00 00 02
 02 19 19 19 19 19 19 19 19 00 00 24 00 00 00 00 46 00 00 00 00 00 00 00 00 00 02 00 00 00 15 00 02
 02 19 19 19 19 19 19 19 19 00 00 00 00 00 00 00 00 00 00 00 00 00 00 00 00 00 02 58 00 00 00 47 02
 02 02 02 02 02 02 02 02 02 02 02 02 02 02 02 02 02 02 02 02 02 02 02 02 02 02 02 02 02 02 02 02 02
