Gauntlet II
Maze number: 22
Offset for maze 21: 234406 - 0x0393a6
big endian buf: [%!l(uint8=0) %!l(uint8=3) %!l(uint8=147) %!l(uint8=166)]
G:2 Maze real addr: 234406 - 0x0393A6, bank 0, boff: 0x0000
Maze read from: 0x0393a6 - 234406
compresssed: 342
 11 00 00 82 00 40 8C 0D B5 0E 6E 10 80 31 C1 1D
 70 81 19 10 35 A0 C2 1D 10 31 C0 35 15 83 2E 0E
 C0 2F 80 C0 19 82 E1 51 19 CA 46 A0 C1 10 E7 19
 C3 52 C4 52 E1 E4 42 C2 53 C5 41 A1 43 A1 C7 15
 2E 62 2E A0 C5 0E CA 51 C2 35 52 C3 41 A0 62 52
 E1 79 03 A0 42 A0 43 E2 42 A0 41 A0 EA C0 20 71
 C1 1E CD 53 E1 2E 19 81 CA 10 CA 35 A0 42 A0 C7
 52 C4 45 E5 31 EB 43 70 19 C3 61 2E CA 35 53 C5
 2A 2F C5 52 A0 41 A0 C6 52 43 A0 C8 24 C2 35 A0
 EA C8 6D 56 2E 19 82 A0 1D E0 C5 53 A0 C8 51 C2
 35 A0 49 73 A0 C3 BF 41 A1 46 62 21 C3 0E E2 45
 70 19 C3 21 C6 51 E4 41 A0 64 22 C0 10 19 C3 66
 A1 42 A0 6D 42 A0 C2 52 C2 14 CC 43 E5 C3 14 82
 51 1C CE 31 19 54 C0 1C 71 C2 43 A0 2E C5 53 22
 C2 51 C2 41 A0 E3 41 B2 C4 03 C5 A1 42 A0 35 29
 70 6B 41 A0 41 A0 1D C2 62 A0 CC 51 28 C2 62 2E
 A0 C1 51 C7 26 C2 1C C1 19 81 A1 C7 43 03 CB 35
 55 C6 52 C5 63 40 A0 41 A0 C2 54 E2 61 51 61 A0
 1F C3 51 C3 51 64 41 A0 46 A0 42 A0 44 A0 E3 C3
 60 10 C0 63 13 81 C0 1D CF 0F E0 C7 13 81 C0 2F
 C4 51 C6 51 C4 BE 2F 21 C3 52 35 13 80 52 2F E4
 35 2A E4 E1 60 00
  Encoded length: 342 bytes
  Wall pattern: 00, Wall color: 12     Floor pattern: 04, Floor color: 08
  Flags: EXIT_CHOOSE_ONE 
  Random food adds: 2
  Secret trick: 17 - Don't Hurt Friends
 02 02 02 02 02 02 02 02 02 02 02 02 02 02 02 02 02 02 02 02 02 02 02 02 02 02 02 02 02 02 02 02 02
 02 16 49 00 14 29 00 46 14 46 25 16 53 02 14 00 00 29 16 49 14 53 21 21 21 21 21 46 14 00 47 47 02
 02 25 25 25 14 00 00 02 14 25 00 00 00 00 14 00 00 00 00 00 14 13 13 13 13 13 13 13 02 00 00 16 02
 02 00 00 00 14 00 00 00 02 25 00 00 00 00 14 00 00 00 00 00 14 00 00 02 00 00 00 00 14 02 13 13 02
 02 00 00 00 14 00 00 00 14 00 00 13 13 02 02 13 13 13 13 02 02 00 00 14 00 00 00 00 14 21 46 53 02
 02 00 00 46 02 00 00 00 14 00 00 14 00 00 14 00 00 00 00 00 00 00 00 14 00 00 00 53 14 00 00 00 02
 02 13 13 02 53 00 00 00 14 00 00 02 00 00 14 00 00 00 00 00 00 00 46 03 02 13 13 13 02 13 13 13 02
 02 00 00 00 02 13 13 13 02 13 13 02 00 00 14 00 00 00 00 00 00 00 00 02 00 32 00 14 46 00 00 30 02
 02 00 00 00 00 00 00 00 00 00 00 14 00 00 14 00 00 02 46 25 25 25 00 14 00 00 00 14 00 00 00 00 02
 02 16 00 00 00 00 00 00 00 00 00 14 00 53 02 13 13 13 02 00 00 00 00 14 00 00 00 14 00 00 00 00 02
 02 13 13 13 13 13 14 00 00 00 00 14 00 02 49 00 00 00 14 00 00 00 00 14 00 00 00 02 13 13 13 13 02
 02 46 25 00 00 00 14 53 00 00 46 14 00 00 00 00 00 00 14 00 00 00 53 14 00 00 00 14 00 00 42 47 02
 02 00 00 00 00 00 14 02 13 13 02 14 00 00 00 00 00 00 14 13 13 13 13 02 00 00 00 14 00 00 00 00 02
 02 36 00 00 00 53 02 00 00 00 00 14 00 00 00 00 00 00 02 00 00 00 00 00 00 00 00 14 53 00 00 00 02
 02 00 00 00 00 00 14 00 00 00 00 14 46 25 25 25 25 02 29 00 02 00 00 00 00 00 00 14 02 00 00 00 02
 02 00 00 00 00 00 14 00 00 00 53 02 13 13 13 13 13 13 13 13 13 13 00 00 00 00 46 02 00 00 00 00 02
 02 13 13 02 02 13 13 13 13 13 13 13 53 00 00 14 33 00 00 00 00 14 00 00 00 02 13 13 13 13 13 13 02
 02 46 25 14 00 00 00 33 00 00 00 14 00 00 00 14 00 00 00 00 00 02 13 13 02 53 00 00 00 00 00 34 02
 02 16 25 14 00 00 00 53 00 00 00 14 00 00 00 02 02 13 13 13 02 53 00 00 14 00 00 00 00 00 00 00 02
 02 00 00 14 13 13 13 02 00 00 00 14 00 00 00 20 14 00 00 00 00 00 00 00 14 00 00 00 00 13 13 13 02
 02 00 00 14 00 00 00 02 00 00 00 02 20 20 20 20 14 28 00 00 00 00 00 00 14 00 00 00 00 14 00 00 02
 02 49 25 14 00 28 00 14 46 00 00 02 13 13 13 13 02 46 00 00 00 00 00 00 14 34 00 00 00 14 00 00 02
 02 13 13 02 00 00 00 14 02 13 13 02 00 00 00 00 00 03 00 00 00 00 00 00 02 02 13 13 13 02 53 41 02
 02 46 53 14 00 00 00 14 00 00 00 14 00 00 00 13 13 02 13 13 02 29 00 00 14 53 00 00 00 02 00 00 02
 02 00 00 14 00 00 00 14 00 00 00 14 40 00 00 14 53 00 00 00 46 02 00 00 14 00 00 00 00 00 00 00 02
 02 38 00 14 00 28 00 14 25 25 25 02 02 00 00 14 00 00 00 00 00 13 13 13 13 03 00 00 00 00 00 00 02
 02 00 00 14 00 00 53 14 00 00 00 14 00 00 00 14 00 00 00 00 00 14 53 00 00 00 14 13 02 13 13 02 02
 02 00 00 14 00 00 00 02 53 00 00 14 53 00 00 02 31 00 00 00 00 14 00 00 00 00 14 53 00 00 00 00 02
 02 13 13 02 13 13 13 13 13 13 13 02 13 13 13 02 13 13 13 13 13 02 00 00 00 00 02 00 00 00 00 53 02
 02 16 00 53 00 00 00 14 19 19 19 14 29 00 00 00 00 00 14 00 00 00 00 00 00 00 14 00 00 15 00 02 02
 02 00 00 00 00 00 00 14 19 19 19 14 47 00 00 00 00 00 14 00 00 00 00 00 00 00 14 00 00 00 00 00 02
 02 47 33 00 00 00 00 14 53 19 19 14 47 00 00 00 00 00 02 53 42 00 00 00 00 00 02 00 00 02 53 00 02
 02 02 02 02 02 02 02 02 02 02 02 02 02 02 02 02 02 02 02 02 02 02 02 02 02 02 02 02 02 02 02 02 02
