Gauntlet II
Maze number: 10
Offset for maze 9: 231512 - 0x038858
big endian buf: [%!l(uint8=0) %!l(uint8=3) %!l(uint8=136) %!l(uint8=88)]
G:2 Maze real addr: 231512 - 0x038858, bank 0, boff: 0x0000
Maze read from: 0x038858 - 231512
compresssed: 125
 03 00 00 00 00 50 72 AE 60 69 5F 31 80 DC 47 25
 CB 25 DF E4 10 C5 AF A7 31 A0 DF 57 59 C2 43 29
 61 61 C0 4F CE AF A4 C5 48 31 DB 22 C9 22 C9 4F
 D6 4F CE A6 C2 A6 DF C1 22 53 69 67 D1 BF 4F CE
 AC C7 B8 C9 40 20 DF 76 DF 62 CA BF C7 A5 D1 1F
 71 C7 4F C9 B2 D7 4F DF C6 22 53 CC 1D D8 40 1D
 7A D0 A3 B3 C6 BB C2 BF DF C8 B8 DF C2 31 BE C0
 0F C4 39 BA 44 2E B2 41 31 BA 46 2E 00
  Encoded length: 125 bytes
  Wall pattern: 00, Wall color: 02     Floor pattern: 05, Floor color: 07
  Flags: 
  Random food adds: 0
  Secret trick:  3 - Try Transportability (into exit)
 02 02 02 02 02 02 02 02 02 02 02 02 02 02 02 02 02 02 02 02 02 02 02 02 02 02 02 02 02 02 02 02 02
 02 49 00 00 00 00 00 00 00 00 00 00 00 00 00 00 00 00 00 00 00 00 00 00 00 00 00 00 00 00 00 46 02
 02 00 00 00 00 00 00 00 37 00 00 00 00 00 00 00 00 00 00 00 00 37 00 00 00 00 00 00 00 00 00 00 02
 02 00 00 00 00 00 00 00 00 00 00 00 00 00 00 00 00 00 00 00 00 00 00 00 00 00 00 02 16 00 00 00 02
 02 00 00 02 02 02 02 02 02 02 02 02 02 02 02 02 02 02 02 02 02 02 02 02 02 02 02 49 02 00 00 00 02
 02 00 00 00 00 00 00 00 00 00 00 00 00 00 00 00 00 00 00 00 00 00 00 00 00 00 00 02 00 00 00 00 02
 02 00 00 00 00 41 00 00 00 00 00 00 00 00 00 00 41 00 00 00 46 00 00 00 00 41 00 02 32 00 00 32 02
 02 46 00 00 00 00 00 00 00 00 00 00 00 00 00 00 00 00 00 00 00 00 00 00 00 00 00 02 00 00 00 00 02
 02 02 02 02 02 02 02 02 02 02 02 02 02 02 02 02 02 02 02 02 02 02 00 00 00 00 00 02 46 00 00 00 02
 02 00 00 00 00 00 49 00 00 00 00 00 00 00 00 00 00 00 00 00 00 00 02 00 00 00 00 02 00 00 00 00 02
 02 00 00 34 00 00 00 00 00 00 00 00 00 00 34 00 00 00 00 00 00 00 02 00 00 46 00 02 00 00 00 00 02
 02 00 00 00 00 00 00 00 00 00 00 00 00 00 00 00 00 00 00 00 00 00 02 00 00 00 00 02 00 00 00 00 02
 02 46 00 00 00 00 00 00 00 00 00 00 00 00 00 00 00 00 00 00 00 00 02 00 00 00 00 02 00 00 00 00 02
 02 02 02 02 02 02 02 02 00 00 00 02 02 02 02 02 02 02 00 00 00 00 02 00 00 00 00 02 00 00 00 00 02
 02 00 00 00 00 00 00 00 00 00 00 00 00 00 00 00 00 02 00 00 34 00 02 00 00 41 00 02 00 00 00 00 02
 02 00 00 00 32 00 00 00 00 00 00 00 00 32 00 00 00 02 00 00 00 00 02 00 00 00 00 02 00 00 00 00 02
 02 46 00 00 00 00 00 00 00 00 00 00 00 00 00 00 00 02 00 00 00 00 02 00 00 00 00 02 00 00 00 00 02
 02 02 02 02 02 02 02 02 02 02 02 02 02 02 00 00 00 02 00 00 00 00 02 00 00 00 00 02 00 00 00 00 02
 02 46 00 32 00 00 00 00 00 00 00 00 00 02 00 00 00 02 00 00 00 00 00 00 00 00 00 02 00 00 00 00 02
 02 00 00 00 00 00 00 00 00 00 00 31 00 02 00 00 00 02 00 00 00 00 00 00 00 00 00 02 00 00 00 00 02
 02 00 00 00 00 00 00 00 00 00 00 00 00 02 00 32 00 02 00 00 00 00 00 00 00 00 00 02 00 00 00 00 02
 02 00 00 02 02 02 02 02 02 02 00 00 00 02 00 00 00 02 00 00 00 00 02 00 00 00 00 02 31 00 00 31 02
 02 00 00 02 00 00 00 00 46 02 00 00 00 02 00 00 00 02 00 00 00 00 02 00 00 00 00 02 00 00 00 00 02
 02 00 00 02 00 00 00 00 00 02 00 00 00 02 00 00 00 02 00 00 00 00 02 00 00 00 00 02 46 00 00 00 02
 02 00 00 00 00 00 00 00 00 02 00 00 00 02 00 00 00 02 00 00 00 00 02 00 00 00 00 02 00 00 00 00 02
 02 00 00 00 00 02 00 00 00 02 00 00 00 02 00 00 00 02 00 00 34 00 02 00 00 41 00 02 00 00 00 00 02
 02 00 00 00 00 02 00 29 00 02 00 00 00 02 00 00 00 02 00 00 00 00 02 00 00 00 00 02 00 00 00 00 02
 02 46 00 29 00 02 00 00 00 02 00 00 00 02 00 31 00 02 00 00 00 00 02 00 00 00 00 02 00 00 00 00 02
 02 02 02 02 02 02 00 00 00 02 00 00 00 02 00 00 00 02 00 00 00 00 02 00 00 00 00 02 00 00 00 00 02
 02 00 00 00 00 00 00 00 00 02 00 00 00 00 00 00 00 02 00 00 00 00 02 00 00 00 00 02 00 00 00 00 02
 02 00 00 00 00 00 00 00 00 02 00 00 00 00 00 00 00 02 00 00 00 00 02 00 00 00 00 00 00 00 00 49 02
 02 00 15 00 00 00 00 00 57 02 46 00 00 00 00 00 46 02 46 00 00 49 02 46 00 00 00 00 00 00 00 46 02
 02 02 02 02 02 02 02 02 02 02 02 02 02 02 02 02 02 02 02 02 02 02 02 02 02 02 02 02 02 02 02 02 02
