Gauntlet II
Maze number: 61
Offset for maze 60: 236643 - 0x039c63
big endian buf: [%!l(uint8=0) %!l(uint8=3) %!l(uint8=156) %!l(uint8=99)]
G:2 Maze real addr: 244835 - 0x03BC63, bank 1, boff: 0x2000
Maze read from: 0x03bc63 - 244835
compresssed: 301
 0B 00 10 80 40 71 2C 5D 85 0E 81 1D 80 E0 20 C0
 35 E2 1F C9 3F 80 C1 10 A0 0F E5 C5 A1 DF E1 C8
 3C D4 20 C6 3F 80 31 A0 C9 75 A0 C0 B2 A0 E1 C3
 A4 45 E0 75 1F C4 21 C1 B2 B2 A0 23 C8 A2 C2 56
 C1 B2 A0 D4 1F CE 21 C7 B6 F2 C0 B4 A0 E3 CE 1F
 C2 38 C2 20 C6 23 CB A4 E1 2E A0 B2 A0 C3 A1 B2
 A1 1E CE 2E A0 15 A0 35 E4 2E E3 C2 13 83 E6 1D
 60 A0 E3 1C C0 1C C0 1C C0 3A A0 31 C0 13 82 C0
 3E C3 2E C1 62 A0 C2 3F 08 84 A3 13 82 A7 40 62
 A0 31 3F CA 13 82 BF C4 2F C1 64 A0 C1 07 C6 3F
 B7 C2 70 18 37 45 66 1D 07 CC 18 3E C2 18 C0 3E
 67 07 22 07 CB 18 37 45 66 1D 07 C8 77 2F C1 67
 07 CD A6 40 62 A1 C9 3F C5 3E C3 2E C1 62 A0 C0
 31 3F E0 09 83 A2 28 CA BF A0 1D 60 A0 C3 3F 2E
 20 C1 20 C1 3A C6 A2 E4 15 A0 C2 1E C0 2E C5 A2
 C3 29 40 E7 C7 A4 C0 35 C8 B2 7B 1E 40 C4 1E C9
 72 1D D3 2A D3 B4 31 D2 B5 C3 A1 C1 A1 2E A1 C3
 2E E8 D0 01 80 C3 0A C0 0B C0 0C BE 1D E0 20 C4
 2E B2 1D 44 C5 10 B9 0A 2E 0B 2E 0C 00
  Encoded length: 301 bytes
  Wall pattern: 01, Wall color: 12     Floor pattern: 07, Floor color: 02
  Flags: EXIT_CHOOSE_ONE EXIT_FAKE FAST_SORCERERS 
  Random food adds: 0
  Secret trick: 11 - Don't Be Fooled
 02 02 02 02 02 02 02 02 02 02 02 02 02 02 02 02 02 02 02 02 02 02 02 02 02 02 02 02 02 02 02 02 02
 02 29 00 02 32 00 53 14 00 00 02 31 00 00 00 00 00 00 00 00 00 00 63 63 00 00 16 02 15 00 00 00 02
 02 00 00 02 00 00 00 14 00 00 02 02 00 00 00 00 00 00 00 00 00 00 00 00 00 00 02 00 00 00 00 00 02
 02 00 00 00 00 00 00 14 00 00 00 00 00 02 02 00 00 00 00 00 00 00 00 00 60 00 02 00 00 00 00 00 02
 02 00 00 00 00 00 00 14 00 00 00 00 00 02 32 00 00 00 00 00 02 02 63 63 49 02 02 00 00 00 00 00 02
 02 00 00 00 01 00 00 14 00 00 02 02 00 02 02 00 02 02 00 00 02 02 02 02 02 02 02 00 00 00 00 00 02
 02 29 00 02 01 00 00 14 00 00 02 31 00 00 00 00 02 33 00 00 02 02 02 35 00 00 02 00 00 00 00 00 02
 02 02 02 02 00 00 00 14 00 00 02 02 00 00 00 00 02 00 00 00 00 00 00 00 00 00 02 00 00 00 00 00 02
 02 31 00 00 00 00 00 02 00 00 00 00 00 00 00 00 02 33 00 00 00 00 00 00 00 00 02 00 00 00 00 00 02
 02 00 00 00 00 00 00 02 00 00 00 00 00 02 02 00 02 02 00 00 00 02 02 00 00 00 00 02 00 00 00 00 02
 02 00 00 00 00 00 31 02 00 00 56 00 00 02 32 00 00 00 00 00 00 02 35 00 00 00 00 02 00 00 00 00 02
 02 00 00 02 02 02 02 02 00 00 02 46 02 02 02 00 00 00 00 02 02 02 02 02 30 00 00 02 00 00 00 00 02
 02 00 00 00 00 00 00 02 46 02 21 02 53 00 00 00 00 00 02 46 00 00 00 00 02 00 00 02 19 19 19 19 02
 02 00 00 00 00 00 00 02 02 29 05 00 02 00 00 00 00 02 28 00 28 00 28 00 58 02 49 02 19 19 19 19 02
 02 62 00 00 00 00 46 02 00 05 00 00 00 02 00 00 00 63 08 08 08 08 08 08 02 02 02 02 19 19 19 19 02
 02 02 02 02 02 02 02 02 00 29 05 00 00 00 02 49 63 00 00 00 00 00 00 00 00 00 00 02 19 19 19 19 02
 02 00 00 00 00 00 47 02 00 05 00 00 00 00 00 02 00 00 07 00 00 00 00 00 00 00 63 02 00 00 00 01 02
 02 24 55 00 00 00 00 02 00 29 05 00 00 00 00 00 00 00 29 07 00 00 00 00 00 00 00 00 00 00 00 00 02
 02 24 62 00 00 00 24 02 62 05 00 00 00 00 00 00 00 00 07 34 07 00 00 00 00 00 00 00 00 00 00 00 02
 02 24 55 00 00 00 00 02 00 29 05 00 00 00 00 00 00 00 29 07 00 00 00 00 00 00 00 00 00 01 00 00 02
 02 00 00 00 00 00 47 02 00 05 00 00 00 00 00 00 00 00 07 00 00 00 00 00 00 00 00 00 00 00 00 00 02
 02 02 02 02 02 02 02 02 00 29 05 00 00 00 02 02 00 00 00 00 00 00 00 00 00 00 63 00 00 00 00 00 02
 02 62 00 00 00 00 46 02 00 05 00 00 00 02 00 49 63 00 02 09 09 09 09 09 02 02 02 40 00 00 00 00 02
 02 00 00 00 00 00 00 02 02 29 05 00 02 00 00 00 00 63 46 32 00 00 32 00 00 58 02 00 00 00 00 00 02
 02 02 02 02 00 00 00 02 00 02 21 02 00 00 00 30 00 46 02 00 00 00 00 00 02 02 02 00 00 00 00 41 02
 02 29 00 02 00 00 00 02 00 00 02 00 00 00 00 00 00 00 02 02 02 02 02 02 00 53 02 00 00 00 00 00 02
 02 00 00 02 01 00 00 02 00 00 00 00 00 00 00 00 00 30 02 29 00 00 00 00 00 30 02 00 00 00 00 00 02
 02 00 00 00 01 00 00 02 29 00 00 00 00 00 00 00 00 00 02 00 00 00 00 00 00 00 02 00 00 42 00 00 02
 02 00 00 00 00 00 00 02 00 00 00 00 00 00 00 00 00 00 02 49 00 00 00 00 00 00 02 00 00 00 00 00 02
 02 00 00 00 00 00 00 02 00 00 00 02 02 02 00 00 02 02 46 02 02 00 00 00 00 46 02 00 00 00 00 00 02
 02 00 00 02 00 00 00 00 00 00 00 02 00 00 00 00 00 00 00 00 00 01 01 00 00 00 02 10 00 11 00 12 02
 02 29 00 02 32 00 00 00 00 00 46 02 29 00 00 00 00 00 29 00 00 00 00 00 00 16 02 10 46 11 46 12 02
 02 02 02 02 02 02 02 02 02 02 02 02 02 02 02 02 02 02 02 02 02 02 02 02 02 02 02 02 02 02 02 02 02
