Gauntlet II
Maze number: 21
Offset for maze 20: 234163 - 0x0392b3
big endian buf: [%!l(uint8=0) %!l(uint8=3) %!l(uint8=146) %!l(uint8=179)]
G:2 Maze real addr: 234163 - 0x0392B3, bank 0, boff: 0x0000
Maze read from: 0x0392b3 - 234163
compresssed: 243
 07 00 00 0D 00 11 40 5C AE 5D 48 38 80 DC 38 47
 A0 64 0F C5 2E A0 1C 58 A4 1C A4 3A 81 A5 1C A3
 1C 45 42 A0 1C C2 04 A3 1C 42 A0 1C C1 2F F2 10
 DD 1C A2 08 80 07 80 09 80 A1 C1 66 1D A4 1E D8
 08 1C 42 A1 63 A2 7F E6 55 A1 1C 42 B5 77 C1 A2
 C3 B3 C6 A4 1D 77 43 09 82 1C C3 65 1C C4 62 08
 1C 46 A0 1C 41 A0 1C 4E A1 1D 45 A3 1C 08 80 07
 80 C8 BA 1C C1 60 09 08 07 A1 4A 09 80 56 A0 DA
 BF 42 49 B2 1C C1 A3 1D 42 B5 69 A2 1C 08 81 04
 1E 44 A4 1C 48 42 A0 41 A0 1C 49 C3 63 B5 C1 61
 62 A0 1C D3 1C 07 82 1D 43 07 81 08 81 09 82 4B
 41 A2 DA 2F 4B A0 43 B4 D1 B2 C1 A3 1C A4 1C CA
 A6 1C C1 61 1D A0 C0 61 1C C8 B4 1C C6 10 A0 1D
 6E 62 1C A8 1C AA D2 1C 81 D0 BC 1C D2 33 42 B4
 C4 1E A9 C4 A9 1E CF 2E 1D 81 6C BE 33 CC 2E B4
 6C 3A 00
  Encoded length: 243 bytes
  Wall pattern: 01, Wall color: 00     Floor pattern: 01, Floor color: 04
  Flags: WALLS_CYCLIC 
  Random food adds: 5
  Secret trick:  7 - Save Super Shots
 02 02 02 02 02 02 02 02 02 02 02 02 02 02 02 02 02 02 02 02 02 02 02 02 02 02 02 02 02 02 02 02 02
 02 56 00 00 00 00 00 00 00 00 00 00 00 00 00 00 00 00 00 00 00 00 00 00 00 00 00 00 00 00 00 56 02
 02 00 00 00 00 00 00 00 28 02 46 00 00 00 00 00 15 00 00 00 00 00 00 46 02 28 00 00 00 00 00 00 02
 02 00 00 29 02 02 02 02 02 28 02 02 02 02 02 58 58 58 02 02 02 02 02 02 28 02 02 02 02 28 00 00 02
 02 00 00 02 28 00 00 00 28 02 28 00 00 00 04 02 02 02 02 28 00 00 00 28 02 28 00 00 47 02 00 00 02
 02 00 00 02 00 00 00 00 00 00 00 00 00 00 00 00 02 16 00 00 00 00 00 00 00 00 00 00 00 02 00 00 02
 02 00 00 02 00 00 00 00 00 00 00 00 00 00 00 00 28 02 02 02 08 08 07 07 09 09 02 02 00 02 46 00 02
 02 00 00 02 00 00 29 02 02 02 02 02 30 00 00 00 02 00 00 00 00 00 00 00 00 00 00 00 00 02 00 00 02
 02 00 00 02 00 00 08 28 00 00 00 28 02 02 46 00 02 00 00 02 02 02 00 00 00 00 00 00 00 02 00 00 02
 02 00 00 02 00 00 08 00 00 00 00 00 00 00 02 00 02 00 00 00 00 29 02 02 28 00 00 00 28 02 00 00 02
 02 00 00 02 00 00 08 00 00 02 02 02 00 00 00 00 02 00 00 00 00 00 00 00 02 02 02 02 02 29 00 00 02
 02 00 00 02 00 00 08 00 00 00 00 28 09 09 09 09 28 00 00 00 00 46 00 00 00 00 00 00 28 02 00 00 02
 02 00 46 02 00 00 08 28 00 00 00 00 00 00 00 28 02 28 00 00 28 02 28 00 00 00 00 00 00 02 00 00 02
 02 00 00 02 00 00 28 02 02 29 00 00 00 00 00 00 28 02 02 02 02 28 08 08 07 07 00 00 00 02 00 00 02
 02 00 00 02 28 00 02 46 00 09 08 07 02 02 00 00 02 00 00 00 00 00 00 00 00 28 09 09 00 02 00 00 02
 02 00 00 29 02 00 02 00 00 00 00 00 00 00 00 00 02 00 00 00 00 00 00 00 00 00 00 00 00 02 00 00 02
 02 00 00 02 28 00 02 00 00 00 00 00 00 00 00 28 02 28 00 00 02 02 02 02 29 00 00 00 28 02 46 00 02
 02 00 00 02 00 00 02 00 00 02 02 02 28 08 08 08 04 30 00 00 00 00 00 28 02 02 02 02 02 28 00 00 02
 02 00 00 02 00 00 02 28 00 00 00 28 02 00 00 28 02 28 00 00 00 00 00 00 00 00 00 00 28 02 00 00 02
 02 46 00 02 00 00 02 00 00 46 00 00 46 00 00 00 02 28 00 00 00 00 00 00 00 00 00 00 00 02 00 00 02
 02 00 00 02 00 00 28 07 07 07 07 29 00 00 00 00 28 07 07 07 08 08 08 09 09 09 09 00 00 02 00 00 02
 02 00 00 02 00 00 02 28 00 00 28 02 02 02 00 00 02 00 00 00 00 00 00 00 00 00 00 00 00 02 00 00 02
 02 00 00 02 00 00 02 00 00 47 00 00 00 00 00 00 02 00 00 00 00 00 28 02 00 00 00 00 28 02 00 00 02
 02 00 00 02 00 00 02 00 00 00 00 00 00 00 00 00 02 00 00 02 02 02 02 28 02 02 02 02 02 28 00 00 02
 02 00 00 02 00 00 02 00 00 02 02 02 02 02 02 02 28 00 00 46 00 00 29 02 00 46 00 00 28 02 00 00 02
 02 00 00 02 00 00 02 28 00 00 00 00 00 00 00 16 02 29 46 00 00 00 00 00 00 00 00 00 00 02 00 00 02
 02 00 46 02 00 00 28 02 02 02 02 02 02 02 02 02 28 02 02 02 02 02 02 02 02 02 02 02 00 02 00 00 02
 02 00 00 02 00 00 00 00 00 00 00 00 00 00 00 28 02 28 00 00 00 00 00 00 00 00 00 00 00 02 00 00 02
 02 00 00 02 28 00 00 00 00 00 00 00 00 00 00 00 02 00 00 00 00 00 00 00 51 00 00 00 28 02 00 00 02
 02 00 00 30 02 02 02 02 02 02 02 02 02 02 00 00 02 00 00 02 02 02 02 02 02 02 02 02 02 30 00 00 02
 02 00 00 00 00 00 00 00 00 00 00 00 00 00 46 29 02 29 46 00 00 00 00 00 00 00 00 00 00 00 00 00 02
 02 51 00 00 00 00 00 00 00 00 00 00 00 00 00 46 02 46 00 00 00 00 00 00 00 00 00 00 00 00 00 58 02
 02 02 02 02 02 02 02 02 02 02 02 02 02 02 02 02 02 02 02 02 02 02 02 02 02 02 02 02 02 02 02 02 02
