Gauntlet II
Maze number: 62
Offset for maze 61: 236944 - 0x039d90
big endian buf: [%!l(uint8=0) %!l(uint8=3) %!l(uint8=157) %!l(uint8=144)]
G:2 Maze real addr: 245136 - 0x03BD90, bank 1, boff: 0x2000
Maze read from: 0x03bd90 - 245136
compresssed: 297
 0C 00 00 80 20 00 0F 0D 45 0E 5D C1 2F 1A C2 10
 C5 32 C1 1A C2 10 C2 1A C2 10 E2 1C A0 E0 1D 70
 A0 E0 60 1E 05 E0 E0 1D 70 A0 E0 E0 1D 70 A1 E0
 E0 60 18 05 E0 E0 E0 E0 E0 60 18 05 E0 E0 60 18
 05 67 6C 66 DF CB 48 D5 2E C0 3A C2 2C C6 51 2E
 C7 48 51 C0 44 C1 2E C2 44 C3 2E 0E C4 2C CA 41
 C2 2C C6 41 C1 42 A0 42 C7 2C C9 41 2C C3 1C 35
 70 2E CB 01 C4 01 CC 51 C3 1C 54 DE 35 C5 54 E5
 C7 53 C3 55 C0 53 42 57 C0 52 C8 3A C4 54 C4 42
 C6 44 CA 2F C8 35 C0 0F C5 32 C8 56 C1 1C C6 43
 C1 42 71 C1 56 D7 35 C1 53 43 C6 2E 53 CE 1C 51
 C6 34 C1 56 42 A0 C0 54 35 01 1C 55 C9 48 57 C0
 40 2E E3 43 C6 54 CC 0E CA 55 35 22 35 55 C3 0E
 47 C2 47 C0 41 A0 42 A0 44 CB 35 C7 32 C0 35 20
 D2 20 C4 52 C5 47 A0 42 C4 01 C3 43 71 CB 32 35
 C6 53 C1 32 C4 53 C5 43 CB 43 51 C0 42 A0 C0 54
 7B C3 01 C7 0E C6 53 71 35 C8 56 34 C1 42 C0 42
 C6 44 53 C7 43 C0 2E 51 3A 0E C1 25 35 52 2E C9
 34 55 C1 55 35 C2 21 C0 00
  Encoded length: 297 bytes
  Wall pattern: 00, Wall color: 15     Floor pattern: 00, Floor color: 00
  Flags: WRAP_H EXIT_CHOOSE_ONE 
  Random food adds: 0
  Secret trick: 12 - Don't Be Greedy (no keys or potions)
 02 02 02 02 02 02 02 02 02 02 02 02 02 02 02 02 02 02 02 02 02 02 02 02 02 02 02 02 02 02 02 02
 00 00 47 26 00 00 00 16 00 00 00 00 00 00 50 00 00 26 00 00 00 16 00 00 00 26 00 00 00 16 00 00
 00 02 28 02 00 02 29 00 29 02 00 02 00 05 30 05 00 02 00 02 29 00 29 02 00 02 00 02 29 00 29 02
 02 00 02 00 02 00 05 24 05 00 02 00 02 00 02 00 02 00 02 00 05 24 05 00 02 00 02 00 05 24 05 00
 00 00 00 00 00 00 00 05 00 00 00 00 00 00 00 00 00 00 00 00 00 05 00 00 00 00 00 00 00 05 00 00
 00 00 00 00 00 00 00 00 00 00 00 00 00 00 00 00 00 00 00 00 00 00 00 00 00 00 00 00 00 00 00 00
 00 00 00 00 00 00 00 00 00 00 13 13 13 13 13 13 13 13 13 00 00 00 00 14 00 00 00 00 00 00 00 00
 00 00 00 00 00 00 00 00 00 46 14 58 00 00 00 44 00 00 14 00 00 00 00 14 46 00 00 00 00 00 00 00
 00 13 13 13 13 13 13 13 13 13 14 00 13 13 13 13 14 00 14 46 00 00 00 13 13 13 13 13 00 00 00 00
 46 14 00 00 00 00 00 44 00 00 00 00 14 00 00 00 14 00 14 13 13 00 00 14 44 00 00 00 00 00 00 00
 13 13 00 00 13 13 13 02 13 13 13 00 14 00 00 00 14 00 14 44 00 00 00 14 00 00 00 00 00 00 13 13
 44 14 00 00 14 28 53 14 29 46 14 00 14 00 14 00 14 00 14 00 00 00 01 14 00 00 14 00 01 00 00 00
 00 14 00 00 14 00 00 14 00 00 14 00 14 00 14 28 14 00 14 00 14 00 00 14 00 00 14 00 00 00 00 00
 00 14 00 00 14 00 00 14 00 00 00 00 14 00 14 00 53 00 14 00 14 00 00 14 00 00 14 00 00 14 02 14
 00 14 00 00 14 00 00 14 00 00 00 00 14 00 14 13 13 13 14 00 14 00 00 00 00 00 14 00 00 14 58 14
 00 14 00 00 14 00 00 00 00 14 13 13 13 00 00 00 00 00 00 00 13 13 14 13 13 00 14 00 00 14 00 14
 00 14 00 14 47 14 00 00 00 14 00 00 00 00 53 00 15 00 00 00 00 00 14 50 00 00 14 00 00 14 00 14
 00 14 00 14 28 14 00 00 00 14 00 14 13 13 13 14 00 14 13 13 13 00 14 29 00 00 14 00 00 14 00 14
 00 00 00 14 00 14 00 00 00 14 00 14 00 00 00 14 00 14 00 53 14 00 14 13 13 13 13 00 00 14 00 14
 00 00 46 14 00 14 00 00 00 14 00 14 00 00 00 14 00 14 00 28 14 00 00 00 00 00 00 00 52 14 00 14
 13 13 13 02 00 14 53 01 28 14 00 14 00 00 00 14 00 14 00 00 13 13 13 13 13 13 13 13 13 14 00 13
 46 00 00 00 00 02 13 13 13 13 00 14 00 00 00 14 00 14 00 00 00 00 00 00 00 00 00 00 00 00 00 14
 00 00 00 00 00 00 00 00 00 00 00 14 53 34 53 14 00 00 00 00 14 13 13 13 13 13 13 13 13 00 00 00
 13 13 13 13 13 13 13 14 00 13 13 02 13 13 13 02 13 13 13 13 13 00 00 00 00 00 00 00 14 00 00 00
 14 53 00 00 00 00 00 14 00 14 50 14 53 32 00 00 00 00 00 00 00 00 00 00 00 00 00 00 14 00 00 00
 14 32 00 00 00 00 00 14 00 14 00 14 00 00 13 13 13 13 13 13 13 13 02 13 13 13 00 00 14 00 00 01
 14 00 00 00 13 13 13 13 00 14 29 14 00 00 14 00 00 00 00 00 00 00 14 50 53 14 00 00 14 00 00 00
 14 00 00 50 14 00 00 00 00 14 00 14 00 00 14 00 13 13 13 14 00 00 14 00 00 14 00 00 14 00 00 00
 13 13 13 13 14 00 13 13 13 02 00 14 00 00 14 00 00 00 00 14 00 00 14 00 29 14 00 00 14 01 00 00
 00 00 00 00 00 00 14 00 00 14 00 00 00 00 14 00 00 29 53 14 00 00 14 00 00 14 00 00 14 52 00 00
 13 13 14 00 13 13 13 00 00 14 00 00 00 00 13 13 13 13 13 14 00 00 14 00 00 14 00 00 13 13 13 13
 00 46 14 58 14 00 00 37 53 14 46 00 00 00 00 00 00 00 00 00 00 52 14 00 00 14 53 00 00 00 33 00
 02 02 02 02 02 02 02 02 02 02 02 02 02 02 02 02 02 02 02 02 02 02 02 02 02 02 02 02 02 02 02 02
