Gauntlet II
Maze number: 49
Offset for maze 48: 233641 - 0x0390a9
big endian buf: [%!l(uint8=0) %!l(uint8=3) %!l(uint8=144) %!l(uint8=169)]
G:2 Maze real addr: 241833 - 0x03B0A9, bank 1, boff: 0x2000
Maze read from: 0x03b0a9 - 241833
compresssed: 305
 05 00 00 00 00 61 C0 45 81 43 6F C9 0E 0B CE 21
 A0 C6 33 CF 1E E4 71 E3 E0 C0 A1 1D A8 E4 D0 B2
 C5 31 23 71 C5 19 64 A0 C5 0E 0C C8 A1 C0 A2 C7
 1C C2 A7 C5 18 07 C0 07 18 C3 1E E3 C4 0F C2 31
 23 C5 18 07 C0 07 18 E3 35 C3 31 7C C1 A1 01 A2
 2F E6 C2 A1 C0 A2 C7 1E C2 1E CC 18 07 E0 72 CB
 21 C4 35 E0 C2 18 07 40 EF C6 1C E3 0A A0 CA 65
 0A 19 E3 53 E0 C1 2E 80 A2 2E 81 C1 1A 62 2F E0
 E8 03 63 1A 81 F0 D7 1E C2 BF E7 C9 BF 15 C2 15
 E1 E2 E1 CA 35 C4 61 60 BC C4 3F C1 1C E4 C5 BF
 C1 35 C5 3F C0 19 35 E4 C5 A2 C7 15 C2 15 CA 35
 CF 61 68 A0 C1 BF A0 C3 BF C1 21 81 C2 15 C2 15
 70 C2 21 CE 08 B3 09 C4 B7 EA E5 C3 08 18 09 C3
 60 61 A0 E0 E0 E8 C4 08 18 09 C3 10 31 10 C1 2E
 03 40 36 E2 C8 31 3E 08 18 09 3E 31 70 72 A1 50
 50 C5 B4 A2 42 85 A5 B7 2E 05 E0 E3 C0 66 05 86
 43 E0 50 40 52 48 81 B2 05 81 BB 54 40 35 A0 E3
 1C A0 E0 F0 50 40 C0 A1 18 52 E7 C0 3E E0 46 E0
 50 37 BC 31 C0 67 B9 35 A0 E2 E5 38 A0 40 35 A0
 00
  Encoded length: 305 bytes
  Wall pattern: 01, Wall color: 00     Floor pattern: 06, Floor color: 12
  Flags: 
  Random food adds: 0
  Secret trick:  5 - Watch What You Shoot (shoot foods)
 02 02 02 02 02 02 02 02 02 02 02 02 02 02 02 02 02 02 02 02 02 02 02 02 02 02 02 02 02 02 02 02 02
 02 00 00 00 00 00 00 00 00 00 14 11 00 00 00 00 00 00 00 00 02 00 00 00 00 00 00 33 02 00 00 00 02
 02 00 00 00 51 00 00 00 00 00 02 00 00 00 00 00 00 00 00 00 02 30 00 00 00 00 00 02 00 00 47 00 02
 02 00 00 02 00 02 00 02 02 29 02 02 02 02 02 02 02 02 02 00 02 00 00 00 02 00 00 00 00 00 00 00 02
 02 00 00 00 00 00 00 00 00 00 02 00 00 00 00 00 02 49 35 00 02 47 00 00 00 00 00 00 25 01 00 00 02
 02 00 00 02 00 00 00 00 00 00 14 12 00 00 00 00 02 00 00 00 02 02 02 00 02 02 02 00 00 00 00 00 02
 02 00 00 28 00 00 02 02 02 02 02 02 02 02 02 00 02 00 00 00 02 24 07 00 07 24 02 00 00 00 30 00 02
 02 00 00 02 00 00 02 00 00 15 00 00 02 49 35 00 02 00 00 00 02 24 07 00 07 24 02 00 00 00 02 53 02
 02 00 00 00 49 00 02 00 00 00 00 00 02 00 00 00 02 00 47 00 02 02 02 01 02 02 02 47 00 00 00 00 02
 02 00 00 02 00 00 02 02 02 00 02 02 02 00 00 00 02 00 00 00 02 30 00 00 00 30 02 00 00 00 00 00 02
 02 00 00 00 00 00 02 24 07 00 02 00 02 00 47 00 02 00 00 00 02 00 00 00 00 00 02 33 00 00 00 00 02
 02 53 00 02 00 00 02 24 07 00 05 00 02 00 00 00 02 00 00 00 02 00 00 00 00 00 02 02 00 00 00 00 02
 02 00 00 28 00 00 02 00 02 10 02 00 02 00 00 00 02 00 00 00 02 00 01 00 00 00 02 00 00 10 25 00 02
 02 00 00 02 00 00 02 00 03 00 02 00 02 46 46 02 02 02 46 46 02 00 00 26 01 00 02 00 47 00 02 00 02
 02 00 00 00 00 00 02 00 02 03 01 00 02 00 00 26 02 26 00 00 02 00 00 00 00 00 02 00 00 00 00 00 02
 02 00 00 02 00 00 02 00 00 00 00 00 02 00 00 00 02 00 00 00 02 00 00 02 00 00 02 00 30 00 00 00 02
 02 00 00 00 00 00 02 00 00 02 00 00 02 00 00 00 02 00 00 00 02 21 00 02 00 21 02 00 02 00 00 00 02
 02 00 00 02 00 00 02 00 00 00 00 00 02 00 00 53 02 00 00 00 02 01 00 02 01 00 02 00 00 00 00 00 02
 63 00 00 28 00 00 02 00 00 02 00 00 02 00 00 00 02 00 00 53 02 00 00 02 00 00 63 00 25 53 00 00 63
 02 00 00 02 00 00 02 00 00 00 02 02 02 00 00 00 02 00 00 00 02 21 00 02 00 21 02 00 00 00 00 00 02
 02 00 00 00 00 53 02 00 00 00 00 00 02 00 00 00 02 00 00 00 02 00 01 02 00 01 02 00 00 00 00 00 02
 02 00 00 02 00 00 02 02 00 00 00 00 02 00 00 33 02 33 00 00 02 21 00 02 00 21 02 47 00 00 00 33 02
 02 00 00 00 00 00 02 00 00 00 00 00 02 00 00 08 02 09 00 00 02 00 00 02 00 00 02 00 00 00 00 00 02
 02 00 00 02 00 00 02 00 00 00 02 00 02 00 00 08 24 09 00 00 02 00 01 00 01 00 02 02 00 02 00 02 02
 02 00 00 00 00 00 02 00 00 02 00 00 02 00 00 08 24 09 00 00 02 00 16 49 16 00 02 46 03 00 05 54 02
 02 00 00 02 00 00 02 00 00 00 00 00 02 49 62 08 24 09 62 49 02 47 00 00 00 47 02 02 00 03 00 03 02
 02 00 00 00 00 00 02 02 02 02 00 00 02 05 05 05 02 05 05 05 02 02 02 02 02 02 02 46 05 00 02 00 02
 02 00 00 02 00 01 00 00 00 00 00 00 02 05 05 05 02 05 05 05 02 00 00 00 00 05 00 02 00 03 00 05 02
 02 00 00 03 00 00 00 00 00 00 00 00 02 05 05 05 02 05 05 05 02 00 00 00 00 00 03 00 05 53 02 00 02
 02 00 00 02 28 02 00 02 00 00 00 00 02 00 00 00 00 00 00 00 00 00 00 00 00 02 00 03 00 05 00 02 02
 02 24 00 00 00 03 00 00 00 00 00 00 02 00 02 00 62 00 02 00 00 00 00 00 00 00 05 00 02 00 03 55 02
 02 49 00 01 00 00 00 00 00 00 00 00 02 53 02 00 00 00 02 00 00 00 00 00 00 02 56 02 00 05 53 02 02
 02 02 02 02 02 02 02 02 02 02 02 02 02 02 02 02 02 02 02 02 02 02 02 02 02 02 02 02 02 02 02 02 02
