Gauntlet II
Maze number: 9
Offset for maze 8: 231339 - 0x0387ab
big endian buf: [%!l(uint8=0) %!l(uint8=3) %!l(uint8=135) %!l(uint8=171)]
G:2 Maze real addr: 231339 - 0x0387AB, bank 0, boff: 0x0000
Maze read from: 0x0387ab - 231339
compresssed: 173
 0F 00 00 10 00 82 48 9C 47 48 6E 0F 80 C4 37 53
 C1 33 C0 18 61 C2 31 C5 37 5B 66 D4 1D 60 C6 09
 C5 20 C1 20 DF D1 15 78 71 C8 B5 C4 20 DF C1 15
 7E DE A4 DF D0 1E C8 32 1D DF C7 35 C3 BB CF 09
 80 07 A7 B9 C6 B9 FD C4 BD CB 20 EA E4 44 09 BF
 EF E4 44 07 C1 A9 E4 E4 44 A0 C2 18 C1 15 80 E8
 E4 44 A0 F0 EB F0 EB C0 22 C3 37 E9 EB C0 09 54
 80 09 A7 E4 E5 E2 F2 44 A0 E4 CA 1E E4 44 A0 66
 2F C0 31 EB 44 A0 C2 32 73 08 AD 44 A0 C4 22 E2
 F3 E0 E6 F3 C0 22 E0 E4 C4 21 70 6B E4 62 D3 08
 56 C0 09 C4 BE 37 5C 77 A0 2E C3 10 00
  Encoded length: 173 bytes
  Wall pattern: 02, Wall color: 08     Floor pattern: 08, Floor color: 04
  Flags: WALLS_DELETABLE1 
  Random food adds: 0
  Secret trick: 15 - Be Pushy
 02 02 02 02 02 02 02 02 02 02 02 02 02 02 02 02 02 02 02 02 02 02 02 02 02 02 02 02 02 02 02 02 02
 02 15 00 00 00 00 00 55 02 00 00 00 08 00 00 51 02 24 00 00 07 00 00 00 49 02 00 00 00 00 00 55 02
 02 00 00 00 00 00 00 00 02 00 00 00 08 00 00 00 02 00 00 00 07 00 00 00 00 02 00 00 00 00 00 00 02
 02 00 00 00 00 00 00 00 02 00 29 00 07 00 00 00 02 00 00 00 09 00 00 00 00 02 00 32 00 00 32 00 02
 02 00 00 00 00 00 00 00 02 00 00 00 02 00 00 00 02 00 00 00 02 00 00 00 00 02 00 00 00 00 00 00 02
 02 00 00 00 00 00 00 00 02 00 00 00 02 00 00 00 02 21 00 00 02 00 00 00 00 02 00 46 00 00 46 00 02
 02 00 00 00 00 00 00 00 02 00 00 00 02 00 32 00 02 00 00 00 02 00 00 00 00 02 00 00 00 00 00 00 02
 02 00 00 00 00 00 00 00 00 00 00 00 02 00 00 00 02 21 00 00 02 00 00 00 00 02 00 00 00 00 00 00 02
 02 46 00 00 00 00 00 00 00 00 00 00 02 00 00 00 02 00 00 00 02 00 00 00 00 02 00 00 00 00 00 00 02
 02 02 02 02 02 02 00 00 00 00 00 00 02 00 00 00 02 00 00 00 02 00 00 00 00 02 00 00 00 00 00 00 02
 02 00 00 00 00 00 00 00 00 00 00 00 02 00 00 00 02 00 00 00 02 00 00 30 00 02 00 00 00 00 00 00 02
 02 50 29 00 00 00 00 00 00 00 00 00 02 00 00 00 02 00 00 00 02 00 00 00 00 02 00 00 00 00 00 00 02
 02 00 00 00 00 00 00 00 00 00 00 53 02 00 00 00 02 00 00 00 02 00 00 00 00 02 00 00 00 00 00 00 02
 02 09 09 07 02 02 02 02 02 02 02 02 02 00 00 00 00 00 00 00 02 00 00 00 00 02 00 00 00 00 00 00 02
 02 00 00 00 00 00 00 00 00 00 00 00 00 00 00 00 00 00 00 02 00 00 00 00 00 02 00 00 00 00 00 00 02
 02 00 00 00 00 00 32 00 00 00 00 00 00 00 00 00 00 00 02 00 00 00 00 00 02 28 00 00 00 00 00 09 02
 02 00 00 00 00 00 00 00 00 00 00 00 00 00 00 00 00 02 00 00 00 00 00 02 28 00 00 00 00 00 07 00 02
 02 02 02 02 02 02 02 02 02 02 02 00 00 00 00 00 02 00 00 00 00 00 02 28 00 00 00 00 00 02 00 00 02
 02 24 00 00 21 21 00 00 00 00 00 00 00 00 00 02 00 00 00 00 00 02 28 00 00 00 00 00 02 00 00 00 02
 02 00 00 00 00 00 00 00 00 00 00 00 00 00 02 00 00 00 00 00 00 00 00 00 00 00 00 02 00 00 00 00 02
 02 00 00 00 00 00 00 00 00 00 00 00 00 02 00 00 00 00 00 00 00 00 00 00 00 00 02 00 34 00 00 00 02
 02 55 00 00 00 00 00 00 00 00 00 00 02 00 00 00 00 00 00 00 00 00 00 00 00 02 00 09 00 00 00 00 02
 02 08 08 09 02 02 02 02 02 02 02 02 00 00 00 00 00 02 00 00 00 00 00 00 02 00 00 00 02 00 00 00 02
 02 00 00 00 00 00 00 00 00 00 00 00 00 00 00 00 02 28 00 00 00 00 00 02 00 00 00 00 00 02 00 00 02
 02 00 00 00 00 00 00 00 00 30 00 00 00 00 00 02 28 00 00 00 00 00 02 00 00 00 00 00 00 00 07 47 02
 02 49 00 00 00 00 00 00 00 00 00 00 00 00 02 28 00 00 00 00 00 02 00 00 00 50 00 00 00 00 46 08 02
 02 02 02 02 02 02 02 02 02 02 02 02 02 02 28 00 00 00 00 00 02 00 00 00 00 00 34 00 00 00 02 00 02
 02 00 00 00 00 00 00 00 00 00 00 00 00 00 00 00 00 00 00 02 00 02 00 00 00 00 00 00 00 02 00 00 02
 02 00 00 00 00 00 00 00 00 00 00 00 00 00 00 00 00 00 02 00 34 00 02 00 00 00 00 00 02 00 00 00 02
 02 00 33 00 46 00 00 00 00 00 00 00 00 00 00 00 00 07 00 00 00 00 00 02 00 00 00 07 00 00 00 00 02
 02 00 00 00 00 00 00 00 00 00 00 00 00 00 00 00 08 00 00 00 00 00 00 00 08 00 09 00 00 00 00 00 02
 02 55 00 00 00 00 00 00 00 00 00 00 00 00 00 08 00 00 00 00 00 00 00 00 46 02 46 00 00 00 00 16 02
 02 02 02 02 02 02 02 02 02 02 02 02 02 02 02 02 02 02 02 02 02 02 02 02 02 02 02 02 02 02 02 02 02
