Gauntlet II
Maze number: 92
Offset for maze 91: 230033 - 0x038291
big endian buf: [%!l(uint8=0) %!l(uint8=3) %!l(uint8=130) %!l(uint8=145)]
G:2 Maze real addr: 254609 - 0x03E291, bank 3, boff: 0x6000
Maze read from: 0x03e291 - 254609
compresssed: 271
 0A 00 20 08 00 22 D2 AE 83 5D 6F C5 38 C1 2E A0
 2E A0 C4 2C A0 41 A0 C9 0F C2 20 C1 62 2C A0 2E
 A0 C1 A2 C3 25 A0 EF C1 A2 C2 29 A0 C2 A1 C0 A1
 1D C7 10 F0 42 A0 C6 B4 A3 04 AA E0 2E A0 CA 07
 C4 41 2F C0 32 C1 46 A0 57 07 CF A1 2E A1 42 35
 C2 31 C0 07 C5 15 C3 15 70 C1 2E A1 E1 C2 A6 C4
 A4 04 EA C1 1E C9 B4 2E 80 2F 2E 80 A0 C4 22 B3
 C1 20 CE 3F C4 3F C1 41 A0 C2 A1 CC 35 A0 C2 29
 E6 C7 08 81 A8 EC E1 C3 1B CC 23 73 C3 2E A0 D6
 15 E5 E1 20 A0 BF C7 38 C5 29 EC C6 09 A1 09 CA
 4F A0 15 80 A0 C5 23 56 A0 51 A0 E7 15 80 A0 C6
 35 C6 4B 09 A1 09 E6 B8 71 BF C3 B2 51 D1 40 15
 C7 B2 C0 A2 CD 35 C4 41 B3 B2 C9 23 C0 29 C0 23
 C0 A5 B3 E3 B2 F2 41 32 C5 18 05 C6 62 1D 50 C0
 A3 04 C9 05 80 61 60 60 69 35 A0 71 15 71 C0 2E
 B3 D4 A4 04 A3 04 D1 19 C1 09 DE 09 D8 19 C4 09
 C2 19 C1 2C C3 19 C8 BE 47 09 D1 1A C0 35 00
  Encoded length: 271 bytes
  Wall pattern: 02, Wall color: 02     Floor pattern: 02, Floor color: 13
  Flags: FAST_AUX_GRUNTS WALLS_CYCLIC 
  Random food adds: 0
  Secret trick: 10 - Try Pushing a Wall
 02 02 02 02 02 02 02 02 02 02 02 02 02 02 02 02 02 02 02 02 02 02 02 02 02 02 02 02 02 02 02 02 02
 02 00 00 00 00 00 56 02 00 46 02 46 02 00 00 00 00 00 44 02 46 00 00 02 00 00 00 00 00 00 00 00 02
 02 00 15 00 00 00 32 02 00 03 00 00 00 44 02 46 02 00 00 02 02 02 00 00 00 00 37 02 00 00 00 00 02
 02 00 00 00 00 00 00 02 00 00 00 00 02 00 00 02 02 02 00 00 00 41 02 00 00 00 02 02 00 02 02 29 02
 02 00 00 00 00 00 00 02 16 00 00 00 00 00 00 00 00 00 00 00 00 00 00 00 00 00 02 46 00 00 00 02 02
 02 00 00 00 00 00 00 02 02 02 02 02 04 02 02 02 02 02 02 02 02 02 02 02 00 02 46 02 00 00 00 00 02
 02 00 00 00 00 00 00 07 00 00 00 00 02 46 00 00 47 00 50 00 00 46 02 00 00 00 00 00 00 02 00 00 02
 02 00 00 00 00 00 29 07 00 00 00 00 02 00 00 00 00 00 00 00 00 00 02 00 02 02 46 02 02 46 00 00 02
 02 53 00 00 00 49 00 07 00 00 00 00 02 00 21 00 00 00 00 21 00 47 02 00 46 02 02 00 00 02 00 00 02
 02 02 02 02 02 02 02 02 00 00 00 00 02 02 02 02 02 02 04 00 00 00 02 00 00 02 00 00 00 00 02 00 02
 02 30 00 00 00 00 00 00 00 00 00 00 02 46 46 47 46 46 02 00 00 00 02 00 34 02 00 00 32 00 00 00 02
 02 00 00 00 00 00 00 00 00 00 00 00 63 00 00 00 00 00 63 00 00 46 02 00 02 00 00 00 02 02 00 00 02
 02 00 00 00 00 00 00 00 00 00 00 53 02 00 00 00 41 00 02 00 00 00 02 00 02 00 00 00 00 00 00 00 02
 02 08 08 08 02 02 02 02 02 02 02 02 02 00 00 00 00 00 02 00 00 00 02 00 00 00 02 00 00 02 00 00 02
 02 00 27 00 00 00 00 00 00 00 00 00 00 00 00 00 35 00 02 00 00 47 02 00 00 00 46 02 00 00 00 00 02
 02 00 00 00 00 00 00 00 00 00 00 00 00 00 00 00 00 00 02 21 00 00 02 00 00 00 02 00 00 02 32 02 02
 02 00 00 00 00 00 00 00 00 56 00 00 00 00 00 00 41 00 02 00 00 00 02 00 00 00 00 00 00 00 02 00 02
 02 00 00 00 00 00 09 02 02 09 00 00 00 00 00 00 00 00 02 00 00 46 02 00 00 00 00 00 00 00 00 00 02
 02 00 00 00 00 00 02 21 21 02 00 00 00 00 00 00 35 00 02 00 00 00 02 00 29 02 00 02 29 02 00 00 02
 02 00 00 00 00 00 02 21 21 02 00 00 00 00 00 00 00 53 02 00 00 00 02 00 02 46 00 02 02 00 00 00 02
 02 00 00 00 00 00 09 02 02 09 00 00 00 00 00 00 02 02 02 00 00 47 02 00 02 02 00 02 02 00 29 00 02
 02 00 00 00 00 00 00 00 00 00 00 00 00 00 00 00 02 46 00 21 00 00 02 00 02 02 00 00 02 00 02 02 02
 02 00 00 00 00 00 00 00 00 00 00 00 00 00 00 53 02 00 00 00 00 46 02 00 02 02 00 00 00 00 00 00 02
 02 00 00 00 35 00 41 00 35 00 02 02 02 02 02 02 02 00 00 00 02 02 02 00 00 00 00 00 00 00 00 00 02
 02 00 00 00 00 00 00 00 00 00 02 46 00 00 50 00 00 00 00 00 02 24 05 00 00 00 00 00 00 00 03 00 02
 02 00 29 00 29 00 02 02 02 02 04 00 00 00 00 00 00 00 00 00 02 05 05 03 00 00 03 00 03 00 03 00 02
 02 00 00 00 00 00 00 00 00 53 02 00 00 47 21 00 00 47 00 46 02 00 00 00 00 00 00 00 00 00 00 00 02
 02 00 00 00 00 00 00 00 00 00 02 02 02 02 02 04 02 02 02 02 04 00 00 00 00 00 00 00 00 00 00 00 02
 02 00 00 00 00 00 00 25 00 00 09 00 00 00 00 00 00 00 00 00 00 00 00 00 00 00 00 00 00 00 00 00 02
 02 00 00 00 00 00 00 00 00 00 09 00 00 00 00 00 00 00 00 00 00 00 00 00 00 00 00 00 00 00 00 00 02
 02 00 00 00 25 00 00 00 00 00 09 00 00 00 25 00 00 44 00 00 00 00 25 00 00 00 00 00 00 00 00 00 02
 02 46 00 00 00 00 00 00 00 00 09 00 00 00 00 00 00 00 00 00 00 00 00 00 00 00 00 00 00 26 00 53 02
 02 02 02 02 02 02 02 02 02 02 02 02 02 02 02 02 02 02 02 02 02 02 02 02 02 02 02 02 02 02 02 02 02
