Gauntlet II
Maze number: 47
Offset for maze 46: 233017 - 0x038e39
big endian buf: [%!l(uint8=0) %!l(uint8=3) %!l(uint8=142) %!l(uint8=57)]
G:2 Maze real addr: 241209 - 0x03AE39, bank 1, boff: 0x2000
Maze read from: 0x03ae39 - 241209
compresssed: 286
 10 43 11 00 00 34 D9 AE FF 7E 41 35 80 1D C3 06
 86 03 CE 32 C6 06 86 C1 05 80 D3 06 86 03 E3 29
 A0 E0 E0 C8 63 62 60 A4 E0 E0 1E A0 C1 2E 83 CE
 15 1A 2F C1 24 C2 24 C9 1F A0 1F A0 E4 1A A4 CC
 31 5C 1E C0 31 C8 19 C1 19 67 62 A0 32 A4 E3 03
 05 E2 C1 35 56 C5 15 C0 2F 52 C6 29 CF A4 DA 3E
 1E C0 31 C6 1D E1 C7 61 62 60 A3 B8 E5 C1 23 C4
 1C C1 1E C6 0E 5D E4 15 C8 0E E3 C7 19 32 A0 CD
 A1 C3 23 A0 C2 1D C4 1C C0 BF C0 1C CA 1D A7 B8
 3E 53 E3 CA 08 18 15 EB C7 15 80 3F C2 3F A0 08
 CD 1D 72 71 C8 08 C0 18 A1 05 03 A5 BF D1 08 C0
 15 C0 2F EA 19 71 80 C1 32 0B C5 08 18 C1 2F CB
 1B C5 A3 0D 81 A0 1D 08 80 B6 AE 01 71 BB C1 41
 0B CA 40 20 C4 44 0E D1 B2 C7 0A C2 0E DA 07 80
 C1 03 C1 0A C0 46 40 1F E6 20 C4 18 C0 07 C3 A8
 B2 A8 E3 0D 80 A1 C3 10 4F C4 35 E2 C3 31 14 10
 E1 C8 1D A0 1A C8 0E C3 33 14 10 C5 23 A0 1A C9
 BE 0F C1 35 0E C0 0A 35 B9 10 4F C2 2E 00
  Encoded length: 286 bytes
  Wall pattern: 04, Wall color: 09     Floor pattern: 03, Floor color: 13
  Flags: ODDANGLE_GRUNTS FAST_SORCERERS ODDANGLE_GHOSTS FAST_GHOSTS ODDANGLE_DEATHS 
  Random food adds: 0
  Secret trick: 16 - IT Could Be Nice
 02 02 02 02 02 02 02 02 02 02 02 02 02 02 02 02 02 02 02 02 02 02 02 02 02 02 02 02 02 02 02 02 02
 02 53 29 00 00 00 00 06 06 06 06 06 06 06 06 03 00 00 00 00 00 00 00 00 00 00 00 00 00 00 00 50 02
 02 00 00 00 00 00 00 06 06 06 06 06 06 06 06 00 00 05 05 00 00 00 00 00 00 00 00 00 00 00 00 00 02
 02 00 00 00 00 00 00 06 06 06 06 06 06 06 06 03 00 00 00 00 02 41 02 00 02 00 02 00 00 00 00 00 02
 02 00 00 00 02 02 02 02 63 02 02 02 63 02 63 02 02 02 02 02 00 02 00 02 30 02 00 02 46 46 46 46 02
 02 00 00 00 00 00 00 00 00 00 00 00 00 00 00 00 21 26 47 02 00 36 00 00 00 36 00 02 00 00 00 00 02
 02 00 00 00 31 02 31 02 00 00 00 00 00 02 26 02 02 02 02 02 00 00 00 00 00 00 00 02 00 00 00 00 02
 02 49 00 00 00 00 00 00 00 00 00 00 00 00 00 62 30 00 49 02 00 00 00 00 00 00 00 02 25 00 00 25 02
 02 02 02 02 02 02 02 02 63 02 02 02 63 02 50 02 02 02 02 02 00 00 00 02 02 03 05 02 00 00 02 00 02
 02 53 00 00 00 00 00 00 00 62 00 00 00 00 00 00 21 00 47 02 00 00 62 02 00 00 00 02 00 00 41 00 02
 02 00 00 00 00 00 00 00 00 00 00 00 00 00 00 02 02 02 02 02 00 00 00 02 00 00 00 02 00 00 00 00 02
 02 00 00 00 00 00 00 00 00 00 00 00 00 00 00 62 30 00 49 02 00 00 00 02 00 00 29 02 00 02 00 00 02
 02 00 00 00 00 02 02 02 63 02 02 02 63 02 63 02 02 02 02 02 00 00 00 02 00 00 02 02 00 35 00 00 02
 02 00 00 28 00 02 30 00 00 00 00 00 00 00 14 00 00 00 00 00 00 00 00 02 00 00 00 02 00 62 00 00 02
 02 00 00 02 21 02 00 00 00 00 00 00 00 00 14 00 00 00 00 02 00 00 00 02 00 00 00 02 25 50 02 00 02
 02 00 00 00 00 02 00 00 00 00 00 00 00 02 02 00 00 00 00 35 02 00 00 02 29 00 00 02 00 00 28 00 02
 02 00 28 00 00 02 00 00 00 00 00 00 00 00 29 02 02 02 02 02 02 02 02 02 62 00 00 02 00 62 00 00 02
 02 00 02 00 00 02 00 00 00 00 00 00 00 00 08 24 21 02 00 00 00 00 00 00 00 00 00 02 00 02 00 00 02
 02 00 00 00 00 02 21 21 63 00 00 00 63 02 08 00 00 02 00 00 00 00 00 00 00 00 00 02 00 29 00 00 02
 02 01 00 00 01 02 00 00 00 00 00 00 00 00 08 00 24 02 02 05 03 02 02 02 02 02 02 02 00 00 00 00 02
 02 00 00 00 00 02 00 00 00 00 00 00 00 00 08 00 21 02 47 00 00 00 00 00 00 00 00 00 00 00 02 25 02
 02 00 01 01 00 02 50 11 00 00 00 00 00 00 08 24 00 02 47 00 00 00 00 00 00 00 00 00 00 00 00 27 02
 02 00 00 00 00 02 02 02 02 02 13 13 13 02 29 08 08 02 02 02 02 02 02 02 02 02 02 02 02 02 02 02 02
 02 01 00 00 01 02 00 00 46 02 00 11 00 00 00 00 00 00 00 00 00 00 00 46 02 32 00 00 00 00 00 46 02
 02 00 00 00 00 14 00 00 00 02 00 00 00 00 00 00 00 00 00 00 00 00 00 00 02 00 00 00 00 00 00 00 02
 02 10 00 00 00 14 00 00 00 02 00 00 00 00 00 00 00 00 00 02 00 00 00 00 00 00 00 00 00 00 00 00 02
 02 07 07 00 00 03 00 00 10 02 46 00 00 00 00 00 00 00 46 02 31 00 00 00 00 00 00 00 02 32 00 00 02
 02 00 00 24 00 07 00 00 00 02 02 02 02 02 02 02 02 02 02 02 02 02 02 02 02 02 02 02 02 00 00 00 02
 02 02 13 13 02 02 00 00 00 02 16 46 00 00 00 00 00 00 00 00 00 00 00 00 00 00 00 00 00 00 00 00 02
 02 53 00 00 00 02 00 00 00 02 49 20 16 00 00 02 00 00 00 00 00 00 00 00 00 29 02 26 00 00 00 00 02
 02 00 00 00 00 14 00 00 00 02 51 20 16 00 00 00 00 00 00 35 02 26 00 00 00 00 00 00 00 00 00 00 02
 02 15 00 00 53 14 00 10 53 02 16 46 00 00 00 00 00 00 00 00 00 00 00 00 00 00 00 00 00 00 00 46 02
 02 02 02 02 02 02 02 02 02 02 02 02 02 02 02 02 02 02 02 02 02 02 02 02 02 02 02 02 02 02 02 02 02
