Gauntlet II
Maze number: 50
Offset for maze 49: 233946 - 0x0391da
big endian buf: [%!l(uint8=0) %!l(uint8=3) %!l(uint8=145) %!l(uint8=218)]
G:2 Maze real addr: 242138 - 0x03B1DA, bank 1, boff: 0x2000
Maze read from: 0x03b1da - 242138
compresssed: 177
 07 22 00 80 01 20 FE 6E 9F 50 AC 10 80 D0 10 43
 1E 54 C6 1E C1 31 E3 D1 21 C3 A5 41 A1 62 A5 20
 C5 B2 45 C6 A1 D7 20 C5 33 CC A3 19 D6 21 42 D4
 73 A2 CC B2 C6 B3 4F C5 73 2E DF 4A CA A4 C4 A4
 2E C7 6F CC 31 A1 D9 73 2E C7 38 A1 65 A0 63 B8
 CA 2B 13 84 A0 C1 B6 C2 1D A0 2B C5 B4 C1 BF C3
 B6 E6 E5 31 A0 D2 2E E7 E2 C3 20 51 DA A5 C2 1C
 D9 2E C2 A3 C7 6F 43 C7 A4 C3 7F C0 3A 19 CF A3
 7A B5 44 13 81 1F B4 D6 38 CA 19 D1 1C D1 2E C7
 A3 D0 A3 D1 3A 13 82 31 45 D1 B2 C2 A4 C3 1E C2
 0F DF DB BE 4B B3 31 42 A0 61 A0 2E C1 21 A0 50
 00
  Encoded length: 177 bytes
  Wall pattern: 00, Wall color: 14     Floor pattern: 02, Floor color: 15
  Flags: ODDANGLE_GRUNTS ODDANGLE_GRUNTS EXIT_CHOOSE_ONE SHOTS_STUN 
  Random food adds: 0
  Secret trick:  7 - Save Super Shots
 02 02 02 02 02 02 02 02 02 02 02 02 02 02 02 02 02 02 02 02 02 02 02 02 02 02 02 02 02 02 02 02 02
 02 16 00 00 00 00 00 00 00 00 00 00 00 00 00 00 00 00 00 16 00 00 00 00 46 30 00 00 00 00 00 16 02
 02 00 00 02 00 00 00 30 00 00 49 00 00 00 00 02 00 00 00 00 00 00 00 00 00 00 00 00 00 00 00 00 02
 02 00 33 02 00 00 00 02 02 02 02 02 02 00 00 46 02 02 31 00 00 00 02 02 02 02 02 02 32 00 00 00 02
 02 00 00 02 00 00 00 00 00 00 46 00 00 00 00 00 00 00 02 02 00 00 00 00 00 00 00 00 00 00 00 00 02
 02 00 00 00 00 00 00 00 00 00 00 00 32 00 00 00 00 00 00 51 02 00 00 00 00 00 00 00 00 00 00 00 02
 02 02 02 02 02 25 00 00 00 00 00 00 02 00 00 00 00 00 00 00 02 00 00 00 00 00 02 00 00 33 00 00 02
 02 46 00 00 00 00 00 00 00 00 00 00 02 00 00 00 00 00 00 00 02 00 00 44 00 00 02 00 02 02 02 00 02
 02 00 00 00 00 00 00 00 00 00 00 00 02 00 00 00 00 00 00 00 02 00 00 00 00 00 02 00 00 00 00 00 02
 02 00 00 00 00 46 00 00 00 00 00 00 44 00 00 00 02 46 00 00 00 00 00 00 00 00 02 00 00 00 00 00 02
 02 00 00 00 00 02 00 00 00 00 00 00 00 00 00 00 02 00 00 00 00 00 00 00 00 00 02 00 00 46 00 00 02
 02 00 00 00 00 02 00 00 00 02 02 02 02 02 00 00 02 00 00 02 02 02 02 02 46 00 02 00 00 02 00 00 02
 02 31 00 00 00 02 00 00 00 00 00 00 00 00 00 00 02 00 00 00 00 00 00 00 00 00 02 00 00 02 00 49 02
 02 02 00 00 00 02 00 00 00 00 00 00 00 00 00 00 02 00 00 00 00 00 00 00 00 00 02 00 44 02 00 00 02
 02 46 00 00 00 02 00 00 00 00 56 02 02 31 00 00 02 00 00 00 02 31 00 00 00 00 02 00 00 02 00 00 02
 02 00 00 00 00 02 43 19 19 19 19 19 19 02 00 00 02 00 00 00 29 02 43 00 00 00 00 00 00 02 00 00 02
 02 00 00 00 00 02 00 00 00 00 00 00 00 02 00 00 00 00 00 00 02 49 02 00 00 00 00 00 00 00 00 00 02
 02 00 00 00 00 00 00 00 00 00 46 00 00 00 00 00 00 00 00 02 00 00 00 02 00 00 00 00 32 00 00 16 02
 02 00 00 00 00 00 00 00 00 00 02 00 00 00 00 00 00 00 00 00 00 00 00 00 00 00 00 02 02 02 02 02 02
 02 00 00 00 28 00 00 00 00 00 02 00 00 00 00 00 00 00 00 00 00 02 00 00 00 00 00 00 00 00 00 46 02
 02 00 00 02 02 02 02 00 00 00 02 00 00 00 00 31 00 00 00 00 00 02 00 00 00 00 00 00 00 00 00 00 02
 02 00 00 00 46 00 00 00 00 00 02 00 00 02 02 02 02 02 00 00 00 02 44 00 00 00 00 00 00 00 00 00 02
 02 00 00 00 00 00 00 00 58 25 02 00 00 00 00 00 00 00 00 00 00 02 00 00 00 00 02 02 02 02 44 00 02
 02 00 00 00 00 00 00 00 00 00 02 00 00 00 00 00 46 19 19 19 31 02 00 00 00 00 00 00 00 00 00 00 02
 02 00 00 00 00 00 00 00 00 00 00 00 00 56 00 00 00 00 00 00 00 00 00 00 00 25 00 00 00 00 00 00 02
 02 00 00 00 00 00 00 00 00 00 00 00 28 00 00 00 00 00 00 00 00 00 00 00 00 00 00 00 00 00 00 46 02
 02 00 00 00 00 00 00 00 02 02 02 02 00 00 00 00 00 00 02 00 00 00 00 00 00 00 00 00 00 02 02 02 02
 02 00 00 00 00 00 00 00 00 00 00 00 00 00 00 00 00 00 02 58 19 19 19 19 49 00 00 00 00 00 00 46 02
 02 00 00 00 00 00 00 00 00 00 00 00 00 00 02 00 00 00 02 00 00 00 02 02 02 02 02 00 00 00 00 30 02
 02 00 00 15 00 00 00 00 00 00 00 00 00 00 02 00 00 00 00 00 00 00 00 00 00 00 00 00 00 00 00 00 02
 02 00 00 00 00 00 00 00 00 00 00 00 00 00 02 00 00 00 00 00 00 00 00 00 00 00 00 00 00 00 00 00 02
 02 00 00 00 00 00 00 00 00 00 00 00 00 46 02 49 00 00 00 46 02 31 00 00 02 46 00 00 33 02 00 16 02
 02 02 02 02 02 02 02 02 02 02 02 02 02 02 02 02 02 02 02 02 02 02 02 02 02 02 02 02 02 02 02 02 02
