Gauntlet II
Maze number: 20
Offset for maze 19: 233888 - 0x0391a0
big endian buf: [%!l(uint8=0) %!l(uint8=3) %!l(uint8=145) %!l(uint8=160)]
G:2 Maze real addr: 233888 - 0x0391A0, bank 0, boff: 0x0000
Maze read from: 0x0391a0 - 233888
compresssed: 275
 0E 00 00 00 00 10 F7 49 6E 45 5E 23 80 C5 0E C4
 31 A0 C1 0A 60 50 C4 19 31 C0 10 E2 C3 0E E4 2E
 C0 35 0C E3 C4 A1 2E E1 15 A0 E2 62 A0 E2 0D B2
 E3 C2 07 C1 31 E2 35 E1 62 A0 E2 E2 E3 E0 E9 62
 A0 E2 E4 E3 EE E2 C3 33 E0 E2 EE E2 63 A0 E3 CB
 B2 E5 C2 36 A1 2E 41 A0 C8 0D 81 C0 29 E4 E0 31
 A1 33 C4 24 D6 0C 09 C2 B3 F6 E2 35 41 C5 B2 E0
 BA 65 82 E2 E2 0D 81 A0 0D E5 4E 21 B3 40 1E 70
 09 E5 C2 22 EB 40 21 A0 E2 E4 C0 21 C0 A2 4A E0
 40 24 41 E5 C3 BF 0F C2 21 E5 40 24 A0 E2 1E D5
 09 21 A0 40 2A 41 F6 40 2A A0 E2 D1 21 43 E0 40
 21 41 F6 50 E0 E2 D6 09 E0 2E 09 70 40 6F 82 C0
 BC C1 A4 09 A1 C6 B6 C3 20 C5 BF E1 E5 35 C0 24
 BE C9 35 C1 BF E2 E2 C0 1D C1 22 09 A2 09 A0 1F
 EF E2 E2 E5 F0 70 E0 E9 F0 E2 E4 E3 C8 B3 27 74
 A0 E2 E2 E3 1D A0 C7 15 A2 E4 52 E0 E3 E2 63 E5
 C4 A4 E3 E4 C1 BE 31 2E C4 18 A0 C6 35 0E 52 65
 A0 22 00
  Encoded length: 275 bytes
  Wall pattern: 00, Wall color: 07     Floor pattern: 01, Floor color: 15
  Flags: 
  Random food adds: 0
  Secret trick: 14 - Go On a Diet (no food)
 02 02 02 02 02 02 02 02 02 02 02 02 02 02 02 02 02 02 02 02 02 02 02 02 02 02 02 02 02 02 02 02 02
 02 35 00 00 00 00 00 00 14 00 00 00 00 00 49 02 00 00 10 02 46 00 05 00 00 00 00 00 25 49 02 16 02
 02 00 00 02 00 00 00 00 14 00 00 00 00 00 02 46 00 53 12 02 00 00 00 02 00 00 00 00 00 02 02 46 02
 02 00 02 21 02 00 00 00 02 00 00 00 46 02 00 00 00 02 13 02 00 00 00 00 02 00 00 00 07 00 02 49 02
 02 00 00 02 53 00 00 02 00 00 00 46 02 00 00 00 02 00 00 00 02 00 00 00 00 02 00 02 00 00 02 00 02
 02 00 00 00 00 00 02 00 00 00 46 02 00 00 00 02 00 00 00 00 00 02 00 00 00 00 02 00 00 00 02 00 02
 02 00 00 00 00 02 00 00 00 00 02 00 00 00 02 00 00 00 00 51 00 02 00 00 00 02 00 00 00 00 02 00 02
 02 00 00 00 00 02 00 00 00 02 00 00 00 02 00 00 00 00 46 02 02 00 00 00 02 00 00 00 00 00 02 00 02
 02 00 00 00 00 02 00 00 02 00 00 00 02 00 00 00 54 02 02 46 02 00 09 02 00 00 00 00 00 00 02 00 02
 02 13 13 13 02 41 00 00 02 00 00 02 00 02 49 02 02 51 00 00 02 00 02 36 00 00 00 02 00 00 02 00 02
 02 00 00 00 02 00 00 00 02 00 02 00 00 00 02 12 09 00 00 00 02 00 02 00 00 00 00 02 00 00 02 00 02
 02 00 00 00 02 00 00 00 02 00 02 00 02 00 02 00 02 53 00 00 09 00 02 00 00 00 00 02 00 02 02 00 02
 02 00 00 00 02 46 46 46 02 00 02 00 02 00 02 00 02 13 13 13 02 13 02 00 00 00 00 00 02 00 00 00 02
 02 00 00 00 02 00 00 00 02 00 02 00 09 33 02 00 09 30 00 30 09 00 02 00 00 00 00 02 00 00 00 34 02
 02 00 00 00 02 00 00 00 02 00 02 00 02 00 09 33 02 00 00 00 02 00 02 00 00 00 02 00 33 00 02 02 02
 02 00 00 00 02 00 00 00 02 00 02 00 09 00 02 00 09 36 00 00 09 00 02 00 00 00 00 02 00 00 00 00 02
 02 15 00 00 02 33 00 00 02 00 02 00 02 00 09 36 02 00 00 00 02 30 02 00 00 00 00 00 02 00 00 00 02
 02 00 00 00 02 00 00 00 02 00 02 00 09 33 02 00 09 42 00 00 09 00 02 00 00 00 00 00 02 00 00 00 02
 02 00 00 00 02 00 00 00 02 00 02 00 02 00 09 42 02 00 00 00 02 00 02 00 00 00 00 00 02 00 00 00 02
 02 00 00 00 02 00 00 33 02 00 02 00 09 00 02 00 09 33 00 00 09 00 02 00 00 00 00 00 02 00 00 00 02
 02 00 00 00 02 00 00 00 02 00 02 00 02 00 05 00 02 00 00 00 02 00 02 00 00 00 00 00 02 00 00 00 02
 02 00 00 00 02 00 00 00 02 00 02 00 09 00 02 46 09 00 30 00 09 00 02 00 00 00 00 00 02 00 00 00 02
 02 00 00 00 02 46 46 46 02 00 02 00 00 02 02 02 02 02 09 02 02 00 02 00 00 00 00 00 02 00 00 00 02
 02 32 00 00 02 00 00 00 02 00 00 02 00 00 00 00 00 00 02 53 00 36 02 00 00 00 00 00 00 00 00 00 02
 02 53 00 00 02 00 00 00 02 00 00 00 02 00 29 00 00 34 09 02 02 02 09 02 31 00 00 00 00 00 00 00 02
 02 00 00 00 02 00 00 00 00 02 00 00 00 02 00 00 00 02 00 00 00 00 00 00 02 00 00 00 00 00 00 00 02
 02 00 00 00 02 00 00 00 00 00 02 00 30 00 02 00 00 00 00 00 00 00 00 00 00 02 00 00 00 00 00 00 02
 02 00 00 00 02 00 00 00 00 00 00 02 00 00 00 02 00 00 00 00 00 02 00 00 00 00 02 00 00 00 00 00 02
 02 00 00 00 02 39 00 00 00 00 00 30 02 00 00 00 02 00 00 00 02 00 00 00 00 02 29 02 00 00 00 00 02
 02 00 00 00 21 02 02 02 00 00 00 00 00 02 00 00 00 05 00 02 00 00 00 00 02 00 00 00 02 00 00 00 02
 02 46 00 00 00 00 00 00 02 00 00 00 00 00 02 02 02 02 02 00 00 00 00 02 00 00 00 00 00 02 00 00 02
 02 49 46 00 00 00 00 00 24 02 00 00 00 00 00 00 00 53 14 00 00 00 05 00 00 00 00 00 00 46 02 34 02
 02 02 02 02 02 02 02 02 02 02 02 02 02 02 02 02 02 02 02 02 02 02 02 02 02 02 02 02 02 02 02 02 02
