Gauntlet II
Maze number: 64
Offset for maze 63: 229376 - 0x038000
big endian buf: [%!l(uint8=0) %!l(uint8=3) %!l(uint8=128) %!l(uint8=0)]
G:2 Maze real addr: 245760 - 0x03C000, bank 2, boff: 0x4000
Maze read from: 0x03c000 - 245760
compresssed: 380
 0C 00 00 00 00 31 BF 0D 9C 0E 85 33 80 15 C1 22
 E8 10 A0 21 E1 64 29 C0 15 33 C0 18 15 51 E5 C3
 09 81 E3 C5 51 18 15 42 75 1D A0 2F CF 05 42 E4
 05 81 AC 05 81 A1 CB 6E 6B 47 E0 E2 C1 46 C4 20
 35 C2 28 C3 62 A0 E0 61 22 C3 1D CB 43 E2 E2 C2
 43 C3 35 C2 2E B3 1D C2 3A 31 C3 1C A0 E0 35 C3
 18 3B C2 1D B3 C0 1E C2 72 51 18 37 51 E2 0C E1
 C1 35 51 38 31 51 C2 73 1D A0 C2 43 E3 E0 62 43
 E2 E4 C0 55 1D C3 28 55 E0 E2 C1 62 22 2F 55 E0
 C2 08 80 70 47 C0 1C A0 E0 C1 57 46 C0 05 2E C2
 35 73 1D E4 E2 2E C3 63 72 1D C1 A9 C5 A9 60 BF
 C2 32 18 35 18 C3 3E 81 C2 3E 81 18 35 18 C3 32
 C6 A8 B2 35 C3 B2 A9 C0 35 C7 1D C3 2E A0 E2 2E
 C3 1D C8 2E B4 C0 47 C7 46 C0 B4 2E C2 1F 07 C1
 20 C3 61 44 C1 23 C3 61 08 22 C3 07 C3 42 C2 0E
 C0 25 C0 0E C2 43 C2 08 C4 07 C3 37 31 C0 35 C1
 44 C3 31 38 C3 08 C4 07 62 18 3A C5 2F C4 51 36
 18 51 C1 1C 70 22 C6 53 41 53 C2 44 C1 35 43 C4
 35 C4 55 63 20 55 C0 0E C0 25 C0 0E C1 63 62 A2
 C1 B2 C0 47 C0 44 C0 57 45 56 C1 36 68 6D 63 B3
 C2 35 62 A1 05 A5 04 A6 05 A2 C2 1C 2E 42 73 1F
 2E CB 2E 1F C1 0B C1 05 42 15 18 C4 05 35 E1 E4
 C2 35 75 31 18 BE 31 15 51 61 0A 1F 2E C0 1C A0
 C1 0F E1 61 2E 1F C3 1D 51 15 35 00
  Encoded length: 380 bytes
  Wall pattern: 01, Wall color: 15     Floor pattern: 03, Floor color: 11
  Flags: 
  Random food adds: 0
  Secret trick: 12 - Don't Be Greedy (no keys or potions)
 02 02 02 02 02 02 02 02 02 02 02 02 02 02 02 02 02 02 02 02 02 02 02 02 02 02 02 02 02 02 02 02 02
 02 51 21 14 00 34 00 00 00 00 00 00 00 00 00 02 16 02 33 00 00 02 28 00 00 00 00 00 41 14 21 51 02
 02 24 21 14 00 00 00 00 00 00 02 00 00 00 00 09 09 09 00 00 00 00 02 00 00 00 00 00 00 14 24 21 02
 02 13 13 05 00 00 00 00 00 00 29 02 47 00 00 00 00 00 00 00 00 00 00 00 00 00 00 00 00 05 13 13 02
 02 00 00 00 00 00 02 05 05 05 02 02 02 02 02 02 02 02 02 02 02 02 02 05 05 05 02 02 00 00 00 00 02
 02 00 00 00 00 00 00 00 28 00 00 00 00 00 00 00 00 00 00 00 00 00 00 00 28 00 00 00 00 00 00 00 02
 02 00 00 02 00 13 13 13 13 13 13 13 13 00 02 00 00 00 02 00 14 13 13 13 13 13 13 13 00 02 00 00 02
 02 32 53 02 00 14 40 00 00 00 00 28 14 00 00 02 00 02 28 00 14 34 00 00 00 00 29 14 00 02 00 00 02
 02 00 00 02 00 14 00 13 13 13 13 00 14 00 02 00 00 00 02 00 14 00 13 13 13 13 00 14 00 02 53 00 02
 02 00 46 02 29 14 00 14 58 49 14 00 14 00 28 02 00 02 53 00 14 00 14 24 59 14 00 14 29 02 00 30 02
 02 00 00 05 00 14 00 14 24 55 14 00 14 00 02 12 00 00 02 00 14 53 14 56 49 14 00 14 00 05 00 00 02
 02 00 29 02 00 14 00 13 13 13 13 00 14 00 00 02 00 02 28 00 14 00 13 13 13 13 00 14 00 02 00 00 02
 02 00 00 02 00 14 29 00 00 00 00 40 14 00 02 00 00 00 02 00 14 28 00 00 00 34 47 14 00 02 00 00 02
 02 08 08 05 00 13 13 13 13 13 13 13 13 00 28 02 00 02 00 00 14 13 13 13 13 13 13 13 00 05 46 00 02
 02 00 53 05 00 00 00 00 29 00 00 00 00 00 02 00 00 00 02 46 00 00 00 00 28 00 00 00 00 05 00 00 02
 02 29 00 02 02 02 02 02 02 02 02 02 02 02 00 00 00 00 00 02 02 02 02 02 02 02 02 02 02 02 28 00 02
 02 00 00 02 50 24 53 24 00 00 00 00 62 02 62 00 00 00 62 02 62 24 53 24 00 00 00 00 50 02 00 00 02
 02 00 00 02 02 02 02 02 02 02 02 02 02 02 53 00 00 00 00 02 02 02 02 02 02 02 02 02 02 02 00 53 02
 02 00 00 02 00 00 00 00 29 00 00 00 00 46 02 00 00 00 02 46 00 00 00 00 29 00 00 00 00 02 00 00 02
 02 00 46 02 00 13 13 13 13 13 13 13 13 00 00 00 00 00 00 00 14 13 13 13 13 13 13 13 00 02 46 00 02
 02 00 31 07 00 14 32 00 00 00 00 28 14 00 13 13 13 13 13 00 14 35 00 00 00 00 28 14 00 08 34 00 02
 02 00 00 07 00 14 00 14 13 13 14 00 14 00 14 00 37 00 14 00 14 00 13 13 13 13 00 14 00 08 00 00 02
 02 00 00 07 00 14 00 14 55 49 14 53 14 00 13 13 13 13 13 00 14 00 14 49 56 14 00 14 00 08 00 00 02
 02 00 00 07 28 14 00 14 24 58 14 00 14 00 00 00 47 00 00 00 14 00 14 54 24 14 00 14 28 05 00 34 02
 02 00 00 02 00 14 00 14 13 13 14 00 14 00 13 13 13 13 13 00 14 53 13 13 13 13 00 14 00 02 00 53 02
 02 00 00 02 00 14 28 00 00 00 00 32 14 00 14 00 37 00 14 00 14 28 00 00 00 00 28 14 00 02 02 02 02
 02 00 00 02 00 13 13 13 13 13 13 13 13 00 13 13 13 13 13 00 14 13 13 13 13 13 13 14 00 02 54 28 02
 02 00 00 00 00 00 00 00 00 28 00 00 00 00 00 00 00 00 00 00 00 00 00 00 28 00 00 00 00 02 00 00 02
 02 53 28 00 00 00 02 02 05 02 02 02 02 02 02 04 02 02 02 02 02 02 02 05 02 02 02 00 00 00 28 46 02
 02 13 13 05 00 00 00 00 31 46 00 00 00 00 00 00 00 00 00 00 00 00 46 31 00 00 11 00 00 05 13 13 02
 02 21 24 14 00 00 00 00 05 53 00 00 02 00 00 00 00 00 02 00 00 00 53 05 00 00 00 00 00 14 49 24 02
 02 49 21 14 28 00 00 10 31 46 00 28 02 00 00 15 00 00 02 28 00 00 46 31 00 00 00 00 29 14 21 53 02
 02 02 02 02 02 02 02 02 02 02 02 02 02 02 02 02 02 02 02 02 02 02 02 02 02 02 02 02 02 02 02 02 02
