Gauntlet II
Maze number: 1
Offset for maze 0: 229856 - 0x0381e0
big endian buf: [%!l(uint8=0) %!l(uint8=3) %!l(uint8=129) %!l(uint8=224)]
G:2 Maze real addr: 229856 - 0x0381E0, bank 0, boff: 0x0000
Maze read from: 0x0381e0 - 229856
compresssed: 130
 00 00 00 00 00 61 1D 6E 54 0E 09 35 80 47 C4 31
 42 C9 35 6F DE 14 C8 1D C1 1D C4 1E CB 22 DE 14
 DD 0C 81 DF D9 09 81 C3 09 81 D0 58 DF C3 24 C6
 24 C2 59 DF D0 20 40 C0 74 C0 11 C0 74 40 C0 20
 C9 07 84 B3 A2 B5 A8 B5 A1 B2 08 86 C4 0A 80 CD
 0B 80 DF C7 BF DF DF DF DF C1 1E DC A4 DA 10 C9
 1C C3 1C DF 45 C2 32 C0 1E C5 B5 A6 0D 82 A5 B5
 A8 DD 2E C5 1F DF DF 48 CA 0F DF DF C2 BE 35 DC
 2E 00
  Encoded length: 130 bytes
  Wall pattern: 01, Wall color: 13     Floor pattern: 06, Floor color: 01
  Flags: 
  Random food adds: 0
  Secret trick:  0 - No trick
 02 02 02 02 02 02 02 02 02 02 02 02 02 02 02 02 02 02 02 02 02 02 02 02 02 02 02 02 02 02 02 02 02
 02 53 00 00 00 00 00 14 00 00 46 00 00 00 00 00 49 00 00 00 46 00 00 00 14 00 00 00 00 00 00 53 02
 02 00 00 00 00 00 00 14 00 00 00 00 00 00 00 00 20 00 00 00 00 00 00 00 14 00 00 00 00 00 00 00 02
 02 00 00 00 00 00 00 14 00 00 00 00 00 00 00 00 20 00 00 00 00 00 00 00 14 00 29 00 00 29 00 00 02
 02 00 00 30 00 00 00 14 00 00 00 00 00 00 00 00 34 00 00 00 00 00 00 00 14 00 00 00 00 00 00 00 02
 02 00 00 00 00 00 00 14 00 00 00 00 00 00 00 00 20 00 00 00 00 00 00 00 14 00 00 00 00 00 00 00 02
 02 00 00 00 00 00 00 14 00 00 00 00 00 00 00 12 12 12 00 00 00 00 00 00 14 00 00 00 00 00 00 00 02
 02 00 00 00 00 00 00 14 00 00 00 00 00 00 00 00 00 00 00 00 00 00 00 00 14 00 00 00 00 00 00 00 02
 02 00 00 00 00 00 00 14 00 00 00 02 09 09 09 00 00 00 09 09 09 02 00 00 14 00 00 00 00 00 00 00 02
 02 00 00 00 00 00 00 14 00 00 00 02 00 00 09 00 00 00 09 00 00 02 00 00 14 00 00 00 00 00 00 00 02
 02 00 00 00 00 00 00 02 00 00 00 02 36 00 09 00 00 00 09 00 36 02 00 00 14 00 00 00 00 00 00 00 02
 02 00 00 00 00 00 00 02 00 00 00 02 00 00 09 00 00 00 09 00 00 02 00 00 02 00 00 00 00 00 00 00 02
 02 00 00 00 00 00 00 02 00 00 32 02 46 00 09 00 17 00 09 00 46 02 32 00 02 00 00 00 00 00 00 00 02
 02 07 07 07 07 07 07 02 02 02 02 02 02 02 02 02 02 02 02 02 02 02 02 02 02 08 08 08 08 08 08 08 02
 02 00 00 00 00 00 10 10 00 00 00 00 00 00 00 00 00 00 00 00 00 00 11 11 00 00 00 00 00 00 00 00 02
 02 00 00 00 00 00 00 00 00 00 00 00 00 00 00 00 00 00 00 00 00 00 00 00 00 00 00 00 00 00 00 00 02
 02 00 00 00 00 00 00 00 00 00 00 00 00 00 00 00 00 00 00 00 00 00 00 00 00 00 00 00 00 00 00 00 02
 02 00 00 00 00 00 00 00 00 00 00 00 00 00 00 00 00 00 00 00 00 00 00 00 00 00 00 00 00 00 00 00 02
 02 00 00 00 00 00 00 00 00 00 00 00 00 00 00 00 00 00 00 00 00 00 00 00 00 00 00 00 00 00 00 00 02
 02 00 00 00 00 02 00 00 00 00 00 00 00 00 00 00 00 00 00 00 00 00 00 02 00 00 00 00 00 00 00 00 02
 02 00 00 30 00 02 00 00 00 00 00 00 00 00 00 00 00 00 00 00 00 00 00 02 00 00 00 00 00 00 00 00 02
 02 02 02 02 02 02 00 00 00 00 00 00 00 00 00 00 00 00 00 00 00 00 00 02 00 00 00 00 00 00 00 00 02
 02 16 00 00 00 02 00 00 00 00 00 00 28 00 00 00 00 28 00 00 00 00 00 02 00 00 00 00 00 00 00 00 02
 02 00 00 00 00 02 00 00 00 00 00 00 00 00 00 00 00 00 00 00 00 00 00 02 46 00 00 00 50 00 30 00 02
 02 00 00 00 00 02 02 02 02 02 02 02 02 13 13 13 13 02 02 02 02 02 02 02 02 02 02 02 02 02 02 02 02
 02 00 00 00 00 00 00 00 00 00 00 00 00 00 00 00 00 00 00 00 00 00 00 00 00 00 00 00 00 00 00 46 02
 02 00 00 00 00 00 31 00 00 00 00 00 00 00 00 00 00 00 00 00 00 00 00 00 00 00 00 00 00 00 00 00 02
 02 00 00 00 00 00 00 00 00 00 00 00 00 00 00 00 00 00 00 00 00 00 00 00 00 00 00 00 00 00 00 00 02
 02 00 00 00 00 00 00 00 00 00 00 00 00 00 00 00 46 00 00 00 00 00 00 00 00 00 00 00 15 00 00 00 02
 02 00 00 00 00 00 00 00 00 00 00 00 00 00 00 00 00 00 00 00 00 00 00 00 00 00 00 00 00 00 00 00 02
 02 00 00 00 00 00 00 00 00 00 00 00 00 00 00 00 00 00 00 00 00 00 00 00 00 00 00 00 00 00 00 00 02
 02 53 00 00 00 00 00 00 00 00 00 00 00 00 00 00 00 00 00 00 00 00 00 00 00 00 00 00 00 00 00 46 02
 02 02 02 02 02 02 02 02 02 02 02 02 02 02 02 02 02 02 02 02 02 02 02 02 02 02 02 02 02 02 02 02 02
