Gauntlet II
Maze number: 58
Offset for maze 57: 235878 - 0x039966
big endian buf: [%!l(uint8=0) %!l(uint8=3) %!l(uint8=153) %!l(uint8=102)]
G:2 Maze real addr: 244070 - 0x03B966, bank 1, boff: 0x2000
Maze read from: 0x03b966 - 244070
compresssed: 239
 11 00 00 80 02 43 48 0D 41 0E AE 22 80 C1 32 C7
 1C C1 31 C5 23 C0 22 C0 23 C0 22 C0 23 CB 49 D5
 1E 88 CD 75 52 1E 87 52 CA 22 C4 54 1C C1 35 51
 2E 2F 2E 31 2E 2F 70 35 C7 31 C1 A3 C1 41 A2 47
 52 CB 1F C7 35 C0 1E C0 35 C0 1E C0 35 C0 1E CF
 7F D3 03 C2 05 C2 05 C1 53 03 63 D1 1E C2 1E C1
 43 63 C2 1F C2 77 1E C2 1E 65 D3 1E C2 1E 6A C8
 42 57 03 56 03 57 03 57 03 56 03 52 63 60 C1 1D
 C4 73 0E D5 1F C9 44 C0 42 C2 54 C0 1D 63 BF 49
 35 81 C2 35 82 C0 B4 C9 22 C2 74 AA 04 D3 21 C8
 21 DF 67 C4 A2 2E 1C 7F C0 74 22 C3 04 A3 6E 60
 C3 A2 E1 32 D8 2C D4 01 D4 A7 65 DA 7F D6 70 2C
 C5 2C C1 21 C1 5A C0 5B C0 5B C1 21 C5 A7 C0 73
 BD C0 5C C6 5C C0 BA C6 32 10 81 C7 72 35 DF D0
 BE 22 C7 35 B3 C3 0F C3 B3 35 C1 1D C4 1D 00
  Encoded length: 239 bytes
  Wall pattern: 03, Wall color: 08     Floor pattern: 04, Floor color: 04
  Flags: EXIT_CHOOSE_ONE SHOTS_HURT 
  Random food adds: 0
  Secret trick: 17 - Don't Hurt Friends
 02 02 02 02 02 02 02 02 02 02 02 02 02 02 02 02 02 02 02 02 02 02 02 02 02 02 02 02 02 02 02 02 02
 02 34 00 00 50 00 00 14 00 00 00 00 00 28 00 00 49 00 00 00 00 00 00 35 00 34 00 35 00 34 00 35 02
 02 00 00 00 00 00 00 14 00 00 00 14 13 13 13 13 13 13 13 13 13 14 00 00 00 00 00 00 00 00 00 00 02
 02 00 00 00 00 00 00 14 00 00 00 14 30 30 30 30 30 30 30 30 30 14 00 00 00 00 00 00 00 00 00 00 02
 02 00 00 00 46 00 00 14 00 00 00 14 14 30 30 30 30 30 30 30 14 14 00 00 00 00 00 00 00 00 00 00 02
 02 34 00 00 00 00 00 14 28 00 00 53 14 46 47 46 49 46 47 46 14 53 00 00 00 00 00 00 00 00 49 00 02
 02 02 02 02 02 00 00 13 13 02 02 14 13 13 13 14 13 14 13 13 14 14 00 00 00 00 00 00 00 00 00 00 02
 02 31 00 00 00 00 00 00 00 00 53 14 30 14 53 14 30 14 53 14 30 14 00 00 00 00 00 00 00 00 00 00 02
 02 00 00 00 00 46 00 00 00 00 00 14 00 14 00 14 00 14 00 14 00 14 00 00 00 00 00 00 00 00 00 00 02
 02 00 00 00 00 00 00 00 00 00 03 14 00 14 05 14 00 14 05 14 00 14 03 00 00 00 00 01 00 00 00 00 02
 02 00 00 00 00 00 00 00 00 00 00 14 00 14 30 14 00 14 30 14 00 13 13 13 13 00 00 00 00 01 00 00 02
 02 31 00 00 00 46 00 00 00 00 00 14 00 14 30 14 00 14 30 14 00 14 00 00 14 01 00 00 00 00 00 00 02
 02 00 00 00 00 00 00 00 00 00 00 14 00 14 30 14 00 14 30 14 00 14 02 00 14 00 00 00 00 00 01 00 02
 02 00 00 00 00 00 00 00 13 13 13 14 03 14 03 14 03 14 03 14 03 14 02 00 14 00 01 00 01 00 00 29 02
 02 00 00 00 00 46 00 00 00 00 14 00 00 00 00 00 00 00 00 00 00 00 02 00 14 00 00 00 00 00 00 00 02
 02 31 00 00 00 00 00 00 00 00 02 00 13 13 13 13 13 00 13 13 13 00 02 00 14 00 29 00 00 00 00 01 02
 02 13 13 13 13 13 13 13 13 13 02 53 14 53 00 00 14 53 14 53 14 00 02 00 00 00 00 00 00 00 00 00 02
 02 34 00 00 00 46 00 00 00 00 02 02 14 02 14 02 14 02 14 02 14 02 04 00 00 00 00 00 00 00 00 00 02
 02 00 00 00 00 00 00 00 00 00 02 33 14 00 14 00 14 00 14 00 14 33 02 00 00 00 00 00 00 00 00 00 02
 02 00 00 00 00 00 00 00 00 00 02 00 14 00 14 00 14 00 14 00 14 00 02 00 00 00 00 00 00 00 01 00 02
 02 00 00 00 02 02 02 46 28 46 02 00 14 00 14 00 14 00 14 00 14 00 02 00 00 00 00 46 00 00 00 00 02
 02 34 00 00 00 00 04 02 02 02 02 00 14 00 14 00 14 00 14 00 14 00 02 00 00 00 01 00 01 00 00 00 02
 02 02 02 02 00 00 02 50 00 00 02 00 14 00 14 00 14 00 14 00 14 00 02 00 00 00 00 00 00 00 00 00 02
 02 44 00 00 00 00 00 00 00 00 02 00 14 00 14 00 14 00 14 00 14 00 02 01 00 00 00 00 00 00 00 00 02
 02 00 00 00 00 00 00 00 00 00 02 00 14 02 14 02 14 02 14 02 14 00 02 00 00 00 00 01 00 00 00 00 02
 02 00 00 00 00 00 00 00 00 00 02 00 14 00 14 00 14 00 14 00 14 00 02 46 00 00 00 00 00 00 00 00 02
 02 00 00 00 00 00 00 00 00 00 02 00 14 00 14 00 14 00 14 00 14 00 02 00 00 00 00 00 00 00 00 46 02
 02 44 00 00 00 00 00 00 44 00 02 33 14 00 14 00 14 00 14 00 14 33 02 00 00 00 00 00 02 02 02 02 02
 02 02 02 02 00 46 00 00 00 00 02 02 14 00 00 00 00 00 00 00 14 02 02 00 00 00 00 00 00 00 50 16 02
 02 16 00 00 00 00 00 00 00 00 46 02 00 00 53 00 00 00 00 00 00 02 00 00 00 00 00 00 00 00 00 00 02
 02 00 00 00 00 00 00 00 00 00 00 02 00 00 00 00 00 00 00 00 00 02 00 00 00 00 00 00 00 00 00 00 02
 02 34 00 00 00 00 00 00 00 00 53 02 00 00 00 00 15 00 00 00 00 02 53 00 00 29 00 00 00 00 00 29 02
 02 02 02 02 02 02 02 02 02 02 02 02 02 02 02 02 02 02 02 02 02 02 02 02 02 02 02 02 02 02 02 02 02
