Gauntlet II
Maze number: 78
Offset for maze 77: 233719 - 0x0390f7
big endian buf: [%!l(uint8=0) %!l(uint8=3) %!l(uint8=144) %!l(uint8=247)]
G:2 Maze real addr: 250103 - 0x03D0F7, bank 2, boff: 0x4000
Maze read from: 0x03d0f7 - 250103
compresssed: 349
 0B 00 7F 8B 40 20 D8 45 59 5C 9D 10 80 40 50 05
 C1 1A 35 05 42 C0 10 31 05 C1 09 C0 1A 40 C0 1F
 05 31 10 C0 31 18 05 41 43 07 C0 20 05 C0 18 40
 70 09 42 41 18 41 81 42 C3 07 41 83 C1 09 42 41
 82 44 40 1C C1 07 C8 09 42 C3 35 41 41 42 40 82
 45 19 42 45 1D 05 80 44 62 08 84 62 05 C0 08 C2
 1A E1 45 40 44 42 41 C2 08 51 47 42 61 05 C3 07
 81 C3 08 41 87 51 40 41 43 C3 21 C1 08 40 C2 20
 41 15 05 44 80 C2 20 40 45 40 C3 2E 42 40 44 44
 44 C2 75 05 42 43 43 19 05 42 4A 43 43 82 42 40
 4B C1 23 41 42 46 64 05 82 08 80 A1 09 43 51 05
 C4 33 19 05 44 C0 31 BF C5 09 42 42 80 45 C1 71
 05 18 10 C2 2A E2 05 81 15 08 81 41 62 05 40 43
 C8 07 E2 C0 20 09 42 41 41 63 05 81 C5 07 C5 09
 43 80 51 05 47 81 A0 05 84 C2 09 C3 20 05 43 C7
 70 A0 45 C1 09 44 42 40 48 C4 20 05 C1 09 44 41
 50 40 C2 73 05 45 E1 44 41 43 46 20 44 80 A0 15
 05 81 40 80 40 53 40 42 82 A2 05 81 E2 42 2F E0
 15 05 43 40 2F C0 39 C3 3A 05 45 E6 43 42 46 C2
 71 05 C6 07 50 40 C7 0F 42 45 C6 07 41 63 1A 46
 45 E2 71 05 A1 43 82 45 C2 71 05 C6 08 45 18 31
 BE 37 C3 3B 05 45 C6 08 64 05 C0 10 00
  Encoded length: 349 bytes
  Wall pattern: 00, Wall color: 08     Floor pattern: 02, Floor color: 13
  Flags: FAST_GHOSTS FAST_LOBBERS EXIT_FAKE FAST_GRUNTS FAST_DEATHS FAST_SORCERERS FAST_AUX_GRUNTS EXIT_CHOOSE_ONE FAST_DEMONS WALLS_CYCLIC 
  Random food adds: 3
  Secret trick: 11 - Don't Be Fooled
 02 02 02 02 02 02 02 02 02 02 02 02 02 02 02 02 02 02 02 02 02 02 02 02 02 02 02 02 02 02 02 02
 02 16 00 05 00 28 05 00 00 26 53 05 00 00 00 05 00 16 49 05 00 00 09 00 26 00 05 00 31 05 49 16
 02 49 24 05 00 00 05 00 00 00 00 05 07 00 32 05 00 24 00 05 29 00 09 00 00 00 05 00 00 05 24 00
 02 05 05 05 00 00 00 05 00 00 00 00 07 00 00 05 05 05 05 05 00 00 09 00 00 00 05 00 00 05 05 05
 02 00 00 00 00 00 05 00 05 28 00 00 07 00 00 00 00 00 00 00 00 00 09 00 00 00 05 00 00 00 00 53
 02 00 05 00 00 05 00 00 00 05 00 05 05 05 05 00 00 00 00 00 00 05 25 00 00 00 05 00 00 00 00 00
 02 05 29 05 05 00 00 00 00 00 05 00 00 00 25 08 08 08 08 08 08 00 00 00 25 05 00 08 00 00 00 26
 02 00 02 00 00 00 00 00 00 05 00 05 00 00 00 00 00 05 00 00 00 05 00 00 05 00 00 00 08 00 00 28
 02 00 00 00 00 00 00 00 05 00 00 00 05 00 00 25 05 00 00 00 00 07 07 07 00 00 00 00 08 00 00 05
 02 05 05 05 05 05 05 05 00 00 28 00 05 00 00 05 00 00 00 00 05 00 00 00 00 33 00 00 08 00 05 00
 02 00 32 00 00 05 21 05 00 00 00 00 00 05 05 00 00 00 32 00 05 00 00 00 00 00 00 05 00 05 00 00
 02 00 46 00 00 00 05 00 05 00 00 00 00 00 05 00 00 00 00 00 05 00 00 00 00 00 05 00 00 00 29 00
 02 00 00 00 00 05 00 00 00 05 00 00 00 00 05 00 00 00 00 05 25 05 00 00 00 05 00 00 00 00 00 00
 02 00 00 00 00 05 00 00 00 00 05 00 00 00 00 05 05 05 05 00 00 00 05 00 05 00 00 00 00 00 00 00
 02 00 00 00 00 05 00 00 35 00 00 05 00 00 00 05 00 00 00 00 00 00 00 05 00 00 00 00 00 25 05 05
 02 05 08 08 02 02 09 00 00 00 00 05 00 00 28 05 00 00 00 00 00 51 25 05 00 00 00 00 00 05 00 49
 02 00 00 00 00 00 00 09 00 00 00 05 00 00 00 05 05 00 00 00 00 00 00 05 00 00 29 00 00 05 24 16
 02 00 00 42 00 00 00 02 05 05 05 21 08 08 08 00 00 05 00 00 00 25 05 00 05 00 00 00 00 05 00 00
 02 00 00 00 00 00 00 07 00 00 00 02 00 32 09 00 00 00 05 00 00 05 00 00 05 00 00 00 00 25 05 05
 02 00 00 00 00 00 00 07 00 00 00 00 00 00 09 00 00 00 00 05 05 00 00 28 05 00 00 00 00 00 00 00
 02 05 05 05 02 05 05 05 05 05 05 00 00 00 09 00 00 00 00 32 05 00 00 00 00 05 00 00 00 00 00 00
 02 00 29 00 02 00 00 00 00 00 00 05 00 00 09 00 00 00 00 00 05 00 00 00 05 00 05 00 00 00 00 00
 02 00 00 00 05 00 00 00 00 00 32 05 00 00 09 00 00 00 00 00 05 00 00 05 00 28 00 05 00 00 00 29
 02 00 00 00 05 00 00 00 00 00 00 05 00 00 02 00 00 00 00 00 05 00 00 05 00 00 00 00 05 00 00 00
 02 00 00 00 05 32 00 00 00 00 00 05 05 02 21 05 05 05 00 05 05 00 05 00 00 00 00 28 00 05 00 00
 02 05 05 05 05 02 02 02 05 05 05 00 00 00 02 00 00 00 05 47 00 02 21 05 00 00 00 00 05 00 05 47
 02 57 00 00 00 00 58 05 00 00 00 00 00 00 05 00 00 00 00 00 00 00 02 00 00 00 00 05 00 00 00 05
 02 00 00 00 00 00 00 05 00 00 00 29 00 00 05 00 00 00 00 00 00 00 07 00 28 00 05 00 00 00 00 00
 02 00 00 15 00 00 00 05 00 00 00 00 00 00 05 00 00 00 00 00 00 00 07 00 00 05 00 00 00 00 25 26
 02 00 00 00 00 00 00 05 00 00 00 00 00 00 05 00 00 00 02 29 00 00 05 02 02 00 00 00 00 05 05 05
 02 00 00 00 00 00 00 05 00 00 00 29 00 00 05 00 00 00 00 00 00 00 08 00 00 00 00 00 00 05 24 49
 02 55 00 00 00 00 59 05 00 00 00 00 00 00 05 00 00 00 00 00 00 00 08 00 00 00 00 00 25 05 00 16
 02 02 02 02 02 02 02 02 02 02 02 02 02 02 02 02 02 02 02 02 02 02 02 02 02 02 02 02 02 02 02 02
