Gauntlet II
Maze number: 57
Offset for maze 56: 235660 - 0x03988c
big endian buf: [%!l(uint8=0) %!l(uint8=3) %!l(uint8=152) %!l(uint8=140)]
G:2 Maze real addr: 243852 - 0x03B88C, bank 1, boff: 0x2000
Maze read from: 0x03b88c - 243852
compresssed: 218
 01 00 00 00 00 72 01 0D AE 5C 5D 2E 80 CF 63 1D
 C0 63 2E 10 FD 6F C1 61 1D C0 35 E5 C5 A9 42 A5
 B3 E3 CA 2E A1 3A E4 73 05 C3 21 C3 2A E8 E3 64
 A1 18 A0 CE 24 E0 E3 E1 35 A0 C0 3E A0 21 C8 2A
 CA 2A E3 E1 F0 C2 67 A0 20 CE 63 A1 B3 A0 C5 20
 CC 41 A2 E1 31 E6 D0 2E 35 C3 A2 E3 C1 3E 19 82
 CA 2E 81 E8 C2 05 83 C3 22 C1 22 C5 24 E6 D1 31
 EA C9 32 22 C0 BF 14 82 A1 E9 27 A0 D1 1D E8 E0
 D6 BE 42 31 A0 FD 6F C5 33 C5 B5 CD BF C8 A1 52
 A0 DC 1C A0 1C C3 64 BC D0 1C A0 1C E4 37 D1 BF
 36 E1 1C E6 D0 A4 E9 C5 1E 32 CA 35 5A A0 C3 B2
 A2 24 C7 0F 5C A0 C4 6F 58 A0 C4 B7 A1 C3 B4 C3
 B4 5C A0 CA 0E C3 0E 5D A0 C6 BE 38 C0 0E C3 0E
 C3 3A B5 67 33 A0 31 C3 2E 00
  Encoded length: 218 bytes
  Wall pattern: 02, Wall color: 01     Floor pattern: 07, Floor color: 00
  Flags: 
  Random food adds: 0
  Secret trick:  1 - Try Transportability (onto demon)
 02 02 02 02 02 02 02 02 02 02 02 02 02 02 02 02 02 02 02 02 02 02 02 02 02 02 02 02 02 02 02 02 02
 02 46 00 00 00 00 00 00 00 00 00 00 00 00 00 00 00 00 46 00 00 00 00 29 02 46 00 00 00 00 46 16 02
 02 00 00 00 00 00 00 00 00 00 00 00 00 00 00 00 00 00 00 00 00 00 00 00 02 00 00 00 00 00 02 46 02
 02 00 00 00 00 00 00 00 00 00 00 00 00 00 00 00 00 00 46 00 00 29 00 53 02 00 00 00 00 00 02 00 02
 02 00 00 00 00 02 02 02 02 02 02 02 02 02 02 13 13 13 02 02 02 02 02 02 02 00 00 00 00 02 00 00 02
 02 00 00 00 00 00 00 00 00 46 02 02 58 00 00 00 00 00 02 00 00 00 00 29 05 00 00 00 02 33 00 00 02
 02 00 42 00 00 00 00 00 00 00 02 00 02 00 00 00 00 02 46 00 00 00 00 00 02 02 24 02 02 00 00 00 02
 02 00 00 00 00 00 00 00 00 00 02 36 00 02 00 00 02 00 02 00 00 02 53 02 00 62 02 33 02 00 00 00 02
 02 00 00 00 00 42 00 00 00 00 02 00 00 00 00 00 02 42 00 00 00 00 02 00 00 02 00 00 02 00 00 00 02
 02 00 00 00 00 02 00 00 00 00 02 02 00 00 00 46 02 00 00 00 00 00 00 00 02 32 00 00 02 00 00 00 02
 02 00 00 00 00 02 00 00 00 46 02 00 00 00 02 02 02 02 00 00 00 00 00 02 32 00 00 00 02 00 00 00 02
 02 00 00 00 00 02 13 13 02 02 02 00 00 02 49 00 00 00 00 00 00 00 02 02 00 00 00 00 02 00 00 00 02
 02 00 00 00 00 02 00 00 46 53 02 00 00 00 02 02 02 00 00 00 00 02 00 02 62 25 25 25 02 00 00 00 02
 02 00 00 00 00 02 00 00 46 46 02 00 00 00 00 00 00 00 00 00 02 00 00 02 05 05 05 05 02 00 00 00 02
 02 34 00 00 34 02 00 00 00 00 02 36 00 00 00 00 00 00 00 02 00 00 00 02 00 00 00 00 02 00 00 00 02
 02 00 00 00 00 02 49 00 00 00 02 00 00 02 00 00 00 00 02 00 00 00 00 02 00 00 00 00 02 50 34 00 02
 02 20 20 20 20 02 02 00 00 00 02 00 00 02 00 00 00 02 39 02 00 00 00 02 00 00 00 00 02 00 00 00 02
 02 00 00 00 00 02 29 00 00 00 02 00 00 02 00 00 02 00 02 00 00 00 00 02 00 00 00 00 02 00 00 00 02
 02 00 00 00 00 02 00 00 00 00 02 13 13 02 49 02 00 00 00 00 00 00 00 02 00 00 00 00 02 00 00 00 02
 02 00 00 00 00 02 00 00 00 00 00 00 00 02 02 46 00 00 00 00 00 00 00 02 00 00 00 00 02 00 00 00 02
 02 00 00 00 00 02 51 00 00 00 00 00 00 02 00 00 00 00 00 00 00 00 00 02 00 00 00 00 02 00 00 00 02
 02 00 00 00 00 02 02 02 00 00 00 28 02 00 00 00 00 00 00 00 00 00 00 02 00 00 00 00 02 00 00 00 02
 02 00 00 00 00 02 00 00 00 00 28 02 28 00 00 00 00 46 00 00 00 00 00 02 00 00 00 00 02 00 00 00 02
 02 00 00 00 00 02 00 00 00 28 02 28 00 00 00 00 00 02 55 00 00 00 00 00 00 00 00 00 02 00 00 00 02
 02 00 00 00 00 02 54 00 00 02 28 00 00 00 00 00 00 00 02 00 00 00 00 00 00 02 00 00 02 00 00 00 02
 02 00 00 02 02 02 02 02 02 00 00 00 00 00 00 00 00 00 00 02 00 00 00 00 00 02 30 50 02 00 00 00 02
 02 00 00 02 00 00 00 53 02 00 00 00 00 00 02 00 00 00 00 28 02 00 00 00 00 02 02 02 02 36 00 00 02
 02 00 00 02 00 00 15 00 02 00 00 00 00 00 02 00 00 00 00 00 28 02 00 00 00 00 00 46 02 00 00 00 02
 02 00 00 02 00 00 00 00 02 00 00 00 00 00 02 00 00 00 00 00 00 28 02 00 00 00 00 00 02 02 02 00 02
 02 00 00 02 00 00 00 00 02 00 00 00 00 00 02 00 00 00 00 00 00 00 28 02 00 00 00 00 00 00 00 00 02
 02 00 00 14 00 00 00 00 14 00 00 00 00 00 02 00 00 00 00 00 00 00 00 28 02 00 00 00 00 00 00 00 02
 02 56 00 14 00 00 00 00 14 00 00 00 00 58 02 46 00 00 00 00 00 00 00 00 51 02 49 00 00 00 00 46 02
 02 02 02 02 02 02 02 02 02 02 02 02 02 02 02 02 02 02 02 02 02 02 02 02 02 02 02 02 02 02 02 02 02
