Gauntlet II
Maze number: 63
Offset for maze 62: 237241 - 0x039eb9
big endian buf: [%!l(uint8=0) %!l(uint8=3) %!l(uint8=158) %!l(uint8=185)]
G:2 Maze real addr: 245433 - 0x03BEB9, bank 1, boff: 0x2000
Maze read from: 0x03beb9 - 245433
compresssed: 297
 0A 00 00 00 20 00 5D 9D 85 2E 5E C3 0E 22 C7 6B
 62 1E 71 C0 0E C9 A2 E7 04 74 C1 0E 22 78 E8 73
 C1 0D 82 C9 2F E7 C3 42 2E 18 2E C3 35 82 72 80
 C0 B2 E2 05 0B C1 B2 1C C0 1D 32 C0 35 03 CB A1
 62 A0 40 05 0B C1 A4 0D 82 C7 22 C5 05 41 6E 24
 C0 24 E7 42 6F 24 E7 43 08 C7 08 82 C8 B8 E1 44
 08 CD 56 2E 81 56 C1 04 A1 45 07 C7 35 EB 1E 80
 C0 40 1C 70 C0 07 C7 07 82 E6 05 A1 70 C0 40 1C
 70 6F C2 18 C0 18 2F A7 67 27 18 81 CF 28 C3 28
 C4 BF 10 C0 2E C0 24 C3 2E C0 18 C0 18 2F C0 29
 C5 28 C7 A2 BD A5 B4 A3 B3 05 A7 09 84 C0 36 18
 C3 0A 80 C3 18 35 0E 18 81 0E 35 C3 36 18 D3 0E
 18 33 18 0E DA 0D 83 18 DF C9 36 DF E0 0D 83 AF
 A3 C5 35 A0 C4 2E D0 0E E7 C1 2A C0 20 C2 AE E8
 C1 B3 A0 C3 4B 65 62 A0 C1 3A C3 A4 C2 A5 0D 84
 E0 E2 C0 31 C8 1C 81 C5 0E E6 C2 A1 B3 C0 B4 A3
 C4 23 C8 43 A0 C2 66 1E C0 2E 81 C8 1D 31 BE 0F
 C1 2E A0 C1 27 A0 C2 15 25 B2 34 B4 35 0C B4 31
 2E 22 C2 B2 C0 1D 31 35 00
  Encoded length: 297 bytes
  Wall pattern: 00, Wall color: 13     Floor pattern: 00, Floor color: 05
  Flags: WRAP_H 
  Random food adds: 0
  Secret trick: 10 - Try Pushing a Wall
 02 02 02 02 02 02 02 02 02 02 02 02 02 02 02 02 02 02 02 02 02 02 02 02 02 02 02 02 02 02 02 02
 02 00 00 00 14 34 00 00 00 00 00 00 00 00 05 00 00 00 00 00 00 00 00 00 00 00 00 05 00 00 00 30
 02 00 30 00 14 00 00 00 00 00 00 00 00 00 02 02 02 02 00 00 00 00 00 00 00 00 02 04 00 00 00 00
 02 30 00 00 14 34 00 00 00 00 00 00 00 00 02 30 00 00 02 00 00 00 00 00 00 02 00 02 00 00 30 00
 02 13 13 13 02 00 00 00 00 00 00 00 00 00 02 47 00 00 02 00 00 00 00 00 02 00 00 02 00 29 00 00
 02 46 24 46 02 00 00 46 53 53 53 46 00 00 02 30 30 00 02 00 00 00 02 05 11 00 00 02 28 00 29 50
 02 53 03 00 02 00 00 46 00 00 00 46 00 00 02 02 02 05 00 00 00 02 29 00 05 11 00 00 02 02 02 02
 02 13 13 13 02 00 00 46 00 00 00 46 00 34 02 00 00 00 00 00 05 29 00 00 05 00 00 00 00 00 00 00
 02 00 00 00 02 00 00 46 36 00 36 46 00 00 02 00 00 00 00 02 29 00 00 00 05 00 00 00 00 00 00 00
 02 00 00 00 02 00 00 46 00 36 00 46 00 00 02 00 00 00 02 29 00 00 00 00 08 00 00 00 00 00 00 00
 02 08 08 08 02 00 00 46 00 00 00 46 00 00 02 00 00 02 29 00 00 00 00 00 08 00 00 00 00 00 00 00
 02 00 00 00 02 00 00 46 46 46 46 46 00 00 04 02 02 29 00 00 00 00 00 00 07 00 00 00 00 00 00 00
 02 53 00 00 02 00 00 00 00 00 00 00 00 00 02 30 30 00 29 00 28 00 30 00 07 00 00 00 00 00 00 00
 02 07 07 07 02 00 00 00 00 00 00 02 02 05 02 02 00 30 00 29 00 28 00 30 05 00 00 00 00 00 00 00
 02 00 00 00 02 00 00 00 00 00 00 02 24 00 24 47 02 02 02 02 02 02 02 02 05 00 00 00 00 00 00 00
 02 39 24 24 02 00 00 00 00 00 00 02 00 00 00 00 02 00 00 00 00 40 00 00 00 00 40 00 00 00 00 00
 02 16 00 46 02 36 00 00 00 00 46 02 24 00 24 47 02 41 00 00 00 00 00 00 40 00 00 00 00 00 00 00
 02 02 02 02 02 02 02 02 02 02 02 02 02 02 02 02 02 05 02 02 02 02 02 02 02 02 09 09 09 09 09 09
 02 54 24 00 00 00 00 10 10 00 00 00 00 24 53 14 24 24 24 14 53 00 00 00 00 54 24 00 00 00 00 00
 02 00 00 00 00 00 00 00 00 00 00 00 00 00 00 14 24 51 24 14 00 00 00 00 00 00 00 00 00 00 00 00
 02 00 00 00 00 00 00 00 00 00 00 00 00 00 00 13 13 13 13 13 24 00 00 00 00 00 00 00 00 00 00 00
 02 00 00 00 00 00 00 00 00 00 00 00 00 00 00 00 00 00 00 00 00 00 00 00 00 00 00 00 00 00 00 54
 02 00 00 00 00 00 00 00 00 00 00 00 00 00 00 00 00 00 00 00 00 00 00 00 00 00 00 00 00 00 00 00
 02 02 13 13 13 13 13 02 02 02 02 02 02 02 02 02 02 02 02 02 02 02 02 02 02 02 02 00 00 00 00 00
 02 53 02 00 00 00 00 02 46 00 00 00 00 00 00 00 00 00 00 00 00 00 00 00 00 00 14 00 00 00 00 00
 02 00 00 02 00 00 42 02 32 00 00 02 02 02 02 02 02 02 02 02 02 02 02 02 02 02 02 00 00 00 00 00
 02 00 00 00 02 00 00 02 02 02 00 02 00 29 00 00 00 00 00 00 00 00 00 00 00 00 05 00 00 00 00 00
 02 05 00 00 00 02 00 00 58 02 00 02 00 02 02 02 02 02 00 00 02 02 02 02 02 02 02 13 13 13 13 13
 02 00 02 00 00 00 02 00 49 02 00 02 00 00 00 00 00 02 28 28 02 00 00 00 00 00 00 14 00 00 00 00
 02 00 00 02 00 00 00 02 02 02 00 02 02 02 02 02 00 02 00 00 02 35 00 00 00 00 00 02 00 00 00 29
 02 00 00 00 02 00 00 00 05 00 00 00 00 00 00 02 30 02 46 46 02 00 00 00 00 00 00 02 00 00 29 49
 02 15 00 00 46 02 00 00 39 02 00 00 00 21 37 02 52 02 53 12 02 49 46 34 00 00 00 02 00 29 49 53
 02 02 02 02 02 02 02 02 02 02 02 02 02 02 02 02 02 02 02 02 02 02 02 02 02 02 02 02 02 02 02 02
