Gauntlet II
Maze number: 32
Offset for maze 31: 236837 - 0x039d25
big endian buf: [%!l(uint8=0) %!l(uint8=3) %!l(uint8=157) %!l(uint8=37)]
G:2 Maze real addr: 236837 - 0x039D25, bank 0, boff: 0x0000
Maze read from: 0x039d25 - 236837
compresssed: 374
 11 00 00 00 04 74 91 8C 4B 09 5F 10 80 C2 15 2F
 83 C0 21 C1 18 80 24 C4 1C 80 CB 0C 2E 83 C3 09
 81 C0 35 D0 15 2F 83 42 2E 33 2E A4 C1 A4 C0 31
 C0 09 85 A2 C3 0C 81 C0 29 C0 18 C2 08 18 35 C0
 29 A2 21 C1 21 C1 21 C0 35 08 C2 B4 0D 81 C0 09
 81 51 C1 08 83 C2 09 85 C0 34 08 D3 27 C0 31 61
 C3 18 08 C0 40 41 A0 B6 C1 43 41 B2 C5 43 18 A0
 C0 40 41 1D 63 65 A6 60 C0 B5 A0 C9 4B 22 18 A0
 CB B3 0D 81 05 A4 41 A0 C3 07 C8 A3 C5 29 E1 C7
 07 42 43 1F 15 05 1D C5 09 82 C7 07 C4 0C 35 C4
 05 CC 35 22 A1 22 07 CC 05 36 C3 20 C2 A1 B4 A0
 C2 A1 2E 0A C9 22 C0 05 C5 40 41 1F C0 27 BF 29
 CF 05 1D C2 54 C5 B2 73 40 35 12 81 15 C5 24 15
 A1 B7 A5 E2 C4 B6 A4 B7 1F 18 C6 22 C3 15 A0 40
 41 29 C8 05 C7 31 C5 0E 67 C5 05 C8 22 C3 15 A0
 CE 05 1E C6 08 86 C0 42 29 57 C0 40 08 81 60 05
 C1 20 72 C0 1D C0 1D C1 1D A0 C5 A4 1D 80 08 C1
 05 C1 A4 B6 A5 1C C3 16 C4 B2 08 81 C1 A3 29 64
 C1 1E C2 41 16 70 C0 22 C0 0A E4 35 C0 29 CA 1C
 C3 16 CA 32 D0 40 16 70 81 C2 0A C2 09 87 08 81
 0B C1 1C C3 16 C4 44 1F C1 25 71 72 08 C5 40 2E
 C0 09 55 C6 B3 09 87 08 81 C2 1C C2 B8 A1 34 07
 83 69 C9 42 BE 22 C0 22 C0 22 07 C6 43 2E 42 24
 B8 1C 5A C2 0F 00
  Encoded length: 374 bytes
  Wall pattern: 04, Wall color: 01     Floor pattern: 07, Floor color: 09
  Flags: TRAPS_LOCAL 
  Random food adds: 0
  Secret trick: 17 - Don't Hurt Friends
 02 02 02 02 02 02 02 02 02 02 02 02 02 02 02 02 02 02 02 02 02 02 02 02 02 02 02 02 02 02 02 02 02
 02 16 00 00 00 21 47 47 47 47 47 00 33 00 02 24 24 36 02 00 00 00 00 28 28 00 00 00 00 00 00 00 02
 02 00 00 00 00 12 46 46 46 46 46 00 00 00 02 09 09 09 02 53 00 00 00 00 00 00 00 00 00 00 00 00 02
 02 00 00 00 00 21 47 47 47 47 47 12 00 00 02 46 51 46 02 02 02 02 02 00 00 02 02 02 02 02 00 49 02
 02 09 09 09 09 09 09 09 02 02 02 00 00 00 02 12 12 12 02 41 00 24 09 00 00 08 24 53 00 41 02 02 02
 02 33 00 00 33 00 00 33 02 53 08 00 00 00 02 13 13 13 02 09 09 09 09 00 00 08 08 08 08 02 00 00 02
 02 09 09 09 09 09 09 09 02 52 08 00 00 00 00 00 00 00 02 00 00 00 00 00 00 00 00 00 00 02 00 39 02
 02 49 00 00 11 00 00 00 02 24 08 00 12 00 12 00 02 02 02 00 00 12 00 00 00 00 12 00 00 02 00 00 02
 02 00 00 00 12 00 00 00 02 24 02 00 12 00 12 00 02 29 00 00 00 00 11 00 00 00 00 00 00 11 02 02 02
 02 02 02 02 02 00 11 00 02 02 00 00 00 00 00 00 02 00 00 00 12 00 00 00 00 00 00 00 00 00 00 00 02
 02 34 24 02 00 00 00 00 00 00 00 00 00 00 00 00 02 13 13 13 05 02 02 02 02 02 12 00 02 02 00 00 02
 02 00 07 00 00 00 00 00 00 00 00 02 02 02 02 02 00 00 00 00 00 02 41 00 00 02 00 00 02 00 00 00 02
 02 00 07 12 00 02 00 12 00 00 00 02 31 21 05 29 00 00 00 00 00 02 09 09 09 09 00 00 02 00 00 00 02
 02 00 07 00 00 02 00 00 12 53 00 02 00 00 00 05 00 00 00 00 00 02 00 09 00 00 00 00 02 53 34 02 02
 02 34 07 00 00 02 00 00 00 00 00 02 00 00 00 00 05 54 00 00 00 02 32 09 00 00 02 02 02 02 02 00 02
 02 02 09 46 10 02 00 00 00 00 00 02 00 00 00 34 00 05 00 00 00 02 00 09 12 00 12 00 00 31 02 39 02
 02 41 09 00 00 02 00 00 00 00 00 02 00 00 00 00 00 00 05 29 00 02 00 09 00 00 00 00 00 00 02 00 02
 02 00 09 31 12 02 53 18 18 18 21 02 00 00 00 00 00 36 21 02 02 02 02 02 02 02 02 02 00 00 00 02 02
 02 00 09 00 00 02 02 02 02 02 02 02 31 24 00 00 00 00 00 02 00 34 00 00 00 00 21 02 12 00 12 00 02
 02 41 09 00 00 00 00 00 00 00 00 05 00 00 00 00 00 00 00 02 49 00 00 00 00 00 00 14 00 00 00 00 02
 02 00 09 00 11 00 00 00 00 00 00 05 00 00 00 00 00 00 00 02 00 34 00 00 00 00 21 02 00 00 00 00 02
 02 00 09 00 00 00 00 00 00 00 00 05 30 00 00 00 00 00 00 02 08 08 08 08 08 08 08 09 00 12 02 00 02
 02 41 09 00 12 02 08 08 08 00 11 05 00 00 32 00 00 00 31 02 29 00 29 00 00 29 02 09 00 00 02 00 02
 02 02 02 02 02 02 29 29 08 00 00 05 00 00 02 02 02 02 02 02 02 02 02 02 02 02 28 09 00 00 02 22 02
 02 00 09 00 00 02 08 08 08 00 00 02 02 02 02 41 00 00 00 00 00 11 00 00 30 02 00 09 12 00 02 22 02
 02 31 09 34 00 10 00 00 00 00 00 02 53 00 41 00 00 00 00 00 00 00 00 00 00 02 28 09 00 00 02 22 02
 02 00 09 00 00 00 00 00 00 00 02 50 00 00 00 00 00 00 00 00 00 00 00 00 00 02 00 09 00 12 02 22 02
 02 31 09 31 00 00 00 10 00 00 02 09 09 09 09 09 09 09 09 09 08 08 08 11 00 02 28 09 00 00 02 22 02
 02 00 09 00 00 12 00 00 00 00 02 31 00 00 37 00 00 31 00 00 00 31 08 00 00 02 00 09 00 12 02 46 02
 02 09 09 00 00 00 00 00 00 00 02 09 09 09 09 09 09 09 09 09 08 08 08 00 00 02 28 09 00 00 02 02 02
 02 52 07 07 07 07 07 00 00 00 00 00 00 00 00 00 00 11 00 00 00 00 00 00 00 02 00 09 12 00 00 00 02
 02 34 00 34 00 34 07 00 00 00 00 00 00 00 12 00 00 00 00 46 12 00 00 00 36 02 28 09 00 00 00 15 02
 02 02 02 02 02 02 02 02 02 02 02 02 02 02 02 02 02 02 02 02 02 02 02 02 02 02 02 02 02 02 02 02 02
