Gauntlet II
Maze number: 11
Offset for maze 10: 231637 - 0x0388d5
big endian buf: [%!l(uint8=0) %!l(uint8=3) %!l(uint8=136) %!l(uint8=213)]
G:2 Maze real addr: 231637 - 0x0388D5, bank 0, boff: 0x0000
Maze read from: 0x0388d5 - 231637
compresssed: 169
 03 01 02 8C 00 02 4D 0D 5D 0E 6E 10 80 A0 C1 23
 72 C5 35 72 C2 07 C0 20 08 C1 09 10 C1 27 D4 07
 C1 08 C1 09 81 6B C9 07 C1 08 C0 21 D5 1E C2 07
 C1 08 C4 23 D5 07 C1 08 84 75 CF 07 C5 20 47 56
 63 C9 07 DE 1F 07 86 DF 2E C9 35 D5 1D 63 DF CA
 1E C8 1E CE 37 5C D0 4E C1 39 CD 35 CD 0F 5E 4D
 BF 4E CE 35 CD 3B C1 4F D0 36 DF D7 35 67 6B D2
 35 EC E1 1D A0 D1 1D C4 47 D3 2E D9 48 61 E0 D2
 2F DF 76 C6 A1 69 C8 08 C0 1E 62 E6 CF 09 21 DF
 CA 1E E0 CD 09 C2 BE 10 A0 C0 1E 71 57 C5 5E 35
 5D 74 56 C1 07 21 C1 33 00
  Encoded length: 169 bytes
  Wall pattern: 02, Wall color: 13     Floor pattern: 00, Floor color: 04
  Flags: EXIT_CHOOSE_ONE WALLS_CYCLIC ODDANGLE_GHOSTS FAST_GRUNTS 
  Random food adds: 4
  Secret trick:  3 - Try Transportability (into exit)
 02 02 02 02 02 02 02 02 02 02 02 02 02 02 02 02 02 02 02 02 02 02 02 02 02 02 02 02 02 02 02 02 02
 02 16 02 00 00 35 00 00 14 46 00 00 00 00 00 14 53 14 00 00 46 00 00 00 07 00 32 08 00 00 09 16 02
 02 00 39 00 00 00 00 00 14 00 00 00 00 00 00 14 00 14 00 00 00 00 00 00 07 00 00 08 00 00 09 09 02
 02 00 00 00 00 00 00 00 14 00 00 00 00 29 00 14 00 14 00 00 00 00 00 00 07 00 00 08 00 33 00 00 02
 02 00 00 00 00 00 00 00 14 00 00 00 00 00 00 14 00 14 00 00 30 00 00 00 07 00 00 08 00 00 00 00 02
 02 35 00 00 00 00 00 00 14 00 00 00 00 00 00 14 00 14 00 00 00 00 00 00 07 00 00 08 08 08 08 08 02
 02 00 00 00 00 00 00 46 14 00 00 00 00 00 00 14 00 14 00 00 00 00 00 00 07 00 00 00 00 00 00 32 02
 02 13 13 13 13 13 13 13 14 00 00 00 00 29 00 14 00 14 00 00 00 00 00 00 07 00 00 00 00 00 00 00 02
 02 00 00 00 00 00 00 00 00 00 00 00 00 00 00 14 00 14 00 00 00 00 00 00 31 07 07 07 07 07 07 07 02
 02 00 00 00 00 00 00 00 00 00 00 00 00 00 00 14 00 14 00 00 00 00 00 00 00 00 00 00 00 00 00 00 02
 02 46 00 00 00 00 00 00 00 00 00 00 53 00 00 14 00 14 00 00 00 00 00 00 00 00 00 00 00 00 00 00 02
 02 00 00 29 00 00 00 00 29 00 00 00 00 00 00 14 00 14 00 00 00 00 00 00 00 00 00 00 00 00 00 00 02
 02 00 00 00 00 00 00 00 00 00 00 00 00 00 00 14 00 14 00 00 30 00 00 00 00 00 00 00 00 00 30 00 02
 02 00 00 00 00 00 00 00 00 00 00 00 00 00 55 14 00 14 00 00 00 00 00 00 00 00 00 00 00 00 00 00 02
 02 13 13 13 13 13 13 13 13 13 13 13 13 13 13 13 00 14 57 00 00 00 00 00 00 00 00 00 00 00 00 00 02
 02 53 00 00 00 00 00 00 00 00 00 00 00 00 00 00 15 14 13 13 13 13 13 13 13 13 13 13 13 13 13 13 02
 02 13 13 13 13 13 13 13 13 13 13 13 13 13 13 13 00 00 00 00 00 00 00 00 00 00 00 00 00 00 00 53 02
 02 00 00 00 00 00 00 00 00 00 00 00 00 00 59 14 00 13 13 13 13 13 13 13 13 13 13 13 13 13 13 13 02
 02 00 00 00 00 00 00 00 00 00 00 00 00 00 00 14 00 14 54 00 00 00 00 00 00 00 00 00 00 00 00 00 02
 02 00 00 00 00 00 00 00 00 00 00 00 00 00 00 14 00 14 00 00 00 00 00 00 00 00 00 00 00 00 00 00 02
 02 00 00 00 00 00 00 00 00 00 00 53 00 00 00 14 00 14 00 00 29 00 00 00 00 00 00 00 00 00 00 00 02
 02 29 00 00 00 00 00 00 00 00 00 00 00 00 00 14 00 14 00 00 00 53 00 00 00 00 00 00 00 00 00 00 02
 02 00 00 02 00 00 02 29 02 00 00 00 00 00 00 14 00 14 00 00 00 00 00 00 00 00 00 29 00 00 00 00 02
 02 13 13 13 13 13 13 13 13 00 00 00 00 00 00 14 00 14 00 00 00 00 00 00 00 00 00 00 00 46 00 00 02
 02 00 00 00 00 00 00 00 14 00 00 00 00 00 00 14 00 14 00 00 00 00 00 00 13 13 13 13 13 13 13 13 02
 02 00 00 29 00 02 00 00 14 00 00 00 00 00 00 14 00 14 00 00 00 00 00 00 14 47 00 00 00 00 00 00 02
 02 00 00 00 00 00 00 00 14 00 00 00 00 00 00 14 00 14 00 00 00 00 00 00 14 00 00 00 00 00 00 00 02
 02 46 00 00 00 00 00 00 14 02 02 00 00 00 00 14 00 14 00 00 00 29 00 00 14 00 00 00 00 00 00 08 02
 02 30 00 00 00 29 00 00 14 00 00 00 00 02 00 14 00 14 00 00 00 00 00 00 14 00 00 00 00 00 09 33 02
 02 00 00 00 00 00 00 00 14 00 00 00 00 00 00 14 00 14 00 00 00 00 00 00 14 00 00 00 00 00 00 00 02
 02 00 00 00 00 00 00 00 14 00 00 30 00 02 00 14 00 14 00 00 00 00 00 00 14 00 00 00 09 00 00 00 02
 02 16 02 00 30 00 00 46 14 00 00 00 00 00 00 14 53 14 00 00 00 00 00 46 14 00 00 07 33 00 00 51 02
 02 02 02 02 02 02 02 02 02 02 02 02 02 02 02 02 02 02 02 02 02 02 02 02 02 02 02 02 02 02 02 02 02
