Gauntlet II
Maze number: 27
Offset for maze 26: 235669 - 0x039895
big endian buf: [%!l(uint8=0) %!l(uint8=3) %!l(uint8=152) %!l(uint8=149)]
G:2 Maze real addr: 235669 - 0x039895, bank 0, boff: 0x0000
Maze read from: 0x039895 - 235669
compresssed: 232
 05 00 00 92 00 22 75 14 AE 9D 49 ED EC 2A C3 1E
 E1 67 A0 C7 6A A0 24 07 64 22 A0 33 A0 61 A0 C1
 2E 07 1F E9 E1 C3 2E A0 72 22 E3 E0 E2 E4 C1 31
 E0 C1 1E A0 E4 E2 E2 E0 C5 2A C0 A1 18 1D A0 C0
 08 65 A0 E0 43 31 A0 E7 41 A1 E0 38 C6 2E A0 E4
 E8 C5 A2 C2 A2 E4 E4 E5 F6 21 E4 31 A0 D3 A1 C3
 B5 2E A0 5F C1 B2 E9 F4 E8 C3 B2 CC B2 C1 2E A0
 E8 36 D2 40 E0 66 2E A0 40 C7 0F C8 40 C0 37 08
 61 BF E2 D3 40 E0 65 A0 D4 28 A0 C3 18 C0 50 A0
 F4 E9 51 B2 CC B2 E0 C5 10 74 E0 CF 29 A7 E0 C1
 2E A0 F0 C5 10 E4 C4 A2 C2 A2 E4 E9 C3 A1 78 E4
 EC 31 1E A0 E6 1D A0 D4 18 E1 E6 44 21 C5 B2 28
 C7 40 21 43 E3 C1 3A B2 E7 2E 42 08 29 33 B2 32
 C2 2E B2 C4 A2 68 A3 C0 A1 C0 A3 07 F1 FD F0 55
 A0 C1 BE 10 A0 2D DB 00
  Encoded length: 232 bytes
  Wall pattern: 02, Wall color: 05     Floor pattern: 02, Floor color: 07
  Flags: EXIT_CHOOSE_ONE WALLS_DELETABLE1 
  Random food adds: 2
  Secret trick:  5 - Watch What You Shoot (shoot foods)
 02 02 02 02 02 02 02 02 02 02 02 02 02 02 02 02 02 02 02 02 02 02 02 02 02 02 02 02 02 02 02 02
 02 00 00 00 00 00 00 00 00 00 00 00 00 00 02 00 00 00 00 00 00 00 00 00 00 00 00 00 02 42 00 00
 02 00 30 00 00 02 46 00 00 00 00 00 00 00 00 02 00 00 00 00 00 00 00 00 46 00 00 00 00 00 00 00
 02 00 00 00 02 36 07 46 00 00 00 00 00 34 02 51 02 46 00 00 02 00 00 46 07 31 00 00 00 00 00 00
 02 00 00 00 02 00 00 02 00 00 00 00 46 02 00 00 00 09 34 00 00 00 00 02 00 02 00 00 00 02 00 00
 02 00 00 02 00 00 49 00 02 00 00 30 02 00 00 00 00 00 02 00 00 00 02 00 00 00 02 00 02 00 00 00
 02 00 02 42 00 02 02 24 29 02 00 08 46 00 00 00 00 00 00 02 00 02 20 20 20 20 49 02 00 00 00 00
 02 00 02 00 02 20 20 02 02 00 02 56 00 00 00 00 00 00 00 46 02 00 00 00 00 00 02 00 00 00 00 00
 02 00 02 00 02 00 00 00 00 00 00 02 02 02 00 00 00 02 02 02 00 00 00 00 00 02 00 00 00 00 00 02
 02 00 02 00 00 00 02 00 00 00 00 00 00 00 00 00 00 00 00 00 00 00 00 00 02 00 00 00 00 00 02 33
 02 00 02 00 00 02 49 02 00 00 00 00 00 00 00 00 00 00 00 00 00 00 00 00 02 00 00 00 02 02 00 00
 02 00 02 46 02 29 00 00 02 00 00 00 00 00 00 00 00 00 00 00 00 00 02 00 02 00 00 00 00 00 00 00
 02 00 00 02 00 00 00 00 02 00 00 00 00 00 00 00 00 00 00 00 00 00 02 00 00 02 00 00 00 00 00 00
 02 00 00 02 00 00 00 00 02 00 00 00 00 00 00 00 00 00 00 00 00 00 02 00 00 46 02 00 00 00 00 00
 02 00 00 00 02 54 00 00 00 00 00 00 00 00 00 00 00 00 00 00 00 00 00 00 00 20 00 02 46 00 00 00
 02 00 00 00 46 02 20 00 00 00 00 00 00 00 00 15 00 00 00 00 00 00 00 00 00 20 00 55 08 46 00 00
 02 00 00 00 02 00 00 00 00 00 00 00 00 00 00 00 00 00 00 00 00 00 00 00 00 20 00 02 46 00 00 00
 02 00 00 02 00 00 00 00 02 00 00 00 00 00 00 00 00 00 00 00 00 00 02 00 00 40 02 00 00 00 00 24
 02 29 00 02 00 00 00 00 02 00 00 00 00 00 00 00 00 00 00 00 00 00 02 00 00 02 00 00 00 00 00 00
 02 00 00 00 02 29 00 00 02 00 00 00 00 00 00 00 00 00 00 00 00 00 02 00 02 00 00 00 00 00 00 16
 02 00 00 00 00 09 00 02 00 00 00 00 00 00 00 00 00 00 00 00 00 00 00 00 41 02 02 02 02 02 02 02
 02 00 02 00 00 46 02 00 00 00 00 00 00 00 00 00 00 00 00 00 00 00 00 00 02 00 00 00 00 00 00 16
 02 00 00 00 00 02 00 00 00 00 00 02 02 02 00 00 00 02 02 02 00 00 00 00 00 02 00 00 00 00 00 00
 02 00 00 00 02 00 00 00 00 02 02 00 00 00 00 00 00 00 00 00 09 00 00 00 00 00 02 00 00 00 00 00
 02 00 00 02 00 00 00 00 02 49 30 02 00 00 00 00 00 00 00 02 29 02 00 00 00 00 00 02 00 00 00 00
 02 00 00 02 00 00 00 00 00 00 00 24 02 00 02 00 00 00 02 00 00 00 02 20 20 20 20 02 33 00 00 00
 02 00 00 02 40 00 00 00 00 00 00 00 02 20 33 20 20 20 02 00 00 00 00 02 00 00 58 02 00 00 00 00
 02 00 00 00 02 46 20 20 20 08 41 51 02 50 00 00 00 46 02 00 00 00 00 00 02 02 02 46 00 00 00 00
 02 00 00 00 00 02 02 02 02 00 02 02 00 02 02 02 02 07 00 00 00 00 00 00 00 00 00 00 00 00 00 00
 02 00 00 00 02 00 00 00 00 00 00 00 00 00 00 00 00 00 00 00 00 00 00 00 00 00 00 00 00 00 00 00
 02 00 00 02 00 00 00 00 00 00 00 00 00 00 00 00 00 00 00 00 00 02 29 00 00 00 00 00 00 02 00 00
 02 16 02 45 00 00 00 00 00 00 00 00 00 00 00 00 00 00 00 00 00 00 00 00 00 00 00 00 00 00 00 00
 02 02 02 02 02 02 02 02 02 02 02 02 02 02 02 02 02 02 02 02 02 02 02 02 02 02 02 02 02 02 02 02
