Gauntlet II
Maze number: 42
Offset for maze 41: 231469 - 0x03882d
big endian buf: [%!l(uint8=0) %!l(uint8=3) %!l(uint8=136) %!l(uint8=45)]
G:2 Maze real addr: 239661 - 0x03A82D, bank 1, boff: 0x2000
Maze read from: 0x03a82d - 239661
compresssed: 217
 09 00 00 04 00 40 6E AE 60 5D 61 35 80 31 C2 1A
 80 7A 6C 57 CE 3C C8 AF A9 65 D6 1C CD 44 1E DA
 AE 67 55 C0 42 43 1D 0A C1 1E DA 35 A0 B2 78 D2
 A1 37 6A C6 B4 DF C2 31 1D C3 2E 20 DC B3 A1 66
 63 C2 A9 C4 A2 33 50 C1 2F C2 BB A4 C3 31 10 07
 47 A7 CB 10 07 C1 B2 A2 C3 0E 44 BF C8 0F C1 07
 C4 40 1E E2 C8 A4 C3 B4 C1 43 B2 A7 68 A4 04 C6
 0E 1F 74 5E A0 45 0E D5 3B A4 0D 82 C5 4F C4 0B
 C1 22 C4 A1 B4 C3 4E 0B DE 0B C1 24 DB 0B DE 0B
 CE 1F C1 1F 61 61 71 71 0B C1 23 1B 70 71 71 C0
 40 09 81 08 88 AF A2 18 80 09 C9 0C 09 C2 1E C0
 42 1E C4 33 C2 09 1D 51 51 51 0C 09 C3 B2 CD 09
 C9 0C 09 E8 C5 BE 1D C0 09 40 42 40 40 0C 09 C2
 1E C3 2E 04 41 1A 80 35 00
  Encoded length: 217 bytes
  Wall pattern: 00, Wall color: 14     Floor pattern: 04, Floor color: 06
  Flags: 
  Random food adds: 4
  Secret trick:  9 - Don't Get Hit (while killing a dragon)
 02 02 02 02 02 02 02 02 02 02 02 02 02 02 02 02 02 02 02 02 02 02 02 02 02 02 02 02 02 02 02 02 02
 02 53 49 00 00 00 26 26 00 00 00 00 00 00 00 00 00 00 00 33 00 00 00 00 00 00 00 00 00 00 00 00 02
 02 32 00 00 00 00 00 00 00 00 29 00 00 00 00 00 00 00 00 00 00 00 00 00 00 00 60 00 00 00 00 00 02
 02 00 00 02 02 02 02 02 02 02 02 02 02 02 02 02 02 02 02 02 02 02 02 02 02 02 02 02 02 02 00 00 02
 02 00 00 02 32 00 00 00 00 00 00 00 00 00 00 00 00 00 00 00 00 00 00 00 00 00 00 00 28 00 00 00 02
 02 00 00 02 00 00 00 00 00 00 00 46 00 00 00 00 00 30 00 00 00 00 00 00 00 00 00 00 00 00 00 00 02
 02 00 00 02 00 00 00 00 00 00 00 00 02 02 02 02 02 02 02 02 02 02 02 02 02 02 02 02 00 00 00 00 02
 02 00 00 02 32 00 00 00 00 00 00 29 02 46 00 00 00 46 00 00 00 00 29 10 02 00 30 00 00 00 00 00 02
 02 00 00 02 00 00 00 00 00 00 00 00 02 00 00 00 00 00 00 00 00 00 53 02 02 00 00 00 00 00 00 00 02
 02 00 33 02 00 00 00 00 00 00 00 00 02 00 00 00 00 00 00 00 00 02 02 02 55 00 00 00 00 00 00 00 02
 02 00 00 02 32 00 00 00 00 00 00 00 02 00 00 00 00 00 00 00 00 02 00 00 00 00 00 00 00 00 00 00 02
 02 00 00 02 00 00 00 00 00 00 00 00 00 00 00 00 49 29 00 00 00 02 46 32 00 00 00 00 00 00 00 00 02
 02 00 00 02 00 00 00 00 00 00 00 00 00 00 00 00 00 00 00 00 00 02 02 02 00 00 00 00 00 00 00 32 02
 02 00 00 02 32 00 00 00 02 02 02 02 02 02 02 02 02 02 00 00 00 00 00 02 02 02 51 00 29 00 00 47 02
 02 00 00 02 02 02 02 02 02 00 00 00 02 49 16 07 46 02 00 00 00 00 00 00 00 02 02 02 02 02 02 02 02
 02 00 00 00 00 00 00 00 00 00 00 00 02 16 07 00 00 02 02 02 02 00 00 00 00 14 46 00 00 00 00 00 02
 02 00 00 00 00 00 00 00 00 00 15 00 02 07 00 00 00 00 00 46 02 30 00 00 00 02 00 00 00 00 00 00 02
 02 00 00 02 02 02 02 02 00 00 00 00 02 00 00 46 00 00 00 00 02 02 02 02 02 02 02 02 02 00 00 00 02
 02 00 00 00 00 00 32 02 02 02 02 02 04 00 00 00 00 00 00 00 14 31 00 00 00 00 00 33 02 00 00 00 02
 02 00 00 00 00 00 00 00 00 00 00 29 02 46 00 00 00 00 00 00 14 00 00 00 00 00 00 00 02 00 00 00 02
 02 00 00 00 00 00 00 00 00 00 00 59 02 02 02 02 02 13 13 13 13 00 00 00 00 00 00 46 02 00 00 00 02
 02 00 00 00 00 00 00 00 00 00 00 00 00 00 00 00 00 11 00 00 34 00 00 00 00 00 02 02 02 00 00 00 02
 02 46 00 00 00 00 00 00 00 00 00 00 00 00 00 00 00 11 00 00 00 00 00 00 00 00 00 00 00 00 00 00 02
 02 00 00 00 00 00 00 00 00 00 00 00 00 00 00 00 00 11 00 00 36 00 00 00 00 00 00 00 00 00 00 00 02
 02 00 00 00 00 00 00 00 00 00 00 00 00 00 00 00 00 11 00 00 00 00 00 00 00 00 00 00 00 00 00 00 02
 02 00 00 00 00 00 00 00 00 00 00 00 00 00 00 00 00 11 00 00 00 00 00 00 00 00 00 00 00 00 00 00 02
 02 31 00 00 31 00 00 32 00 00 32 00 00 33 00 00 33 11 00 00 35 27 00 33 00 00 33 00 00 33 00 46 02
 02 09 09 09 08 08 08 08 08 08 08 08 08 08 02 02 02 02 02 02 02 02 02 02 02 02 02 02 02 02 02 02 02
 02 24 24 09 00 00 00 00 00 00 00 00 00 00 12 09 00 00 00 30 02 46 00 00 00 30 00 00 00 00 00 51 02
 02 00 00 09 29 00 00 29 00 00 29 00 00 29 12 09 00 00 00 00 02 00 00 00 00 00 00 00 00 00 00 00 02
 02 00 00 09 00 00 00 00 00 00 00 00 00 00 12 09 00 00 00 00 00 00 00 00 00 02 00 00 00 00 00 00 02
 02 29 00 09 46 00 46 00 00 00 46 00 46 00 12 09 00 00 00 30 00 00 00 00 46 04 46 00 00 26 26 53 02
 02 02 02 02 02 02 02 02 02 02 02 02 02 02 02 02 02 02 02 02 02 02 02 02 02 02 02 02 02 02 02 02 02
