Gauntlet II
Maze number: 60
Offset for maze 59: 236367 - 0x039b4f
big endian buf: [%!l(uint8=0) %!l(uint8=3) %!l(uint8=155) %!l(uint8=79)]
G:2 Maze real addr: 244559 - 0x03BB4F, bank 1, boff: 0x2000
Maze read from: 0x03bb4f - 244559
compresssed: 276
 01 02 00 00 00 2C 00 06 9D 41 6E A2 04 2E CA 3F
 80 2E 3F 2E C5 22 0A A0 1F C1 05 80 A0 6F C6 0A
 3F C2 05 80 A7 12 83 DB 12 82 E8 C6 0F C9 12 82
 C7 38 A0 C6 05 80 A7 12 83 3F C1 3F A4 3F C2 3F
 A2 05 80 C0 1C C1 66 A0 C0 3F A0 53 3E 81 73 A3
 C5 31 A3 C2 07 C0 61 01 81 76 80 B3 C3 A2 B2 C1
 2B C2 07 DE 07 DE A1 C4 B4 32 C3 2C C7 A6 C2 1F
 A5 2E A6 C1 61 1C E0 1C 81 C0 31 E3 C8 2D 15 A0
 2E C1 B2 A4 08 82 A1 B2 A2 2E C8 15 A0 CA 0B C4
 3A E1 19 A1 C4 15 A0 C1 1E BF C7 0B C8 3E 19 E0
 C2 15 A0 C4 A6 08 82 A6 E3 70 A0 2E C2 1E C0 35
 15 72 80 A0 1C 81 C0 33 70 19 83 C2 A1 CD A5 B2
 CA 03 C3 1E DF C7 2B 55 C3 B4 03 CB 2D 56 E7 C7
 60 03 F2 D0 2C 56 E3 C7 6B 2C 54 72 1A 1E C0 1E
 C0 68 31 1A CB 09 C7 03 C4 19 80 AB 04 2E 09 78
 C4 19 2F C0 14 89 A0 09 CD 43 50 89 CF 44 10 C1
 42 D3 0C 43 BE 10 23 C0 42 C4 62 B6 31 1A C6 1A
 0C 42 18 00
  Encoded length: 276 bytes
  Wall pattern: 12, Wall color: 00     Floor pattern: 02, Floor color: 00
  Flags: ODDANGLE_GRUNTS 
  Random food adds: 0
  Secret trick:  1 - Try Transportability (onto demon)
 02 02 02 02 02 02 02 02 02 02 02 02 02 02 02 02 02 02 02 02 02 02 02 02 02 02 02 02 02 02 02 02 02
 02 02 02 04 46 00 00 00 00 00 00 00 00 00 00 00 63 63 46 63 46 00 00 00 00 00 00 34 10 02 31 00 02
 02 05 05 02 29 00 00 00 00 00 00 00 00 00 00 00 00 00 00 00 00 00 00 00 00 00 00 00 10 63 00 00 02
 02 05 05 02 02 02 02 02 02 02 02 18 18 18 18 18 00 00 00 00 00 00 00 00 00 00 00 00 00 00 00 00 02
 02 00 00 00 00 00 00 00 00 00 00 00 18 18 18 18 00 00 00 00 00 00 00 00 00 02 00 00 00 00 00 00 02
 02 15 00 00 00 00 00 00 00 00 00 00 18 18 18 18 00 00 00 00 00 00 00 00 56 02 00 00 00 00 00 00 02
 02 05 05 02 02 02 02 02 02 02 02 18 18 18 18 18 63 00 00 63 02 02 02 02 02 63 00 00 00 63 02 02 02
 02 05 05 02 28 00 00 29 00 00 00 02 00 00 00 02 00 63 02 00 00 00 00 01 62 02 62 00 00 00 00 46 02
 02 02 02 02 00 00 00 00 00 00 49 02 02 02 02 00 00 00 07 00 29 00 00 01 01 02 00 00 00 00 00 00 02
 02 46 46 02 00 00 00 00 02 02 02 02 00 00 43 00 00 00 07 00 00 00 00 00 00 02 00 00 00 00 00 00 02
 02 00 00 00 00 00 00 00 00 00 00 00 00 00 00 00 00 00 07 00 00 00 00 00 00 02 00 00 00 00 00 00 02
 02 00 00 00 00 00 00 00 00 00 00 00 00 00 00 00 00 00 02 02 00 00 00 00 00 02 50 00 00 00 00 44 02
 02 00 02 00 00 00 00 00 02 02 02 02 02 02 02 00 00 00 31 02 02 02 02 02 02 46 02 02 02 02 02 02 02
 02 00 02 29 00 00 28 00 02 28 28 28 00 49 02 00 00 00 02 00 00 00 00 00 00 00 00 00 45 21 02 46 02
 02 00 02 02 02 02 02 02 08 08 08 08 02 02 02 02 02 02 46 00 00 00 00 00 00 00 00 00 21 02 00 00 02
 02 00 00 00 00 00 00 00 00 11 00 00 00 00 00 58 00 00 02 25 02 02 00 00 00 00 00 21 02 00 00 30 02
 02 00 00 00 00 00 00 00 00 11 00 00 00 00 00 00 00 00 00 62 25 00 02 00 00 00 21 02 00 00 00 00 02
 02 02 02 02 02 02 02 02 08 08 08 08 02 02 02 02 02 02 02 00 02 00 00 02 00 46 02 46 00 00 00 30 02
 02 53 21 00 00 00 46 46 02 28 28 28 00 51 02 46 25 25 25 25 02 00 00 00 02 02 00 00 00 00 00 00 02
 02 00 00 00 00 00 00 00 02 02 02 02 02 02 02 00 00 00 00 00 02 00 00 00 00 00 03 00 00 00 00 30 02
 02 00 00 00 00 00 00 00 00 00 00 00 00 00 00 00 00 00 00 00 02 00 00 00 00 00 00 00 00 00 00 00 02
 02 00 00 00 00 00 00 00 43 00 00 00 00 00 00 01 00 00 00 00 02 03 00 00 00 00 00 00 00 00 00 00 02
 02 00 45 00 00 00 00 00 00 00 01 00 00 00 00 00 00 00 00 02 00 00 00 00 00 00 00 00 29 00 03 00 02
 02 00 00 00 00 00 00 00 00 00 00 00 00 00 00 00 00 00 02 00 00 00 00 00 00 00 00 00 00 00 00 00 02
 02 00 00 00 44 00 00 00 00 00 00 00 01 00 00 00 00 02 00 00 00 00 00 00 00 00 29 00 00 00 00 00 02
 02 00 00 00 00 00 00 44 00 00 00 00 00 01 00 00 02 46 26 30 00 30 00 29 00 00 00 00 00 00 00 00 02
 02 49 26 00 00 00 00 00 00 00 00 00 00 00 00 09 02 00 00 00 00 00 00 00 03 00 00 00 00 00 25 25 02
 02 02 02 02 02 02 02 02 02 02 02 02 04 46 09 00 02 00 00 00 00 00 00 00 46 00 00 00 00 00 25 47 02
 02 20 20 20 20 20 20 20 20 20 20 20 02 09 00 00 02 00 00 00 00 00 00 00 00 00 00 00 06 06 06 06 02
 02 01 01 01 01 01 01 01 01 01 01 01 00 00 00 00 02 00 00 00 00 00 00 00 00 00 00 00 06 06 06 06 02
 02 16 00 00 06 06 06 00 00 00 00 00 00 00 00 00 02 00 00 00 00 00 00 00 00 00 00 12 06 06 06 06 02
 02 16 35 00 06 06 06 00 00 00 00 00 29 00 00 00 02 49 26 00 00 00 00 00 00 00 26 12 06 06 06 24 02
 02 02 02 02 02 02 02 02 02 02 02 02 02 02 02 02 02 02 02 02 02 02 02 02 02 02 02 02 02 02 02 02 02
