Gauntlet II
Maze number: 90
Offset for maze 89: 229376 - 0x038000
big endian buf: [%!l(uint8=0) %!l(uint8=3) %!l(uint8=128) %!l(uint8=0)]
G:2 Maze real addr: 253952 - 0x03E000, bank 3, boff: 0x6000
Maze read from: 0x03e000 - 253952
compresssed: 302
 0F 00 00 00 00 16 10 0D 41 0E AE 35 80 C3 70 1C
 C5 74 A0 31 A0 2F C5 35 F1 C2 23 A0 C1 A1 40 A0
 E6 01 80 A0 E1 41 A0 E4 60 E2 33 28 A0 C5 1E 0E
 EA 1D EF 41 EA 41 E0 E1 C5 70 2F E3 E1 E1 E1 C2
 0E 35 C5 31 A0 E0 01 C0 31 CC 0E C2 41 A0 E4 F2
 E1 E4 EC C1 0F E1 D0 52 C1 1D A0 EB C1 51 28 E0
 E4 E1 C3 B3 CA 0E E1 C1 0E E1 C1 28 C0 35 64 E1
 E1 E1 E1 E4 C6 40 A0 63 D6 A1 18 C2 41 A0 F9 E8
 40 C2 41 A0 40 A0 E2 E1 C6 BF A0 E5 7A 0E E4 F8
 C5 5A C0 52 C2 1D E0 B2 C9 1E A0 C0 A1 C0 35 A0
 C1 22 C1 A1 E8 40 54 C1 53 C1 A1 C3 44 52 C2 2F
 E9 E1 E1 71 51 C1 18 31 E0 70 A0 C5 52 C3 20 C1
 2E A0 E2 42 C0 51 40 A0 E7 E1 E2 41 A0 C8 1C E3
 C8 20 31 E0 61 E3 E0 E0 46 A0 E0 C4 A1 C9 0E C3
 77 0E CA A1 C1 41 A0 C0 51 44 A0 E4 C2 70 51 C5
 1F A0 C0 0E 20 C5 18 A0 E3 C4 A2 E8 42 A0 C1 52
 E1 64 C0 35 C6 1F EB 2E 80 A0 40 B2 C2 43 C1 42
 B3 31 C0 53 C8 A1 61 F0 E0 E1 6B C3 BE 35 C0 51
 2F E4 20 C1 0E E1 E5 2F C0 35 53 C1 10 00
  Encoded length: 302 bytes
  Wall pattern: 06, Wall color: 00     Floor pattern: 01, Floor color: 01
  Flags: 
  Random food adds: 0
  Secret trick: 15 - Be Pushy
 02 02 02 02 02 02 02 02 02 02 02 02 02 02 02 02 02 02 02 02 02 02 02 02 02 02 02 02 02 02 02 02 02
 02 53 00 00 00 00 46 00 28 00 00 00 00 00 00 46 00 00 00 00 00 02 49 02 47 00 00 00 00 00 00 53 02
 02 00 00 00 00 00 00 00 00 00 00 00 00 00 00 00 00 00 02 00 00 00 35 02 00 00 02 02 13 02 00 00 02
 02 00 00 00 00 02 01 01 02 00 00 02 13 13 02 00 00 00 00 00 02 00 01 00 00 00 02 51 40 02 00 00 02
 02 00 00 00 30 14 00 00 00 00 00 00 00 00 00 00 00 02 29 00 00 00 00 00 00 00 00 00 00 00 00 00 02
 02 00 00 02 13 13 00 00 00 00 00 00 00 00 00 00 00 02 13 13 00 02 00 00 02 00 00 00 00 00 00 46 02
 02 47 00 00 00 00 02 00 00 02 00 00 02 00 00 02 00 00 00 14 53 00 00 00 00 00 00 49 02 00 02 01 02
 02 49 00 00 00 00 00 00 00 00 00 00 00 00 00 14 00 00 00 13 13 02 00 00 00 00 00 02 14 00 14 00 02
 02 00 00 02 00 00 00 00 00 00 00 00 00 00 00 02 00 00 02 00 00 00 00 00 02 00 00 00 14 00 14 00 02
 02 00 00 02 00 00 02 00 00 15 00 00 02 00 00 00 00 00 14 00 00 00 00 00 00 00 00 00 14 00 14 00 02
 02 29 02 02 00 00 00 00 00 00 00 00 00 00 00 02 00 00 14 40 00 02 00 00 00 00 00 02 14 00 02 00 02
 02 00 00 02 00 00 00 00 00 00 00 00 00 00 00 14 00 00 02 00 00 14 00 00 02 00 00 40 14 53 00 00 02
 02 00 00 01 00 00 02 00 00 02 00 00 02 00 00 02 00 00 00 00 00 02 00 00 00 00 00 00 14 13 02 00 02
 02 00 00 01 00 00 00 00 00 00 00 00 00 00 00 00 00 00 00 00 00 00 00 00 00 00 00 02 14 24 00 00 02
 02 13 13 02 00 00 00 00 00 00 00 00 00 00 00 00 00 00 00 00 00 00 00 00 00 00 00 00 14 00 02 00 02
 02 00 00 00 00 00 00 00 02 13 14 00 00 13 13 02 13 02 00 00 00 02 00 00 02 00 00 00 14 00 14 00 02
 02 02 00 00 00 02 00 00 02 46 14 00 00 14 00 00 00 00 00 00 00 14 00 00 00 00 00 02 14 00 14 00 02
 02 00 00 00 00 02 00 00 00 00 14 00 00 14 00 00 00 00 00 00 00 02 00 00 00 00 00 14 14 00 14 00 02
 02 00 29 00 02 02 00 00 00 00 14 00 00 14 00 00 30 02 00 02 02 00 53 02 00 00 34 14 00 02 02 00 02
 02 00 00 00 14 00 00 00 02 13 14 00 00 14 00 00 02 02 00 00 14 00 13 13 13 13 13 14 00 00 00 47 02
 02 00 00 00 14 00 00 00 00 00 02 00 00 02 00 00 02 46 00 00 14 00 14 24 49 00 02 46 00 02 00 00 02
 02 00 00 00 14 00 00 00 00 32 00 00 46 02 00 00 00 02 13 13 13 00 14 13 02 00 00 00 00 00 00 00 02
 02 02 00 00 02 00 00 00 02 13 13 02 00 00 00 00 00 00 00 00 00 28 00 00 00 00 02 00 00 00 00 00 02
 02 00 00 00 32 49 00 02 00 00 01 00 00 00 00 02 00 02 00 02 13 13 13 13 13 13 13 02 00 02 00 00 02
 02 00 00 02 02 00 00 00 00 00 00 00 00 00 00 14 00 14 00 00 46 00 00 00 00 00 00 00 00 14 00 00 02
 02 00 00 14 00 00 00 00 00 02 02 00 00 13 13 02 00 14 13 13 14 13 13 02 00 00 00 00 00 02 00 00 02
 02 46 00 14 00 00 02 00 00 14 31 02 00 14 32 00 00 00 00 00 14 24 02 00 00 02 00 02 00 00 00 00 02
 02 02 02 02 00 00 02 00 00 14 00 00 00 02 13 13 13 02 00 00 14 00 00 02 00 02 00 00 00 01 00 53 02
 02 00 00 00 00 00 02 31 00 14 00 00 00 00 00 00 00 00 00 00 02 46 46 02 13 02 00 00 14 13 13 13 02
 02 00 00 13 13 13 02 49 00 14 00 00 00 00 00 00 00 00 00 02 02 00 00 01 00 00 00 00 14 00 00 00 02
 02 00 00 14 00 00 00 00 00 02 00 02 00 00 02 00 00 00 00 00 00 00 00 00 00 00 00 01 14 00 00 00 02
 02 53 00 14 47 00 00 00 00 00 02 32 00 00 14 00 00 02 00 00 00 00 00 00 02 47 00 53 14 00 00 16 02
 02 02 02 02 02 02 02 02 02 02 02 02 02 02 02 02 02 02 02 02 02 02 02 02 02 02 02 02 02 02 02 02 02
