Gauntlet II
Maze number: 88
Offset for maze 87: 236915 - 0x039d73
big endian buf: [%!l(uint8=0) %!l(uint8=3) %!l(uint8=157) %!l(uint8=115)]
G:2 Maze real addr: 253299 - 0x03DD73, bank 2, boff: 0x4000
Maze read from: 0x03dd73 - 253299
compresssed: 314
 10 00 00 00 20 2C C6 B5 6E 0E 99 0F C2 3A 07 C4
 28 33 63 C0 3E 40 3E C0 05 1C C9 0A 07 C0 27 51
 C2 0B 51 C4 18 C1 27 C0 05 1C C5 A2 05 83 A5 C0
 20 C2 A1 B2 0D 80 A7 C8 08 E2 2E C1 3E B3 C4 05
 C3 22 60 C4 B2 C2 08 C2 05 A3 05 29 C2 31 A0 C9
 A1 05 C0 22 35 A0 35 80 1E A0 32 40 2E C5 05 24
 05 A2 C2 1D C0 35 32 A8 C2 2A A6 05 A0 1D C0 07
 61 40 0C 80 C0 09 C0 1F C2 15 05 C4 33 C5 1D C1
 07 40 A2 C0 24 C0 09 C1 51 C1 15 05 C4 23 C1 51
 1F C3 36 A0 05 80 C0 1D B4 C2 09 C2 A7 B4 A3 C1
 B2 0D 81 A0 2E 41 05 C2 09 C2 1C 2E 45 35 2E 1C
 C2 05 C7 05 C2 09 C0 1F CF 05 27 C1 51 C1 0D 80
 A7 C4 A3 C2 B3 A8 C0 1B C0 28 61 28 D4 38 67 D4
 51 C4 B3 C5 B6 C1 B3 C3 18 A3 C1 B3 7F DF D4 20
 A3 C1 B3 18 C0 A3 70 B3 C4 A6 B3 0D 81 D8 1F DF
 C5 71 A3 C4 A3 C1 B3 74 0D 80 A4 2E DA 22 C2 1C
 D4 75 51 C1 A3 C4 B3 60 22 40 A3 C1 B3 C2 41 32
 A0 C6 7F C2 A4 DA 1D CB B3 C1 A3 73 A3 C2 31 C2
 51 C0 28 D8 0D 80 A4 D6 2E C9 25 B3 45 1F C2 B3
 32 C4 29 35 BC 10 C2 51 C1 00
  Encoded length: 314 bytes
  Wall pattern: 12, Wall color: 06     Floor pattern: 02, Floor color: 12
  Flags: WRAP_H 
  Random food adds: 0
  Secret trick: 16 - IT Could Be Nice
 02 02 02 02 02 02 02 02 02 02 02 02 02 02 02 02 02 02 02 02 02 02 02 02 02 02 02 02 02 02 02 02
 15 00 00 00 58 07 00 00 14 00 00 40 51 14 00 00 00 46 02 62 53 02 62 00 05 28 00 00 00 00 00 00
 00 00 00 00 10 07 00 39 14 00 00 00 11 14 00 00 00 00 02 24 00 02 39 00 05 28 00 00 00 00 00 00
 02 02 02 05 05 02 05 05 02 02 02 02 02 02 00 32 00 00 02 02 02 02 13 13 02 02 02 02 02 02 02 02
 00 00 00 00 00 02 00 00 00 08 00 00 00 02 46 00 00 62 02 00 00 00 00 00 05 00 00 00 00 34 00 46
 00 00 00 00 00 02 00 00 00 08 00 00 00 05 02 02 02 02 05 41 00 00 00 49 02 00 00 00 00 00 00 00
 00 00 02 02 02 05 00 34 53 02 53 53 30 02 50 53 00 46 02 00 00 00 00 00 05 36 05 02 02 02 00 00
 00 29 02 53 50 02 02 02 02 02 02 02 02 02 00 00 00 42 02 02 02 02 02 02 02 05 02 29 00 07 00 00
 46 53 02 12 12 00 09 00 31 14 00 00 21 05 00 00 00 00 02 51 00 00 14 00 00 02 29 00 00 07 53 00
 02 02 02 00 36 00 09 00 00 14 00 00 21 05 00 00 00 00 02 35 00 00 14 31 00 02 00 00 54 02 05 05
 00 29 02 00 00 00 09 00 00 02 02 02 02 02 02 02 02 02 02 02 02 02 02 00 00 02 13 13 13 02 46 53
 00 00 05 00 00 00 09 00 00 02 28 46 53 00 00 00 00 00 00 53 46 28 02 00 00 05 00 00 00 14 00 00
 00 00 05 00 00 00 09 00 31 02 00 00 00 00 00 00 00 00 00 00 00 00 02 00 00 05 39 00 00 14 00 00
 13 13 02 02 02 02 02 02 02 02 00 00 02 00 00 02 02 02 02 00 00 00 02 02 02 02 02 02 02 02 02 02
 00 27 02 40 00 00 46 40 00 02 00 00 02 00 00 00 00 00 00 00 00 00 00 00 02 00 00 00 14 56 00 00
 00 00 02 00 00 00 46 00 00 02 00 00 02 00 00 00 00 00 00 00 00 00 00 00 02 00 00 00 14 00 00 00
 00 00 02 00 00 00 02 00 00 02 00 00 02 00 00 02 00 24 02 02 02 02 00 00 02 25 00 00 02 00 00 00
 00 00 00 00 00 00 02 00 00 00 00 00 00 00 00 02 00 00 00 00 00 00 00 00 00 00 00 00 02 00 00 00
 00 00 00 00 00 00 02 00 00 00 00 00 00 00 00 02 00 00 00 00 00 00 00 00 00 00 00 00 02 00 00 32
 02 02 02 02 00 00 02 24 00 02 02 02 02 25 00 02 00 00 02 00 00 02 02 02 02 02 02 02 02 13 13 13
 00 00 00 00 00 00 00 00 00 00 00 00 00 00 00 00 00 00 02 00 00 00 00 00 02 31 00 00 00 00 00 00
 00 00 00 00 00 00 00 00 00 00 00 00 00 00 00 00 00 00 02 00 00 00 00 00 02 00 00 00 00 00 00 00
 25 00 00 02 02 02 02 00 00 02 00 00 02 02 02 02 00 00 02 25 00 02 00 00 02 13 13 02 02 02 02 02
 46 00 00 00 00 00 00 00 00 02 00 00 00 00 00 00 00 00 00 00 00 02 00 00 02 00 00 00 34 14 00 00
 28 00 00 00 00 00 00 00 00 02 00 00 00 00 00 00 00 00 00 00 00 02 25 00 02 00 00 00 00 14 00 00
 02 02 02 02 00 00 02 00 00 02 00 46 34 53 00 02 02 02 02 00 00 02 00 00 02 53 00 00 50 02 00 00
 00 00 00 00 00 25 02 00 00 00 00 00 00 00 00 00 00 00 00 00 00 00 00 00 02 02 02 02 02 02 00 00
 00 00 00 00 00 00 02 00 00 00 00 00 00 00 00 00 00 00 00 00 00 00 00 00 02 29 00 00 00 14 00 00
 00 00 00 02 00 00 02 00 00 02 02 02 02 25 00 02 00 00 02 02 02 02 00 00 02 49 00 00 00 14 00 40
 00 00 00 02 00 00 00 00 00 00 00 00 00 00 00 02 00 00 00 00 00 00 00 00 02 13 13 02 02 02 02 02
 00 00 00 02 00 00 00 00 00 00 00 00 00 00 00 02 00 00 00 00 00 00 00 46 02 00 00 00 00 14 00 00
 00 00 37 02 53 00 00 00 00 00 00 31 00 00 00 02 50 00 00 00 00 00 41 53 02 16 00 00 00 14 00 00
 02 02 02 02 02 02 02 02 02 02 02 02 02 02 02 02 02 02 02 02 02 02 02 02 02 02 02 02 02 02 02 02
