Gauntlet II
Maze number: 23
Offset for maze 22: 234748 - 0x0394fc
big endian buf: [%!l(uint8=0) %!l(uint8=3) %!l(uint8=148) %!l(uint8=252)]
G:2 Maze real addr: 234748 - 0x0394FC, bank 0, boff: 0x0000
Maze read from: 0x0394fc - 234748
compresssed: 168
 02 00 80 81 00 11 66 05 6E 5F 68 39 80 70 D8 16
 80 32 CF 0F CB 16 80 71 DA 16 80 C5 AB C2 A5 41
 A1 62 82 C1 20 54 C9 1C DF DF C3 1D C4 A6 C3 A8
 C3 A5 C1 18 DA 1F DF C0 33 D1 20 CB A3 C3 A4 C3
 A2 41 A2 C3 A2 C2 1C 54 7B DF C6 31 C0 32 C0 1E
 5B CE BF A8 C3 A3 C2 A2 C3 A4 29 2E DB 28 DF C6
 29 C7 29 C3 37 73 C7 A7 42 A5 04 A6 41 A2 DF 2E
 DC 31 C4 23 C4 32 62 23 66 23 C6 A1 41 AF A7 63
 56 C9 21 CB 21 DE 2E 6A 68 C6 21 A5 C1 A1 41 A4
 C2 A1 04 A1 41 A0 C2 A1 10 D9 2E DF C2 BE C2 18
 C7 1E C8 1E C5 18 10 00
  Encoded length: 168 bytes
  Wall pattern: 01, Wall color: 06     Floor pattern: 01, Floor color: 06
  Flags: EXIT_CHOOSE_ONE INVIS_ALLWALLS 
  Random food adds: 1
  Secret trick:  2 - Try Transportability (onto death)
 02 02 02 02 02 02 02 02 02 02 02 02 02 02 02 02 02 02 02 02 02 02 02 02 02 02 02 02 02 02 02 02 02
 02 57 00 40 00 00 00 00 00 00 00 00 00 00 00 00 00 00 00 00 00 00 00 00 00 00 00 00 00 22 22 50 02
 02 00 00 00 00 00 00 00 00 00 00 00 00 00 00 00 15 00 00 00 00 00 00 00 00 00 00 00 00 22 22 00 02
 02 40 00 00 00 00 00 00 00 00 00 00 00 00 00 00 00 00 00 00 00 00 00 00 00 00 00 00 00 22 22 00 02
 02 00 00 00 00 02 02 02 02 02 02 02 02 02 02 02 02 00 00 00 02 02 02 02 02 02 05 05 02 02 00 00 02
 02 46 46 46 46 00 00 32 00 00 00 00 00 31 00 00 00 00 00 00 00 00 00 00 28 00 00 00 00 00 00 00 02
 02 00 00 00 00 00 00 00 00 00 00 00 00 00 00 00 00 00 00 00 00 00 00 00 00 00 00 00 00 00 00 00 02
 02 00 00 00 00 00 00 00 00 00 00 00 00 00 00 00 00 00 00 00 00 00 00 00 00 00 00 00 00 29 00 00 02
 02 00 00 02 02 02 02 02 02 02 00 00 00 00 02 02 02 02 02 02 02 02 02 00 00 00 00 02 02 02 02 02 02
 02 00 00 24 00 00 00 00 00 00 00 00 00 00 00 00 00 00 00 00 00 00 00 00 00 00 00 00 00 00 00 31 02
 02 00 00 00 00 00 00 00 00 00 00 00 00 00 00 00 00 00 00 00 00 00 00 00 00 00 00 00 00 00 00 00 02
 02 51 00 00 00 00 00 00 00 00 00 00 00 00 00 00 00 00 00 00 32 00 00 00 00 00 00 00 00 00 00 00 02
 02 02 02 02 02 00 00 00 00 02 02 02 02 02 00 00 00 00 02 02 02 05 05 02 02 02 00 00 00 00 02 02 02
 02 00 00 00 28 00 00 00 00 00 31 00 00 00 00 00 00 00 00 00 00 00 00 40 00 00 00 00 00 00 00 00 02
 02 00 00 00 00 00 00 00 00 00 00 00 00 00 00 00 00 00 00 00 00 00 00 00 00 00 00 00 00 00 00 49 02
 02 50 00 30 00 00 00 00 00 00 00 00 00 00 00 00 31 00 00 00 00 00 00 00 00 00 00 00 00 00 00 00 02
 02 02 02 02 02 02 02 02 02 02 00 00 00 00 02 02 02 02 00 00 00 02 02 02 00 00 00 00 02 02 02 02 02
 02 41 46 00 00 00 00 00 00 00 00 00 00 00 00 00 00 00 00 00 00 00 00 00 00 00 00 00 00 00 00 40 02
 02 00 00 00 00 00 00 00 00 00 00 00 00 00 00 00 00 00 00 00 00 00 00 00 00 00 00 00 00 00 00 00 02
 02 00 00 00 00 00 00 41 00 00 00 00 00 00 00 00 41 00 00 00 00 55 00 00 00 00 40 00 00 00 00 00 02
 02 00 00 02 02 02 02 02 02 02 02 05 05 05 02 02 02 02 02 02 04 02 02 02 02 02 02 02 05 05 02 02 02
 02 00 00 00 00 00 00 00 00 00 00 00 00 00 00 00 00 00 00 00 00 00 00 00 00 00 00 00 00 00 00 00 02
 02 46 00 00 00 00 00 00 00 00 00 00 00 00 00 00 00 00 00 00 00 00 00 00 00 00 00 00 00 00 00 49 02
 02 00 00 00 00 35 00 00 00 00 00 50 00 00 00 46 35 00 00 00 00 00 00 00 46 35 00 00 00 00 00 00 02
 02 02 02 05 05 02 02 02 02 02 02 02 02 02 02 02 02 02 02 02 02 02 02 02 02 02 02 02 02 00 00 00 02
 02 46 00 00 00 00 00 00 00 31 00 00 00 00 00 00 00 00 00 00 33 00 00 00 00 00 00 00 00 00 00 00 02
 02 33 00 00 00 00 00 00 00 00 00 00 00 00 00 00 00 00 00 00 00 00 00 00 00 00 00 00 00 00 00 00 02
 02 46 00 00 00 00 00 00 00 00 00 00 00 46 00 00 00 00 00 00 00 00 00 46 00 00 00 00 00 00 00 33 02
 02 02 02 02 02 02 00 00 02 02 05 05 02 02 02 02 02 00 00 00 02 02 04 02 02 05 05 02 00 00 00 02 02
 02 16 00 00 00 00 00 00 00 00 00 00 00 00 00 00 00 00 00 00 00 00 00 00 00 00 00 00 46 00 00 00 02
 02 00 00 00 00 00 00 00 00 00 00 00 00 00 00 00 00 00 00 00 00 00 00 00 00 00 00 00 00 00 00 00 02
 02 00 00 00 24 00 00 00 00 00 00 00 00 30 00 00 00 00 00 00 00 00 00 30 00 00 00 00 00 00 24 16 02
 02 02 02 02 02 02 02 02 02 02 02 02 02 02 02 02 02 02 02 02 02 02 02 02 02 02 02 02 02 02 02 02 02
