Gauntlet II
Maze number: 106
Offset for maze 105: 233386 - 0x038faa
big endian buf: [%!l(uint8=0) %!l(uint8=3) %!l(uint8=143) %!l(uint8=170)]
G:2 Maze real addr: 257962 - 0x03EFAA, bank 3, boff: 0x6000
Maze read from: 0x03efaa - 257962
compresssed: 215
 0F 00 00 88 00 61 95 6E 47 08 09 10 80 43 42 61
 2F 42 42 C1 10 40 C2 10 6C D9 2E 42 07 45 43 D2
 07 CB B3 45 43 54 41 61 2E 42 54 42 C1 04 2E 42
 60 84 C0 09 83 A6 07 84 A0 09 84 42 42 42 42 42
 43 42 DF 42 43 46 42 47 DF 42 DF 42 43 42 55 41
 C1 75 2E 43 55 41 C2 09 84 B7 07 89 A7 07 83 40
 43 42 4A 43 42 DF BF 46 42 C2 0F 42 43 DF C6 10
 43 54 41 C7 54 42 C1 74 2E 42 A7 09 83 B6 09 83
 60 84 A6 C1 2F 62 2E 42 42 42 43 42 C0 10 66 D8
 2E 43 07 45 42 47 42 66 DB 2E 61 2E 42 54 41 42
 43 74 41 C2 08 84 A5 04 07 83 B6 08 84 A0 08 83
 40 43 42 42 42 43 61 2E 42 D9 07 4C 42 46 43 07
 DE 07 DE 07 C4 BE 10 43 75 41 C0 10 B5 2E 42 75
 C1 2F 62 2E C2 10 00
  Encoded length: 215 bytes
  Wall pattern: 01, Wall color: 05     Floor pattern: 06, Floor color: 09
  Flags: WALLS_CYCLIC EXIT_CHOOSE_ONE 
  Random food adds: 0
  Secret trick: 15 - Be Pushy
 02 02 02 02 02 02 02 02 02 02 02 02 02 02 02 02 02 02 02 02 02 02 02 02 02 02 02 02 02 02 02 02 02
 02 16 00 00 00 00 46 08 00 00 46 00 00 07 47 00 00 00 46 08 00 00 46 00 00 16 02 46 00 00 00 16 02
 02 00 00 00 00 00 00 08 00 00 00 00 00 07 00 00 00 00 00 08 00 00 00 00 00 00 02 00 00 00 00 00 02
 02 00 00 00 00 00 00 08 46 00 00 00 46 07 00 00 00 00 00 08 46 00 00 00 00 46 02 00 00 00 00 00 02
 02 00 00 00 00 00 00 08 00 00 00 00 00 07 00 00 00 00 00 08 00 00 00 00 00 00 02 00 00 00 00 00 02
 02 46 00 00 00 00 46 08 00 00 46 00 00 07 46 00 00 00 46 08 00 00 00 46 00 00 04 46 00 00 00 46 02
 02 07 07 07 07 07 07 02 09 09 09 09 09 02 02 02 02 02 02 02 07 07 07 07 07 07 02 09 09 09 09 09 02
 02 00 00 00 46 00 00 02 46 00 00 00 46 08 00 00 46 00 00 09 46 00 00 00 00 46 08 00 00 46 00 00 02
 02 00 00 00 00 00 00 02 00 00 00 00 00 08 00 00 00 00 00 09 00 00 00 00 00 00 08 00 00 00 00 00 02
 02 46 00 00 00 00 46 02 00 00 00 00 00 08 46 00 00 00 46 09 00 00 00 00 00 00 08 46 00 00 00 00 02
 02 00 00 00 00 00 00 02 00 00 00 00 00 08 00 00 00 00 00 09 00 00 00 00 00 00 08 00 00 00 00 46 02
 02 00 00 00 00 00 00 02 00 00 00 00 00 08 00 00 00 00 00 09 00 00 00 00 00 00 08 00 00 00 00 00 02
 02 00 00 46 00 00 00 02 46 00 00 00 46 08 00 00 46 00 00 09 46 00 00 00 00 46 08 00 00 46 00 00 02
 02 09 09 09 09 09 09 02 07 07 07 07 07 02 07 07 07 07 07 02 02 02 02 02 02 02 02 07 07 07 07 07 02
 02 46 00 00 00 00 46 08 00 00 46 00 00 02 00 00 00 00 00 08 00 00 46 00 00 00 09 46 00 00 00 46 02
 02 00 00 00 00 00 00 08 00 00 00 00 00 02 00 00 00 00 00 08 00 00 00 00 00 00 09 00 00 00 00 00 02
 02 00 00 00 00 00 00 08 46 00 00 00 46 02 00 00 15 00 00 08 46 00 00 00 00 46 09 00 00 00 00 00 02
 02 00 00 00 00 00 00 08 00 00 00 00 00 02 00 00 00 00 00 08 00 00 00 00 00 00 09 00 00 00 00 00 02
 02 16 00 00 00 00 46 08 00 00 46 00 00 02 00 00 00 00 00 08 00 00 00 46 00 00 09 46 00 00 00 46 02
 02 02 02 02 02 02 02 02 09 09 09 09 09 02 09 09 09 09 09 02 07 07 07 07 07 07 02 02 02 02 02 02 02
 02 00 00 47 00 00 00 07 46 00 00 00 46 08 00 00 46 00 00 02 46 00 00 00 00 46 09 00 00 46 00 16 02
 02 00 00 00 00 00 00 07 00 00 00 00 00 08 00 00 00 00 00 02 00 00 00 00 00 00 09 00 00 00 00 00 02
 02 46 00 00 00 00 46 07 00 00 00 00 00 08 46 00 00 00 46 02 00 00 00 00 00 00 09 46 00 00 00 46 02
 02 00 00 00 00 00 00 07 00 00 00 00 00 08 00 00 00 00 00 02 00 00 00 00 00 00 09 00 00 00 00 00 02
 02 00 00 00 46 00 00 07 46 00 00 00 46 08 00 00 46 00 00 02 46 00 00 00 00 46 09 00 00 46 00 00 02
 02 08 08 08 08 08 08 02 02 02 02 02 02 04 07 07 07 07 07 02 08 08 08 08 08 08 02 08 08 08 08 08 02
 02 46 00 00 00 00 46 09 00 00 46 00 00 02 46 00 00 00 46 09 00 00 00 46 00 00 07 46 00 00 00 46 02
 02 00 00 00 00 00 00 09 00 00 00 00 00 02 00 00 00 00 00 09 00 00 00 00 00 00 07 00 00 00 00 00 02
 02 00 00 00 00 00 00 09 46 00 00 00 46 02 00 00 00 00 00 09 46 00 00 00 00 46 07 00 00 00 00 00 02
 02 00 00 00 00 00 00 09 00 00 00 00 00 02 00 00 00 00 00 09 00 00 00 00 00 00 07 00 00 00 00 00 02
 02 00 00 00 00 00 00 09 00 00 00 00 00 02 00 00 00 00 00 09 00 00 00 00 00 00 07 00 00 00 00 00 02
 02 16 00 00 00 00 46 09 00 00 46 00 16 02 46 00 00 00 46 09 00 00 47 00 00 00 07 46 00 00 00 16 02
 02 02 02 02 02 02 02 02 02 02 02 02 02 02 02 02 02 02 02 02 02 02 02 02 02 02 02 02 02 02 02 02 02
