Gauntlet II
Maze number: 36
Offset for maze 35: 229887 - 0x0381ff
big endian buf: [%!l(uint8=0) %!l(uint8=3) %!l(uint8=129) %!l(uint8=255)]
G:2 Maze real addr: 238079 - 0x03A1FF, bank 1, boff: 0x2000
Maze read from: 0x03a1ff - 238079
compresssed: 194
 10 00 00 00 00 10 F7 13 A1 6E 71 3B 80 CC 35 5E
 E6 C0 6F C0 66 61 2E 43 53 C5 A7 0D 81 C7 A7 E4
 C7 1D CC 03 50 C3 B2 B2 CA 43 CE 04 5B 80 C6 03
 72 E4 CB 43 E6 C0 6F C8 03 C7 3C C1 41 ED 03 E5
 C0 A3 38 43 CA 60 A0 CE 42 79 D1 42 C9 AD 54 81
 C9 2F 7A D3 B2 E0 C1 62 62 1B E8 E0 E0 19 80 BF
 E4 E4 C2 BF F0 C5 20 D0 1F EA E2 C6 BF E4 E2 D8
 2E C6 35 C4 1F E2 C1 1F E9 C0 20 C2 20 E0 E3 FE
 E0 E0 E0 CB 66 6F D1 B5 A0 58 C8 33 C6 32 C2 10
 C7 A1 BC C0 B8 C4 BF A9 C0 68 0E D7 2E C5 0E C3
 1F 80 50 C7 2D C2 A2 B4 AD B9 AA C4 35 0E 44 78
 6B 0F C1 0E 44 C5 20 76 64 BE C3 0E 44 C1 1F 7F
 21 00
  Encoded length: 194 bytes
  Wall pattern: 00, Wall color: 07     Floor pattern: 01, Floor color: 15
  Flags: 
  Random food adds: 0
  Secret trick: 16 - IT Could Be Nice
 02 02 02 02 02 02 02 02 02 02 02 02 02 02 02 02 02 02 02 02 02 02 02 02 02 02 02 02 02 02 02 02 02
 02 59 00 00 00 00 00 00 00 00 00 00 00 00 00 53 02 00 00 00 00 00 00 00 00 00 00 00 00 00 00 46 02
 02 00 00 00 00 00 00 02 00 33 00 00 00 00 00 00 02 00 00 00 00 00 00 00 00 00 00 33 00 00 00 00 02
 02 00 00 33 00 00 46 19 19 19 19 00 00 00 00 46 02 00 00 02 02 02 02 02 02 02 02 02 02 02 13 13 02
 02 00 00 00 00 00 00 00 00 02 02 02 02 02 02 02 02 00 00 02 02 02 02 00 00 00 00 00 00 00 00 29 02
 02 00 00 00 00 00 00 00 00 00 00 00 00 03 00 46 02 00 00 02 02 02 00 00 00 00 00 00 00 00 00 00 02
 02 19 19 19 19 00 00 00 00 00 00 00 00 00 00 00 02 00 00 02 04 00 00 00 00 00 00 00 00 00 00 00 02
 02 46 46 00 00 00 00 00 00 00 03 00 00 00 49 00 02 00 00 02 02 00 00 00 00 00 00 00 00 00 00 00 02
 02 19 19 19 19 00 00 00 00 00 00 00 02 00 33 00 02 00 00 02 00 00 00 00 00 00 00 00 00 00 00 00 02
 02 00 00 00 00 00 00 00 03 00 00 00 00 00 00 00 02 60 00 02 19 19 00 00 00 00 00 00 00 00 00 00 02
 02 00 00 00 02 03 00 00 00 00 00 00 02 00 02 02 02 02 56 02 19 19 02 00 00 00 00 00 00 00 00 00 02
 02 00 33 00 02 00 00 00 00 00 00 00 00 00 00 00 02 00 00 02 19 19 02 00 00 00 00 00 00 00 00 00 02
 02 49 00 00 00 00 00 00 00 00 00 00 00 00 00 00 02 00 00 02 19 19 02 00 00 00 00 00 00 00 00 00 02
 02 02 02 02 02 02 02 02 02 02 02 02 02 02 02 00 02 00 00 02 46 46 02 00 00 00 00 00 00 00 00 00 02
 02 47 02 00 00 00 00 00 00 00 00 00 00 49 02 00 02 00 00 02 00 00 02 00 00 00 00 00 00 00 00 00 02
 02 00 02 00 02 00 00 33 00 00 00 33 00 00 02 27 02 00 00 02 00 00 02 00 00 02 00 02 00 02 25 25 02
 02 00 00 00 00 00 02 00 00 00 00 00 02 00 02 00 02 00 00 02 00 00 02 00 00 00 00 00 00 00 00 00 02
 02 00 02 00 00 00 00 00 00 32 00 00 00 00 02 00 02 00 00 02 00 00 02 00 00 00 00 31 00 00 00 00 02
 02 00 00 00 00 00 00 02 00 00 00 02 00 00 02 00 02 00 00 02 00 00 02 00 00 02 00 00 00 02 00 00 02
 02 00 02 00 00 00 00 00 00 00 00 00 00 00 02 00 02 00 00 02 00 00 02 46 00 00 00 00 00 00 00 53 02
 02 00 02 00 00 31 00 00 00 02 00 00 31 00 02 00 02 00 00 02 00 00 02 02 00 32 00 00 00 32 00 02 02
 02 00 02 00 02 00 00 00 00 00 00 00 00 00 02 00 02 00 00 02 00 00 02 00 00 00 00 00 00 00 00 00 02
 02 00 02 00 02 00 02 00 02 00 02 00 00 00 02 00 02 00 00 02 00 00 02 33 00 00 00 00 00 00 00 33 02
 02 00 02 00 00 00 00 00 00 00 00 00 00 00 02 00 02 00 00 02 00 00 02 00 00 00 00 00 00 00 00 00 02
 02 00 02 02 02 00 00 00 00 00 00 00 00 46 02 00 02 00 00 02 00 00 02 51 00 00 00 00 00 00 00 50 02
 02 00 00 16 02 00 00 00 00 00 00 00 02 02 02 00 02 00 00 02 00 00 02 02 02 02 02 02 02 02 02 02 02
 02 00 33 00 02 00 00 00 00 00 00 00 14 00 00 00 00 00 00 02 00 00 00 00 00 00 00 00 00 00 00 00 02
 02 00 00 00 02 46 00 00 00 00 00 00 14 00 00 00 00 31 31 02 46 00 00 00 00 00 00 00 00 45 00 00 02
 02 02 02 02 02 02 02 02 02 02 02 02 02 02 02 02 02 02 02 02 02 02 02 02 02 02 02 02 02 02 02 00 02
 02 00 00 00 53 14 19 19 19 19 19 00 00 00 00 00 00 00 00 00 49 33 00 00 00 00 00 00 00 00 00 00 02
 02 00 15 00 00 14 19 19 19 19 19 00 00 00 00 00 00 32 00 00 00 00 00 00 00 49 33 00 00 00 00 00 02
 02 00 00 00 00 14 19 19 19 19 19 00 00 31 00 00 00 00 00 00 00 00 00 00 00 00 00 00 00 00 49 33 02
 02 02 02 02 02 02 02 02 02 02 02 02 02 02 02 02 02 02 02 02 02 02 02 02 02 02 02 02 02 02 02 02 02
