Gauntlet II
Maze number: 33
Offset for maze 32: 237211 - 0x039e9b
big endian buf: [%!l(uint8=0) %!l(uint8=3) %!l(uint8=158) %!l(uint8=155)]
G:2 Maze real addr: 237211 - 0x039E9B, bank 0, boff: 0x0000
Maze read from: 0x039e9b - 237211
compresssed: 321
 03 00 00 00 20 23 3E AE 61 0E 75 71 0E E0 42 2E
 A0 0C 80 E0 15 A0 15 A0 61 C0 1E 40 35 19 39 31
 C2 A1 E1 C1 A1 C5 05 A0 05 C3 48 0F E0 E1 05 A0
 21 C1 05 62 C4 B2 C8 B2 C6 05 A1 1D C0 05 1C E5
 C2 B3 10 E5 C4 1F 60 A3 05 E6 C1 05 A0 19 E5 CA
 1E E7 E0 15 A0 09 80 C0 22 72 C2 1F C4 A1 B5 A3
 E1 C2 A1 0D A0 C1 A3 B4 C2 B3 A0 E3 2A EF 33 27
 E3 40 A0 6C C5 0D A3 E1 E2 05 D2 27 E3 66 E5 1E
 62 EE 1E E5 C8 A2 61 73 78 A0 33 A0 E6 46 21 CA
 A6 C3 44 27 E2 2E B3 C0 2E A0 C0 2E B4 C2 1F E4
 C9 56 C1 31 A0 63 A0 C0 A6 E2 18 B2 C4 BF 18 A3
 E1 0D A1 72 0E E3 E2 2F C1 2E 80 C1 45 A0 C4 A3
 C1 1E A0 E0 E1 2F C0 24 80 E7 C5 0E E4 15 A0 C3
 A5 C1 A4 0D 80 A4 05 63 A0 EC 15 A0 21 C5 33 48
 31 2A C8 37 A0 61 67 E3 C8 28 C1 A2 CC 1E E2 C2
 B3 E9 C7 1C E6 E1 1E C2 3E 15 C2 22 A0 22 C5 1C
 C6 2A C1 A1 C2 B4 A3 C2 23 A0 C7 1C EB 40 3E CC
 1D 72 C1 B8 A6 4F C1 1D C0 0D C1 1F C2 3E E0 43
 4B 1D 18 C2 BB A6 3E C4 18 C3 B3 C8 1D C3 2A C2
 2F A1 C4 2E 82 CA 31 BA C6 3E B2 31 C3 2E 18 BE
 00
  Encoded length: 321 bytes
  Wall pattern: 03, Wall color: 14     Floor pattern: 02, Floor color: 03
  Flags: WRAP_H 
  Random food adds: 0
  Secret trick:  3 - Try Transportability (into exit)
 02 02 02 02 02 02 02 02 02 02 02 02 02 02 02 02 02 02 02 02 02 02 02 02 02 02 02 02 02 02 02 02
 00 00 53 14 00 02 46 00 00 00 46 02 12 12 00 02 21 02 21 02 00 00 33 02 30 46 02 53 25 57 49 02
 00 02 02 02 00 00 02 00 00 02 02 00 00 00 00 00 02 05 02 05 00 00 00 02 46 00 02 00 00 00 00 02
 00 02 15 00 02 00 00 02 05 02 33 00 00 05 00 00 02 33 00 00 00 00 00 02 00 00 02 00 00 00 00 02
 00 02 00 00 00 02 00 00 00 05 02 02 29 00 05 28 02 00 00 00 00 00 02 00 00 00 02 16 00 00 00 02
 00 00 02 00 00 02 00 00 31 02 33 02 02 02 02 05 02 00 00 00 00 00 00 02 00 00 05 02 25 00 00 02
 00 00 00 02 00 02 00 00 00 02 00 00 00 00 00 30 02 00 00 00 00 00 00 00 02 00 02 21 02 09 09 02
 34 00 00 00 53 02 00 00 31 02 00 00 00 00 02 02 02 02 02 02 02 00 00 02 00 00 00 02 02 13 02 02
 00 02 02 02 02 02 00 00 00 02 02 00 00 00 00 02 42 00 00 00 00 00 00 00 00 00 00 00 00 00 00 02
 00 02 51 39 00 00 00 00 02 46 00 02 00 00 00 00 00 00 00 00 00 00 00 00 00 33 00 00 00 00 00 02
 13 14 02 02 02 00 00 02 00 00 00 02 05 00 00 00 00 00 00 00 00 00 00 00 00 00 00 00 00 00 00 02
 39 14 00 00 00 02 00 00 00 00 00 00 02 33 00 00 00 00 00 00 02 30 00 00 00 33 00 00 00 00 00 02
 00 14 00 00 00 00 02 00 00 02 30 00 02 00 00 00 00 02 00 00 00 00 00 00 00 00 00 02 02 02 00 02
 33 14 00 00 00 53 02 00 00 00 00 00 02 00 00 53 02 51 02 00 00 00 00 00 00 00 02 46 00 00 00 02
 00 14 00 33 00 00 02 00 00 00 00 00 02 00 00 02 02 02 02 02 02 02 00 00 00 02 46 00 00 00 00 02
 39 14 00 00 02 46 02 00 46 02 00 46 02 00 00 00 31 00 00 00 00 00 02 00 00 02 00 00 00 00 00 02
 00 14 00 00 49 02 00 00 00 00 33 02 00 02 02 02 02 02 02 02 00 00 00 02 24 02 00 00 00 00 00 02
 24 02 02 02 02 00 00 02 13 02 02 00 00 00 53 14 00 00 00 00 02 00 00 00 02 47 00 00 46 46 00 02
 46 00 00 00 00 00 00 02 00 00 00 00 00 02 02 02 02 00 00 30 02 00 02 00 00 02 47 00 36 36 00 02
 00 00 00 00 00 00 02 00 00 00 00 00 00 14 00 00 02 00 02 02 21 02 00 00 00 00 02 02 02 02 02 02
 00 00 02 02 02 02 02 13 13 02 02 02 02 02 05 00 02 00 02 33 02 00 00 00 00 02 00 00 00 00 00 02
 00 00 02 21 02 33 00 00 00 00 00 00 51 46 02 00 02 00 02 00 00 00 00 49 42 02 00 02 00 00 00 02
 00 00 55 02 00 00 33 00 00 00 00 00 00 00 02 33 02 00 02 00 02 00 00 00 00 02 00 02 00 00 40 02
 00 02 02 02 00 00 00 00 00 00 00 00 00 00 02 00 02 30 02 00 00 02 00 00 00 02 00 02 00 00 00 02
 00 00 00 00 02 00 00 00 00 00 00 00 00 28 02 00 02 00 02 00 00 02 00 00 02 30 00 02 00 62 21 02
 00 00 34 02 34 00 00 00 00 00 00 28 00 00 02 00 02 00 02 42 00 00 02 02 00 00 00 02 02 02 02 02
 00 00 00 35 02 00 00 00 00 00 00 00 00 28 02 00 02 00 02 00 00 00 00 00 00 00 02 46 00 62 00 02
 00 00 00 02 00 00 00 00 00 00 00 29 00 00 02 53 02 00 02 02 02 02 02 02 02 02 46 00 00 00 00 02
 00 00 00 02 00 00 00 00 00 00 00 00 00 29 02 13 02 00 31 00 00 00 62 00 02 46 00 00 00 00 46 02
 00 00 00 02 00 00 00 00 00 00 00 29 24 00 02 00 02 02 02 02 02 02 02 02 62 00 00 00 00 00 24 02
 00 00 00 02 00 00 00 00 00 00 00 00 00 29 02 00 00 00 42 00 00 00 47 02 02 00 00 00 00 00 46 02
 46 46 00 00 00 00 00 00 00 00 00 00 00 49 02 00 00 00 00 00 00 00 62 02 49 00 00 00 00 46 24 02
