Gauntlet II
Maze number: 7
Offset for maze 6: 230741 - 0x038555
big endian buf: [%!l(uint8=0) %!l(uint8=3) %!l(uint8=133) %!l(uint8=85)]
G:2 Maze real addr: 230741 - 0x038555, bank 0, boff: 0x0000
Maze read from: 0x038555 - 230741
compresssed: 220
 0D 00 00 00 20 18 A0 6E 60 A3 49 42 C0 1A 5E 50
 2F 44 C7 AA C5 2F 3C 43 C4 B2 CA 50 2E C4 2F A1
 77 80 CB B2 A2 C2 A6 73 18 A9 C8 2F E3 74 80 49
 CD B3 C2 50 09 C8 B2 A2 7F 81 A6 CF 35 C2 A1 2E
 C5 31 1D 40 C5 31 C7 A3 2E C9 B2 A7 B6 C6 26 C7
 A3 46 81 D1 0C 82 D9 1D C3 B2 A4 C6 A1 BC D3 2E
 47 2F 19 CC 2F CD B2 A3 CA B5 A5 C3 0F C6 54 29
 C1 54 20 41 47 4E C9 B5 A2 B8 A3 CA BE A5 6B C4
 24 CA 50 20 41 DA B2 C1 B5 A7 CC A4 C4 08 C5 1D
 C4 31 C2 BF C1 BA A0 29 C1 2F C0 35 42 08 C1 1D
 64 CF B2 A3 08 18 08 A3 C8 24 CE 08 81 C1 0B DE
 0B C0 1D C0 B5 C1 B8 45 C2 AF CA B4 A3 CD 0A C0
 31 CF 19 CA 19 0A A8 BE C6 AE B6 20 C9 A4 60 63
 07 2E 35 32 10 32 35 2E 07 62 CB 00
  Encoded length: 220 bytes
  Wall pattern: 08, Wall color: 00     Floor pattern: 01, Floor color: 10
  Flags: WRAP_H 
  Random food adds: 0
  Secret trick: 13 - Don't Be Greedy (no treasure)
 02 02 02 02 02 02 02 02 02 02 02 02 02 02 02 02 02 02 02 02 02 02 02 02 02 02 02 02 02 02 02 02
 00 00 00 46 02 26 35 00 00 00 00 00 00 00 00 00 00 00 00 00 00 00 35 02 47 00 00 00 00 00 46 00
 00 00 00 00 02 00 00 02 02 02 02 02 02 02 02 02 02 02 00 00 00 00 00 02 47 60 00 00 00 00 46 00
 00 00 00 00 02 00 00 00 00 00 00 00 00 00 00 00 35 02 46 00 00 00 00 02 47 02 02 00 00 00 02 00
 00 00 00 09 09 00 00 00 00 00 00 00 00 00 00 00 00 02 02 02 02 00 00 02 02 02 02 02 02 02 02 00
 00 02 00 09 24 02 02 02 02 02 02 02 02 02 02 00 00 00 00 00 02 00 00 02 47 00 00 00 00 02 02 00
 00 02 00 09 09 00 00 00 00 00 00 00 00 00 02 46 00 00 00 00 02 00 00 02 00 00 00 00 00 00 02 00
 00 02 35 00 09 00 00 00 00 00 00 00 00 00 02 02 02 02 00 00 02 00 00 02 00 00 00 02 00 00 00 00
 00 02 09 09 09 02 02 02 02 02 02 02 00 00 00 00 00 00 00 00 02 00 00 02 00 00 00 02 53 00 00 00
 02 02 46 00 00 00 00 00 00 49 29 02 46 00 00 00 00 00 00 49 02 00 00 02 00 00 00 02 02 02 02 02
 46 02 00 00 00 00 00 00 00 00 00 02 02 02 02 02 02 02 02 02 02 00 00 02 00 00 00 02 38 00 00 00
 00 02 00 00 02 02 02 02 02 00 00 00 00 00 00 00 46 02 46 00 00 00 00 02 00 00 00 02 00 00 00 00
 00 02 00 00 02 12 12 12 02 00 00 00 00 00 00 00 00 02 00 00 00 00 00 02 00 00 00 02 00 00 02 00
 00 02 00 29 02 00 00 00 02 02 02 02 02 02 00 00 00 02 00 00 02 02 02 02 00 00 00 02 00 00 02 00
 00 02 00 00 02 00 00 00 00 00 00 00 46 02 00 00 00 02 00 00 02 46 47 25 00 00 00 02 00 00 02 00
 00 02 00 00 02 47 00 00 00 00 00 00 00 02 00 00 00 02 00 00 02 02 02 02 02 00 00 02 00 00 02 00
 00 02 00 00 02 02 02 02 02 02 02 00 00 02 00 15 00 02 00 00 00 00 00 35 02 00 00 02 00 41 02 00
 35 02 00 00 00 00 32 00 00 46 02 00 00 02 00 00 00 02 46 00 00 00 00 00 02 00 00 02 00 00 02 00
 00 02 46 00 00 00 00 00 00 00 02 00 00 02 02 02 02 02 02 02 02 02 00 00 02 00 00 02 00 00 02 00
 00 02 02 02 02 02 02 02 00 00 02 00 00 00 00 00 00 00 00 00 32 02 00 00 02 00 36 02 00 00 02 00
 00 00 00 00 00 00 35 02 32 00 02 46 00 00 00 00 00 00 00 00 00 02 00 00 02 00 00 02 00 00 02 00
 00 00 00 00 00 00 00 02 00 00 02 02 02 02 02 02 02 02 02 00 00 02 00 00 02 00 00 02 00 00 02 00
 02 02 02 02 02 00 00 00 00 00 08 00 00 00 00 00 00 29 02 00 00 02 00 49 02 00 00 02 00 00 02 02
 41 00 00 47 02 53 00 00 00 46 08 00 00 29 00 00 00 00 02 32 00 02 00 00 02 00 00 02 00 00 00 00
 00 00 00 00 02 02 02 02 02 08 24 08 02 02 02 02 00 00 02 00 00 02 00 00 02 36 00 02 00 00 00 00
 00 00 00 00 00 00 00 00 00 08 08 08 00 00 11 02 00 00 02 00 00 02 00 00 02 00 00 02 00 00 00 00
 00 00 00 00 00 00 00 00 00 00 00 00 00 00 11 02 29 00 02 00 00 02 00 00 02 00 00 02 46 00 00 00
 02 02 02 02 02 02 02 02 02 02 02 02 02 02 02 02 00 00 00 00 00 00 00 00 02 00 00 02 02 02 02 02
 00 00 00 00 00 00 00 00 00 00 00 00 00 00 10 02 49 00 00 00 00 00 00 00 02 00 00 00 00 00 00 00
 00 25 00 00 00 00 00 00 00 00 00 00 00 25 10 02 02 02 02 02 02 02 02 02 02 00 00 00 00 00 00 00
 02 02 02 02 02 02 02 02 02 02 02 02 02 02 02 02 32 00 00 00 00 00 00 00 00 00 00 02 02 02 02 02
 00 32 00 00 00 00 32 07 46 53 50 16 50 53 46 07 00 00 00 32 00 00 00 00 00 00 00 00 00 00 00 00
 02 02 02 02 02 02 02 02 02 02 02 02 02 02 02 02 02 02 02 02 02 02 02 02 02 02 02 02 02 02 02 02
