Gauntlet II
Maze number: 31
Offset for maze 30: 236577 - 0x039c21
big endian buf: [%!l(uint8=0) %!l(uint8=3) %!l(uint8=156) %!l(uint8=33)]
G:2 Maze real addr: 236577 - 0x039C21, bank 0, boff: 0x0000
Maze read from: 0x039c21 - 236577
compresssed: 260
 0F 00 00 02 00 21 28 6E 61 0E 08 C1 35 41 E9 4C
 35 C0 31 60 40 6D 41 C3 20 41 C8 20 C0 1C 2E C2
 51 CF A3 0D 81 AF A4 C3 24 CC 33 40 D3 1E C9 1D
 C7 1E C0 51 CF 20 C0 35 D1 72 C5 A7 C1 A5 45 C1
 05 C5 33 C4 31 B5 C5 35 C6 1F C0 0C 05 66 6A D8
 51 4B CE A1 0D 81 A2 C7 1F C2 19 72 C9 3B C4 35
 C3 B5 C8 05 C2 20 C4 B2 C6 B2 C8 1E C2 05 C5 35
 CF 1D 2E 42 BF 0B 05 C1 0D 81 A1 0D 81 C2 0F C3
 0D 80 A4 B9 0D A2 C7 35 C1 52 C6 52 C1 3A C2 35
 09 C1 10 C0 19 C3 1E D4 09 C4 72 C0 BF C7 35 C4
 3A C5 1E C0 09 C4 05 C8 B2 A1 0D 81 A1 B2 C6 09
 C3 0B 05 D8 09 C1 1A 69 C4 51 64 C4 09 C3 19 C5
 BF 31 E5 35 C4 31 B7 C2 09 1C C5 B4 C2 AF 04 C2
 09 DB 1D CB 1E C8 51 CB 0A C0 1A C1 75 C0 52 67
 C0 35 A0 60 C8 52 35 BB C1 09 05 AF AA 05 4A 60
 48 61 4B 42 43 45 C8 BE 61 41 C0 20 45 61 C3 1A
 C2 1A 62 00
  Encoded length: 260 bytes
  Wall pattern: 01, Wall color: 08     Floor pattern: 02, Floor color: 02
  Flags: 
  Random food adds: 2
  Secret trick: 15 - Be Pushy
 02 02 02 02 02 02 02 02 02 02 02 02 02 02 02 02 02 02 02 02 02 02 02 02 02 02 02 02 02 02 02 02 02
 02 00 53 00 00 46 00 00 00 00 00 00 00 00 00 00 02 00 00 00 00 00 00 00 00 00 00 00 00 00 46 53 02
 02 49 00 33 00 46 00 00 00 00 00 00 00 00 00 00 14 00 00 00 33 00 00 46 00 00 00 00 32 00 00 46 02
 02 00 00 00 00 00 00 00 00 32 00 28 46 00 00 00 14 00 00 00 00 00 00 00 00 00 00 00 00 00 00 00 02
 02 02 02 02 02 13 13 13 02 02 02 02 02 02 02 02 02 02 02 02 02 02 02 02 02 02 02 02 02 00 00 00 02
 02 36 00 00 02 00 00 00 00 00 00 00 00 00 00 51 02 46 00 00 00 00 00 00 00 00 00 00 14 00 00 00 02
 02 00 08 00 02 00 30 00 00 00 00 00 00 00 00 00 02 29 00 00 00 00 00 00 00 00 30 00 14 00 00 00 02
 02 00 08 00 02 00 00 00 00 00 00 00 00 32 00 53 02 00 00 00 00 00 00 00 00 00 00 00 02 00 00 00 02
 02 00 08 00 02 00 00 00 02 02 02 02 02 02 02 02 02 00 00 02 02 02 02 02 02 00 00 00 02 00 00 46 02
 02 00 05 00 02 00 00 00 02 51 00 00 00 00 00 49 02 00 00 00 00 00 00 53 02 00 00 00 02 00 00 31 02
 02 12 05 00 02 00 00 00 02 00 33 00 00 00 00 00 14 00 00 00 00 00 33 00 02 00 00 00 02 00 00 00 02
 02 00 08 00 02 00 00 00 02 00 00 00 00 00 00 00 14 00 00 00 00 00 00 00 02 00 00 00 02 46 00 00 02
 02 00 08 00 02 00 00 00 02 00 00 00 02 02 02 13 13 13 02 02 02 00 00 00 02 00 00 00 02 31 00 00 02
 02 25 08 00 02 00 00 00 02 00 00 00 02 59 00 00 00 00 00 53 02 00 00 00 02 00 00 00 02 00 00 00 02
 02 00 05 00 02 00 32 00 02 00 00 00 02 00 00 00 00 00 00 00 02 00 00 00 00 00 00 00 02 00 30 00 02
 02 00 05 00 02 00 00 00 02 53 00 00 14 00 00 00 00 00 00 00 14 00 00 00 00 00 29 46 02 00 00 46 02
 02 11 05 00 02 13 13 13 02 02 13 13 14 00 00 00 15 00 00 00 14 13 13 02 02 02 02 02 02 13 02 02 02
 02 00 08 00 02 00 00 00 02 53 00 00 14 00 00 00 00 00 00 00 14 00 00 58 02 00 00 53 09 00 02 16 02
 02 25 08 00 02 00 30 00 02 00 00 00 02 00 00 00 00 00 00 00 02 00 00 00 02 00 00 00 09 00 02 00 02
 02 00 08 00 02 00 00 00 02 00 00 00 02 53 00 00 00 00 00 58 02 00 00 00 02 00 30 00 09 00 02 00 02
 02 00 05 00 02 00 00 00 02 00 00 00 02 02 02 13 13 13 02 02 02 00 00 00 02 00 00 00 09 00 02 00 02
 02 11 05 00 02 00 00 00 02 00 00 00 00 00 00 00 14 00 00 00 00 00 00 00 02 00 00 00 09 00 02 26 02
 02 00 08 00 02 00 00 00 02 00 33 00 00 00 00 00 14 00 00 00 00 00 33 00 02 00 00 00 09 00 02 00 02
 02 25 08 00 02 00 00 00 02 49 00 00 00 00 00 00 02 53 00 00 00 00 00 49 02 00 00 00 09 28 02 00 02
 02 00 08 00 02 00 00 00 02 02 02 02 02 02 02 02 02 02 02 02 02 02 02 02 04 00 00 00 09 00 02 00 02
 02 00 08 00 14 00 00 00 00 00 00 00 00 00 00 00 14 00 00 00 00 00 00 00 00 29 00 00 14 00 02 00 02
 02 00 08 00 14 00 30 00 00 00 00 00 00 00 00 00 14 00 00 00 00 00 00 00 00 00 00 00 14 10 02 26 02
 02 00 08 00 14 00 00 00 00 00 00 00 00 33 00 53 02 00 33 00 00 00 00 00 00 00 00 00 14 53 02 00 02
 02 09 05 02 02 02 02 02 02 02 02 02 02 02 02 02 02 02 02 02 02 02 02 02 02 02 02 02 02 02 05 00 02
 02 00 00 00 00 00 00 00 00 00 46 00 33 00 00 00 00 00 00 00 00 00 46 00 00 33 00 00 00 00 00 00 02
 02 00 00 00 00 00 46 00 00 00 46 00 00 00 00 46 00 00 00 00 00 00 46 00 00 00 00 00 00 00 00 00 02
 02 00 00 33 00 00 46 00 32 00 00 00 00 00 00 46 00 00 33 00 00 00 00 26 00 00 00 26 00 00 00 33 02
 02 02 02 02 02 02 02 02 02 02 02 02 02 02 02 02 02 02 02 02 02 02 02 02 02 02 02 02 02 02 02 02 02
