Gauntlet II
Maze number: 54
Offset for maze 53: 234800 - 0x039530
big endian buf: [%!l(uint8=0) %!l(uint8=3) %!l(uint8=149) %!l(uint8=48)]
G:2 Maze real addr: 242992 - 0x03B530, bank 1, boff: 0x2000
Maze read from: 0x03b530 - 242992
compresssed: 235
 11 20 00 00 00 42 AB AE 5C 0E 5F 2E 80 E0 41 20
 A0 41 20 A0 C6 38 C8 0F C2 14 A0 C1 A1 C2 A1 C4
 2B EE EE B2 E2 C3 42 31 E1 72 E5 C7 38 EA E2 B2
 74 FA E2 B2 E2 72 E9 C6 20 77 E2 B4 C8 14 A0 E1
 E2 B2 E6 B2 D0 21 D3 38 E5 E2 B2 E4 CA A3 C4 14
 A0 78 C2 A4 E2 1F E0 C2 31 E0 E9 B2 E1 32 70 A0
 CB 14 A0 E2 DE 21 C0 4C 3A C5 43 A0 C3 B2 A0 C3
 A3 C2 A2 C3 A2 BF E3 C2 20 A0 C4 20 75 A0 E3 1F
 C3 14 A0 C8 B2 C2 B2 C1 B2 CD 14 E1 C5 4F C1 35
 C3 46 49 A3 C3 A3 B2 A7 01 89 C3 01 81 C0 34 CA
 32 A1 C1 A1 C1 A1 C1 A1 C1 A2 6D 61 80 61 80 61
 80 61 1E CF A1 C1 A1 C1 A1 C1 A1 C4 1D C0 41 1D
 C3 20 61 80 61 80 61 80 61 1E CB 43 35 DD B5 A1
 1D A6 1D A3 F2 E6 DF D6 29 C6 29 C6 19 CC 19 CF
 BE 10 19 CA 54 19 CC 54 C0 37 00
  Encoded length: 235 bytes
  Wall pattern: 02, Wall color: 11     Floor pattern: 04, Floor color: 10
  Flags: ODDANGLE_GRUNTS 
  Random food adds: 0
  Secret trick: 17 - Don't Hurt Friends
 02 02 02 02 02 02 02 02 02 02 02 02 02 02 02 02 02 02 02 02 02 02 02 02 02 02 02 02 02 02 02 02 02
 02 46 00 02 46 00 00 32 02 46 00 00 32 02 00 00 00 00 00 00 02 56 00 00 00 00 00 00 00 00 00 15 02
 02 00 00 20 02 00 00 02 02 00 00 00 02 02 00 00 00 00 00 43 02 00 00 00 00 00 00 00 00 00 00 00 02
 02 00 00 02 00 00 00 00 00 02 00 00 00 00 00 00 00 00 00 02 02 00 00 00 02 02 00 00 00 46 00 00 02
 02 49 00 00 02 00 00 00 31 02 00 00 00 00 00 02 02 00 00 00 00 00 00 00 56 02 00 00 00 00 00 00 02
 02 00 00 00 02 00 00 00 02 02 00 00 00 00 00 31 02 00 00 00 00 00 00 00 00 02 00 00 00 00 00 00 02
 02 00 00 00 00 00 00 00 00 00 00 02 02 00 00 02 02 00 00 00 02 02 00 00 31 02 00 00 00 00 00 00 02
 02 00 00 02 00 00 00 00 00 00 00 32 02 00 00 00 00 00 00 00 31 02 00 00 02 02 00 00 00 00 00 00 02
 02 00 00 20 02 00 00 02 02 00 00 02 02 00 00 00 00 00 00 00 02 02 00 00 00 00 00 00 00 00 00 00 02
 02 00 00 00 00 00 00 33 02 00 00 00 00 00 00 00 00 00 00 00 00 00 00 00 00 00 00 00 56 00 00 00 02
 02 00 00 02 00 00 00 02 02 00 00 00 00 00 02 02 00 00 00 00 00 00 00 00 00 00 02 02 02 02 00 00 02
 02 00 00 20 02 00 00 00 00 00 00 00 00 00 31 02 00 00 02 02 02 02 02 00 00 00 02 31 00 02 00 00 02
 02 49 00 02 00 00 00 00 00 00 00 00 00 00 02 02 00 00 02 50 00 31 02 00 00 00 00 00 00 00 00 00 02
 02 00 00 20 02 00 00 00 02 02 00 00 00 00 00 00 00 00 00 00 00 00 00 00 00 00 00 00 00 00 00 00 02
 02 00 00 00 00 00 00 00 33 02 46 00 00 00 00 00 00 00 00 00 00 00 00 00 58 00 00 00 00 00 00 46 02
 02 00 00 00 02 00 00 00 00 02 02 00 00 00 02 02 02 02 02 00 00 02 02 02 02 00 00 00 00 02 02 02 02
 02 00 00 00 00 02 00 00 00 32 02 00 00 00 02 00 32 00 02 00 00 02 00 31 02 00 00 00 00 02 31 00 02
 02 00 00 20 02 00 00 00 00 00 00 00 00 00 02 00 00 00 02 00 00 02 00 00 00 00 00 00 00 00 00 00 02
 02 00 00 00 20 02 00 02 00 00 00 00 00 00 46 00 00 00 00 00 00 00 00 00 00 00 00 00 00 00 00 00 02
 02 53 00 00 00 02 46 00 00 00 00 00 00 00 46 00 00 00 00 00 00 00 00 00 00 02 02 02 02 00 00 00 02
 02 02 02 02 02 02 02 02 02 02 02 02 02 02 01 01 01 01 01 01 01 01 01 01 01 00 00 00 00 01 01 01 02
 02 52 00 00 00 00 00 00 00 00 00 00 00 50 02 02 00 00 02 02 00 00 02 02 00 00 02 02 00 00 02 02 02
 02 00 00 00 00 00 00 00 00 00 00 00 00 00 02 28 00 00 28 28 00 00 28 28 00 00 28 28 00 00 28 30 02
 02 00 00 00 00 00 00 00 00 00 00 00 00 00 02 00 02 02 00 00 02 02 00 00 02 02 00 00 02 02 00 00 02
 02 00 00 29 00 46 00 00 29 00 00 00 00 32 02 00 28 28 00 00 28 28 00 00 28 28 00 00 28 30 00 00 02
 02 00 00 00 00 00 00 00 00 00 46 00 00 00 02 53 00 00 00 00 00 00 00 00 00 00 00 00 00 00 00 00 02
 02 00 00 00 00 00 00 00 00 00 00 00 00 00 02 02 02 29 02 02 02 02 02 02 02 29 02 02 02 02 00 00 02
 02 00 00 00 00 00 00 00 00 00 00 00 00 00 14 00 00 02 00 00 00 00 00 00 00 02 00 00 00 14 00 00 02
 02 00 00 00 00 00 00 00 00 00 00 00 00 00 14 00 00 00 00 00 00 00 00 00 00 00 00 00 00 14 00 00 02
 02 00 00 00 00 00 00 00 00 00 00 00 00 00 14 00 00 41 00 00 00 00 00 00 00 41 00 00 00 14 00 00 02
 02 25 00 00 00 00 00 00 00 00 00 00 00 00 14 25 00 00 00 00 00 00 00 00 00 00 00 00 00 14 00 00 02
 02 16 25 00 00 00 00 00 00 00 00 00 00 00 14 25 00 00 00 00 00 00 00 00 00 00 00 00 00 14 00 55 02
 02 02 02 02 02 02 02 02 02 02 02 02 02 02 02 02 02 02 02 02 02 02 02 02 02 02 02 02 02 02 02 02 02
