Gauntlet II
Maze number: 84
Offset for maze 83: 235799 - 0x039917
big endian buf: [%!l(uint8=0) %!l(uint8=3) %!l(uint8=153) %!l(uint8=23)]
G:2 Maze real addr: 252183 - 0x03D917, bank 2, boff: 0x4000
Maze read from: 0x03d917 - 252183
compresssed: 280
 01 00 12 00 00 60 07 7E 7F 55 9A 2E 80 C7 0F 81
 CA 70 3A C2 1A 31 DB 20 E5 E2 C7 38 A4 1C C0 1C
 B2 58 A0 19 50 A0 C2 A4 19 66 62 CD 2E 6B 62 C2
 1C C7 3A 40 C5 0A C3 25 3F 62 C0 1C E2 C3 A2 B6
 AD 2F 57 A0 CD 18 2E F4 07 81 A6 E1 52 C9 1C 40
 C0 32 18 01 3E 48 42 C8 A3 B2 AC 15 C1 B3 C0 B4
 48 C0 2F C5 20 C4 10 D7 A1 C1 B2 3C E0 C1 B4 C9
 22 B2 E7 63 61 C3 1F B3 C7 2E C2 1C E2 C3 A1 C1
 2F E6 C1 BF CD A2 E2 E6 C2 79 A0 E1 3E 19 E1 32
 C2 B3 A2 C5 B3 C1 0A BB A0 C2 35 A0 C1 A3 40 B9
 41 C0 31 E9 40 42 60 E5 52 E3 E5 C2 B2 E1 C1 A1
 E2 C2 B3 E3 1C 70 20 E1 E2 C1 B5 15 A0 41 A0 E0
 C0 28 E0 C1 B4 C5 A2 E2 E1 C0 A1 3F A3 E2 62 61
 A2 3F 63 61 3E E9 E2 66 63 61 A6 E6 C5 1F C0 23
 72 A0 47 42 E2 19 A0 CB A7 3F 80 B2 E1 B2 C1 35
 3E 33 A0 E9 2F 42 A0 C6 31 E6 E7 E4 C7 1C E7 3F
 E4 64 63 80 A1 B7 F4 E0 D4 BE 31 C1 71 A0 C0 25
 E0 C3 74 B5 1F C6 1F 00
  Encoded length: 280 bytes
  Wall pattern: 00, Wall color: 07     Floor pattern: 06, Floor color: 00
  Flags: FAST_SORCERERS FAST_GRUNTS 
  Random food adds: 0
  Secret trick:  1 - Try Transportability (onto demon)
 02 02 02 02 02 02 02 02 02 02 02 02 02 02 02 02 02 02 02 02 02 02 02 02 02 02 02 02 02 02 02 02 02
 02 46 00 00 00 00 00 00 00 00 15 02 15 00 00 00 00 00 00 00 00 00 00 00 26 02 58 00 00 00 26 49 02
 02 00 00 00 00 00 00 00 00 00 00 02 00 00 00 00 00 00 00 00 00 00 00 00 00 02 00 00 32 00 00 00 02
 02 00 00 02 00 00 00 02 00 00 00 02 00 00 00 00 56 02 02 02 02 02 28 00 28 02 00 00 00 00 00 00 02
 02 00 00 21 02 25 00 21 02 00 00 02 02 02 02 02 02 25 00 00 00 00 00 00 00 63 00 00 00 63 00 00 02
 02 00 00 00 00 00 00 00 00 00 00 02 46 00 00 00 00 00 00 00 00 00 00 00 00 63 00 00 00 63 00 00 02
 02 28 00 00 00 00 00 00 00 00 58 02 62 00 00 00 00 00 00 10 00 00 00 00 37 63 00 00 00 63 00 28 02
 02 00 00 02 00 00 00 02 02 02 02 02 02 02 02 02 02 02 02 02 02 02 02 02 02 02 47 00 02 00 00 00 02
 02 00 00 21 02 00 00 02 00 00 00 00 00 00 00 00 00 00 00 24 46 00 00 00 00 00 02 00 02 00 00 00 02
 02 00 00 00 00 00 00 02 00 02 02 07 07 07 02 02 02 02 02 02 02 00 02 02 02 00 02 21 02 00 00 00 02
 02 00 00 00 00 00 28 02 62 02 50 24 01 62 00 00 00 00 00 00 00 00 02 62 02 00 02 62 02 00 00 00 02
 02 00 00 00 00 02 02 02 02 02 02 02 02 02 02 02 02 02 02 02 02 02 02 21 02 00 02 02 02 00 00 00 02
 02 00 00 00 02 00 62 02 47 00 00 00 00 00 00 32 00 00 02 00 00 16 02 00 02 00 00 02 00 00 00 00 02
 02 00 00 00 02 00 00 02 00 00 00 00 00 00 02 02 00 00 02 60 00 02 02 00 02 00 00 02 00 00 00 00 02
 02 00 00 34 02 00 00 02 00 00 00 00 00 02 00 00 00 00 63 00 00 63 02 00 00 02 31 02 00 00 00 00 02
 02 00 00 02 46 00 00 02 28 00 00 00 02 00 00 00 00 02 02 00 00 47 02 00 00 02 00 00 00 02 00 00 02
 02 00 00 02 00 00 00 02 00 00 00 02 00 00 00 02 02 02 00 00 00 02 02 00 00 02 00 00 00 02 00 00 02
 02 26 00 02 00 00 00 02 00 00 00 02 02 00 00 02 62 25 00 00 02 50 02 00 02 02 02 02 02 00 00 00 02
 02 00 00 02 00 00 10 02 02 02 00 02 53 02 00 00 02 02 02 02 00 62 02 00 02 62 02 49 00 00 00 00 02
 02 00 00 00 00 00 02 00 62 02 00 02 62 00 63 00 00 00 00 00 00 02 00 00 02 21 02 00 00 00 02 00 02
 02 00 00 00 00 02 00 00 00 02 00 02 02 00 00 02 02 00 00 00 02 00 00 00 02 00 02 00 00 02 28 26 02
 02 32 00 00 02 00 00 00 02 00 00 02 21 02 00 00 62 02 00 02 00 40 00 02 00 00 02 00 00 00 00 00 02
 02 02 02 02 00 00 00 02 00 00 02 00 02 02 63 02 02 02 02 00 00 00 02 00 00 00 63 00 00 63 02 02 02
 02 63 00 00 00 00 63 00 00 63 62 00 00 00 00 00 00 00 02 00 00 02 00 00 00 02 00 00 00 00 00 00 02
 02 63 00 00 00 00 63 00 00 63 02 02 02 02 02 02 02 00 02 00 02 00 00 00 02 00 00 00 00 00 00 31 02
 02 35 26 00 00 00 02 00 00 00 00 00 00 00 00 62 02 00 02 62 02 00 00 02 25 02 00 00 00 00 00 00 02
 02 00 00 00 00 00 02 02 02 02 02 02 02 02 63 63 02 00 02 02 02 00 02 53 62 51 02 00 00 00 00 00 02
 02 00 00 00 00 02 47 00 00 00 62 02 00 00 00 00 00 00 02 49 00 00 02 00 00 00 00 02 00 00 00 00 02
 02 00 00 00 02 00 00 00 00 00 02 00 00 00 00 00 00 00 02 28 00 00 02 00 00 00 00 00 02 63 00 00 02
 02 00 00 02 00 00 00 00 00 63 00 00 00 00 63 63 02 02 02 00 00 00 02 00 00 00 00 00 00 00 00 00 02
 02 00 00 00 00 00 00 00 02 00 02 00 00 00 00 00 00 00 00 00 00 00 02 00 00 00 00 00 00 00 00 00 02
 02 49 00 00 26 00 00 02 00 37 00 02 00 00 00 00 26 00 00 00 00 00 02 31 00 00 00 00 00 00 00 31 02
 02 02 02 02 02 02 02 02 02 02 02 02 02 02 02 02 02 02 02 02 02 02 02 02 02 02 02 02 02 02 02 02 02
