Gauntlet II
Maze number: 5
Offset for maze 4: 230404 - 0x038404
big endian buf: [%!l(uint8=0) %!l(uint8=3) %!l(uint8=132) %!l(uint8=4)]
G:2 Maze real addr: 230404 - 0x038404, bank 0, boff: 0x0000
Maze read from: 0x038404 - 230404
compresssed: 200
 00 00 00 08 00 33 64 47 59 09 08 2E 80 C2 18 41
 D5 10 C0 31 45 C8 22 CA 15 C1 2E C4 18 07 72 CA
 AF A5 C9 31 C6 2E 83 45 6E 4E C8 22 61 C5 52 C7
 1D C0 1D 07 72 56 C8 B4 CF AF 63 60 C8 33 2E D4
 72 C7 18 C2 71 C1 1F C6 72 61 43 C6 B3 A4 52 48
 63 41 D6 07 60 63 07 D6 07 A7 C5 20 41 08 09 CC
 2E 1D C2 1D C1 1D DF C0 BF DF C1 20 41 09 08 C6
 1F DF CF 2E D1 2E CB AF A3 B7 A0 09 81 08 81 07
 81 C0 35 C1 0E C6 04 A2 CD 12 81 C2 0E C5 1F 04
 D0 12 80 C0 0F C1 0E C6 04 CE 1D C0 12 80 A8 E2
 1C 84 CA 12 80 C0 2E C9 A6 CA 12 81 D0 B2 AA D6
 1C 31 C0 1D 32 C0 1E 32 D6 B2 C7 B2 D8 B3 DF C1
 B4 C4 BE 38 FA C0 2E 00
  Encoded length: 200 bytes
  Wall pattern: 03, Wall color: 04     Floor pattern: 03, Floor color: 06
  Flags: WALLS_CYCLIC 
  Random food adds: 0
  Secret trick:  0 - No trick
 02 02 02 02 02 02 02 02 02 02 02 02 02 02 02 02 02 02 02 02 02 02 02 02 02 02 02 02 02 02 02 02 02
 02 46 00 00 00 24 00 00 07 08 09 00 00 00 00 00 00 00 00 00 00 00 00 00 00 00 00 00 00 00 00 16 02
 02 49 00 00 00 00 00 00 07 08 09 00 00 00 00 00 00 00 34 00 00 00 00 00 00 00 00 00 00 00 21 00 02
 02 46 00 00 00 00 00 24 07 08 09 00 00 00 00 00 00 00 00 00 02 02 02 02 02 02 02 02 02 02 02 02 02
 02 02 02 02 02 02 02 02 02 02 09 00 00 00 00 00 00 00 00 00 02 49 00 00 00 00 00 00 09 46 46 46 02
 02 46 00 00 00 00 00 00 07 08 09 00 00 00 00 00 00 00 00 00 02 00 00 00 25 00 00 00 09 00 00 00 02
 02 00 00 00 00 00 00 00 07 08 09 00 00 00 00 00 00 00 34 00 02 25 00 00 00 00 00 00 09 00 00 00 02
 02 00 00 00 00 29 00 29 07 08 09 00 00 00 00 00 00 00 00 00 02 00 00 00 00 00 00 00 08 00 00 00 02
 02 00 00 00 02 02 02 02 02 02 02 02 02 02 02 02 02 02 02 02 08 00 00 00 00 25 00 25 08 00 00 00 02
 02 00 00 00 02 51 46 00 00 08 09 00 00 00 00 00 00 00 00 00 08 00 00 00 00 00 00 00 08 00 00 00 02
 02 00 00 00 02 24 00 00 00 08 09 00 31 00 00 00 00 00 00 00 08 00 00 25 00 00 00 00 07 00 00 00 02
 02 00 00 00 02 02 02 02 02 02 09 00 00 00 00 00 00 00 00 00 07 00 00 00 00 25 00 00 07 00 00 00 02
 02 00 00 00 00 00 00 00 00 00 00 00 00 00 00 00 00 00 00 00 07 00 25 00 00 00 00 25 07 00 00 00 02
 02 00 00 00 00 00 00 00 00 00 00 00 00 00 00 00 00 00 00 00 07 02 02 02 02 02 02 02 02 00 00 00 02
 02 00 00 32 00 00 07 08 09 00 00 00 00 00 00 00 00 00 00 00 00 02 46 29 00 00 00 29 00 00 29 00 02
 02 00 00 00 00 00 00 00 00 00 00 00 00 00 00 00 00 00 00 00 00 02 00 00 00 00 00 00 00 00 00 00 02
 02 00 00 00 00 00 00 00 00 00 00 00 00 00 00 00 00 00 00 00 00 02 00 00 00 00 00 00 00 00 00 00 02
 02 00 00 32 00 00 07 09 08 00 00 00 00 00 00 00 31 00 00 00 00 02 00 00 00 00 00 00 00 00 00 00 02
 02 00 00 00 00 00 00 00 00 00 00 00 00 00 00 00 00 00 00 00 00 02 00 00 00 00 00 00 00 00 00 00 02
 02 46 00 00 00 00 00 00 00 00 00 00 00 00 00 00 00 00 00 00 46 02 00 00 00 00 00 00 00 00 00 00 02
 02 02 02 02 02 02 02 02 02 02 02 02 02 02 02 02 02 02 02 02 02 02 02 09 09 09 08 08 08 07 07 07 02
 02 53 00 00 14 00 00 00 00 00 00 00 04 02 02 02 00 00 00 00 00 00 00 00 00 00 00 00 00 00 18 18 02
 02 00 00 00 14 00 00 00 00 00 00 31 04 00 00 00 00 00 00 00 00 00 00 00 00 00 00 00 00 00 18 18 02
 02 15 00 00 14 00 00 00 00 00 00 00 04 00 00 00 00 00 00 00 00 00 00 00 00 00 00 00 29 00 18 18 02
 02 02 02 02 02 02 02 02 02 00 00 00 02 28 28 28 28 28 02 00 00 00 00 00 00 00 00 00 00 00 18 18 02
 02 46 00 00 00 00 00 00 00 00 00 00 02 02 02 02 02 02 02 00 00 00 00 00 00 00 00 00 00 00 18 18 02
 02 00 00 00 00 00 00 00 00 00 00 00 00 00 00 00 00 00 02 02 02 02 02 02 02 02 02 02 02 02 00 00 02
 02 00 00 00 00 00 00 00 00 00 00 00 00 00 00 00 00 00 00 00 02 28 49 02 29 50 02 30 50 02 00 00 02
 02 00 00 00 00 00 00 00 00 00 00 00 00 00 00 00 00 00 00 00 02 00 00 02 00 00 02 00 00 02 00 00 02
 02 00 00 00 00 00 00 00 00 00 00 00 00 00 00 00 00 00 00 00 00 00 00 02 00 00 02 00 00 00 00 00 02
 02 00 00 00 00 00 00 00 00 00 00 00 00 00 00 00 00 00 00 00 00 00 00 00 00 00 02 00 00 00 00 00 02
 02 56 00 00 00 00 00 00 00 00 00 00 00 00 00 00 00 00 00 00 00 00 00 00 00 00 00 00 00 02 00 46 02
 02 02 02 02 02 02 02 02 02 02 02 02 02 02 02 02 02 02 02 02 02 02 02 02 02 02 02 02 02 02 02 02 02
