Gauntlet II
Maze number: 14
Offset for maze 13: 232264 - 0x038b48
big endian buf: [%!l(uint8=0) %!l(uint8=3) %!l(uint8=139) %!l(uint8=72)]
G:2 Maze real addr: 232264 - 0x038B48, bank 0, boff: 0x0000
Maze read from: 0x038b48 - 232264
compresssed: 344
 09 00 00 00 00 2B 40 41 53 10 2E 2E 80 C3 08 CF
 32 E1 21 C0 31 82 C4 08 C2 3C C2 A4 1F A0 69 C5
 A4 32 C5 2E A0 C1 B2 1F 66 CA 38 B3 01 80 E4 E1
 25 C1 B2 62 C6 B2 B2 B2 B2 A0 C0 A3 E1 1F C2 A1
 04 C1 2E 60 C9 1D C4 2E A0 E1 C2 22 E0 C1 35 60
 C3 09 80 C1 09 81 C2 A2 E2 C2 A1 2E 63 C2 B4 1D
 09 C3 07 C0 1D 40 80 E2 1F C2 22 E0 C7 09 A5 0C
 E8 C2 A1 2E C0 B4 0D 80 71 CA 09 81 C2 A3 C2 22
 E0 C7 A3 49 80 C2 77 C1 A1 C5 2E C3 18 A0 CE 2E
 80 A3 C3 A5 C4 1D C6 A4 04 71 71 A0 C0 BC C1 12
 80 2E C7 0C E5 18 25 86 C3 12 80 A0 C0 0F ED CA
 BF 35 12 A0 C8 B8 C1 B5 C2 3F 10 85 52 C3 A1 C3
 B3 C1 B7 C2 1D A0 67 82 CE A3 07 A0 C1 52 C2 52
 C2 52 C0 10 F1 1D 63 87 D0 07 A0 C1 3F 52 10 81
 52 10 80 01 C0 56 DF C8 05 A4 C6 25 86 40 81 C7
 1D C2 1D C1 0A 81 C0 B2 A3 15 2E 80 52 40 80 C0
 12 86 C1 A4 0A C0 B3 C3 2E 45 80 C0 12 86 C1 1F
 C3 0A C1 A2 04 A0 B2 C0 33 43 CC A4 41 81 C3 1E
 D5 1F C8 73 01 C4 A2 0D 80 B5 C5 A3 C7 2E C4 A2
 1F CD 20 C2 1C C0 2E 80 C5 2E 01 C6 B6 C4 A3 C2
 2E 71 41 42 BE 3A 01 C6 0B C0 B5 31 B3 31 A0 31
 C1 21 C0 B5 3A 44 40 00
  Encoded length: 344 bytes
  Wall pattern: 11, Wall color: 00     Floor pattern: 02, Floor color: 04
  Flags: 
  Random food adds: 0
  Secret trick:  9 - Don't Get Hit (while killing a dragon)
 02 02 02 02 02 02 02 02 02 02 02 02 02 02 02 02 02 02 02 02 02 02 02 02 02 02 02 02 02 02 02 02 02
 02 46 00 00 00 00 08 00 00 00 00 00 02 00 00 00 00 00 00 00 00 00 02 50 00 00 02 33 00 49 02 49 02
 02 00 00 00 00 00 08 00 00 00 60 00 02 00 02 02 02 02 02 31 02 00 02 00 00 00 00 02 00 00 02 19 02
 02 00 00 00 00 00 02 02 02 02 02 50 02 00 00 00 00 00 46 02 00 00 02 31 00 00 00 02 00 00 02 19 02
 02 00 00 02 00 00 00 02 02 02 02 56 02 01 01 00 00 00 00 00 02 00 46 02 37 00 00 02 00 00 02 19 02
 02 00 00 02 00 00 00 02 02 02 02 02 00 02 02 02 02 00 00 02 31 00 46 00 02 02 04 00 02 46 02 19 02
 02 00 00 02 00 00 00 00 00 00 29 00 00 00 00 00 46 02 00 00 02 00 46 00 34 00 02 00 02 53 02 19 02
 02 00 00 02 09 09 00 00 09 09 09 00 00 00 02 02 02 00 00 00 02 00 46 00 02 02 46 00 02 00 02 19 02
 02 00 00 02 29 09 00 00 00 00 07 00 29 02 01 01 00 00 00 02 31 00 46 00 34 00 02 00 02 00 02 46 02
 02 00 00 09 02 02 02 02 02 02 12 00 00 02 00 00 00 00 00 00 02 00 46 00 02 02 46 00 02 13 02 46 02
 02 00 00 00 00 00 00 00 00 00 02 09 09 02 00 00 00 02 02 02 02 00 46 00 34 00 02 00 00 00 02 00 02
 02 00 00 02 02 02 02 00 00 00 02 00 00 02 00 00 02 01 01 00 00 00 46 00 00 02 02 00 00 00 02 00 02
 02 46 00 00 00 00 24 02 00 00 02 00 00 02 00 00 02 00 00 00 00 00 00 46 46 02 46 46 02 00 02 00 02
 02 02 02 02 02 02 02 00 00 00 02 00 29 02 00 00 02 00 00 00 02 02 02 02 02 04 46 46 02 00 02 00 02
 02 18 18 46 00 00 00 02 00 00 02 00 12 02 00 00 02 00 00 02 24 37 37 37 37 37 37 37 16 00 16 00 02
 02 18 18 02 00 15 00 02 00 00 02 00 00 02 00 00 02 00 00 00 02 00 00 00 00 00 00 00 16 00 16 00 02
 02 53 18 02 00 00 00 02 00 00 02 00 00 02 00 00 02 00 00 16 63 16 16 16 16 16 16 16 16 00 16 00 02
 02 02 02 00 00 00 00 02 00 00 02 00 00 00 29 02 00 00 00 16 00 00 00 16 19 19 19 16 00 00 16 00 02
 02 00 00 00 00 00 00 00 00 00 00 02 02 02 02 07 02 00 00 16 00 16 00 16 00 16 00 16 00 16 16 00 02
 02 00 00 00 00 00 00 00 00 00 00 00 00 00 00 00 02 29 00 00 00 16 19 19 19 16 19 19 19 19 16 00 02
 02 00 00 00 00 00 00 00 00 00 00 00 00 00 00 00 07 02 00 00 63 16 16 16 16 16 16 16 01 00 16 00 02
 02 00 00 00 00 00 00 00 00 00 00 00 00 00 00 00 00 00 02 00 02 00 00 00 00 00 00 00 16 00 00 00 02
 02 00 00 00 00 00 00 00 05 02 02 02 02 02 00 00 00 00 02 00 02 37 37 37 37 37 37 37 16 00 01 01 02
 02 00 00 00 00 00 00 00 02 29 00 00 00 29 00 00 10 10 02 00 02 02 02 02 02 21 46 46 16 00 01 01 02
 02 18 18 18 18 18 18 18 02 00 02 02 02 02 02 02 10 00 02 00 00 00 00 46 02 00 00 00 46 00 01 01 02
 02 18 18 18 18 18 18 18 02 00 02 31 00 00 00 00 10 00 00 02 02 02 04 02 02 00 51 00 46 00 00 01 02
 02 00 00 00 00 00 00 00 02 00 02 00 02 02 02 02 02 02 00 00 01 01 02 00 00 00 00 30 46 00 00 00 02
 02 00 00 00 00 00 00 00 02 00 02 00 02 00 00 00 00 00 31 00 00 00 02 00 00 00 00 00 46 01 00 00 02
 02 00 00 02 02 02 13 13 02 00 02 00 02 00 02 02 02 02 02 00 00 00 02 00 00 00 00 46 00 00 00 00 02
 02 02 02 02 31 00 00 00 00 00 02 00 02 00 02 00 00 00 00 32 00 00 02 28 46 46 46 00 00 00 00 00 02
 02 46 01 00 00 00 00 00 00 00 02 00 02 00 02 00 02 02 02 02 00 00 02 46 46 00 00 01 00 00 00 01 02
 02 58 01 00 00 00 00 00 00 00 11 00 02 49 02 49 02 49 00 00 33 00 02 58 00 00 00 00 00 01 00 01 02
 02 02 02 02 02 02 02 02 02 02 02 02 02 02 02 02 02 02 02 02 02 02 02 02 02 02 02 02 02 02 02 02 02
