Gauntlet II
Maze number: 104
Offset for maze 103: 233068 - 0x038e6c
big endian buf: [%!l(uint8=0) %!l(uint8=3) %!l(uint8=142) %!l(uint8=108)]
G:2 Maze real addr: 257644 - 0x03EE6C, bank 3, boff: 0x6000
Maze read from: 0x03ee6c - 257644
compresssed: 101
 00 00 00 00 00 21 D2 2E 75 7F 41 DF DF DF DF DF
 DF C0 AF A4 CA AF A4 DF DF DF DF DF DF CA A8 BE
 BE A8 BE C9 BF DF DF C1 32 31 C8 41 2F C5 12 13
 C9 34 33 69 C6 15 16 14 C2 0F DA 18 DC 19 1A C9
 36 3B 69 80 C7 1B C8 37 6A 80 C5 3C CA 38 6A 80
 D1 39 3A DF DF 56 54 EF 7B D2 05 C9 0A D2 03 CB
 10 CE BE DE 00
  Encoded length: 101 bytes
  Wall pattern: 01, Wall color: 02     Floor pattern: 02, Floor color: 13
  Flags: 
  Random food adds: 0
  Secret trick:  0 - No trick
 02 02 02 02 02 02 02 02 02 02 02 02 02 02 02 02 02 02 02 02 02 02 02 02 02 02 02 02 02 02 02 02 02
 02 00 00 00 00 00 00 00 00 00 02 02 00 00 00 00 00 00 00 00 00 02 00 00 00 00 00 00 00 00 00 00 02
 02 00 00 00 00 00 00 00 00 00 02 02 00 00 00 00 00 00 00 00 00 02 00 00 00 00 00 00 00 00 00 00 02
 02 00 00 00 00 00 00 00 00 00 02 02 00 00 00 00 00 00 00 00 00 02 00 00 00 00 00 00 00 00 00 00 02
 02 00 00 00 00 00 00 00 00 00 02 02 00 00 00 00 00 00 00 00 00 02 00 00 00 00 00 00 00 00 00 00 02
 02 00 00 00 00 00 00 00 00 00 02 02 00 00 00 00 00 00 00 00 00 02 00 00 00 00 00 00 00 00 00 00 02
 02 00 00 00 00 00 00 00 00 00 02 02 00 00 00 00 00 00 00 00 00 02 00 00 00 00 00 00 00 00 00 00 02
 02 02 02 02 02 02 02 02 02 02 02 02 02 02 02 02 02 02 02 02 02 02 00 00 00 00 00 00 00 00 00 00 02
 02 02 02 02 02 02 02 02 02 02 02 02 02 02 02 02 02 02 02 02 02 02 00 00 00 00 00 00 00 00 00 00 02
 02 00 00 00 00 00 00 00 00 00 02 02 00 00 00 00 00 00 00 00 00 02 00 00 00 00 00 00 00 00 00 00 02
 02 00 00 00 00 00 00 00 00 00 02 02 00 00 00 00 00 00 00 00 00 02 00 00 00 00 00 00 00 00 00 00 02
 02 00 00 00 00 00 00 00 00 00 02 02 00 00 00 00 00 00 00 00 00 02 00 00 00 00 00 00 00 00 00 00 02
 02 00 00 00 00 00 00 00 00 00 02 02 00 00 00 00 00 00 00 00 00 02 00 00 00 00 00 00 00 00 00 00 02
 02 00 00 00 00 00 00 00 00 00 02 02 00 00 00 00 00 00 00 00 00 02 00 00 00 00 00 00 00 00 00 00 02
 02 00 00 00 00 00 00 00 00 00 02 02 00 00 00 00 00 00 00 00 00 02 00 00 00 00 00 00 00 00 00 00 02
 02 02 02 02 02 02 02 02 02 02 02 02 02 02 02 02 02 02 02 02 02 02 00 00 00 00 00 00 00 00 00 00 02
 02 00 00 00 00 00 00 00 00 00 00 00 00 00 00 00 00 00 00 00 00 00 00 00 00 00 00 00 00 00 00 00 02
 02 00 00 00 00 00 00 00 00 00 00 00 00 00 00 00 00 00 00 00 00 00 00 00 00 00 00 00 00 00 00 00 02
 02 00 00 50 49 00 00 00 00 00 00 00 00 00 46 76 47 00 00 00 00 00 00 18 19 00 00 00 00 00 00 00 02
 02 00 00 52 51 00 00 00 00 00 00 00 00 00 00 53 00 00 00 00 00 00 00 21 22 20 00 00 00 15 00 00 02
 02 00 00 00 00 00 00 00 00 00 00 00 00 00 00 00 00 00 00 00 00 00 00 00 00 24 00 00 00 00 00 00 02
 02 00 00 00 00 00 00 00 00 00 00 00 00 00 00 00 00 00 00 00 00 00 00 25 26 00 00 00 00 00 00 00 02
 02 00 00 54 59 00 00 00 00 00 00 00 00 00 00 73 70 00 00 00 00 00 00 00 00 27 00 00 00 00 00 00 02
 02 00 00 55 00 00 00 00 00 00 00 00 00 00 00 75 71 00 00 00 00 00 00 60 00 00 00 00 00 00 00 00 02
 02 00 00 56 00 00 00 00 00 00 00 00 00 00 00 72 74 00 00 00 00 00 00 00 00 00 00 00 00 00 00 00 02
 02 00 00 57 58 00 00 00 00 00 00 00 00 00 00 00 00 00 00 00 00 00 00 00 00 00 00 00 00 00 00 00 02
 02 00 00 00 00 00 00 00 00 00 00 00 00 00 00 00 00 00 00 00 00 00 00 00 00 00 00 00 00 00 00 00 02
 02 00 00 00 00 00 00 00 00 00 00 00 63 00 00 00 00 00 63 00 00 00 00 00 00 00 00 00 00 00 00 00 02
 02 00 00 02 00 00 00 00 00 00 00 00 00 00 00 00 01 00 00 00 00 00 00 00 00 00 00 00 00 00 00 00 02
 02 00 00 00 05 00 00 00 00 00 00 00 00 00 00 10 00 00 00 00 00 00 00 00 00 00 00 00 00 00 00 00 02
 02 00 00 03 00 00 00 00 00 00 00 00 00 00 00 00 16 00 00 00 00 00 00 00 00 00 00 00 00 00 00 00 02
 02 00 00 00 00 00 00 00 00 00 00 00 00 00 00 00 00 00 00 00 00 00 00 00 00 00 00 00 00 00 00 00 02
 02 02 02 02 02 02 02 02 02 02 02 02 02 02 02 02 02 02 02 02 02 02 02 02 02 02 02 02 02 02 02 02 02
