Gauntlet II
Maze number: 111
Offset for maze 110: 234896 - 0x039590
big endian buf: [%!l(uint8=0) %!l(uint8=3) %!l(uint8=149) %!l(uint8=144)]
G:2 Maze real addr: 259472 - 0x03F590, bank 3, boff: 0x6000
Maze read from: 0x03f590 - 259472
compresssed: 389
 06 00 00 80 20 61 95 41 AE 85 90 C3 2F 05 2E 70
 2F C1 2E A0 71 50 2E 05 70 01 C0 2F 05 2E 10 A0
 72 A2 C3 72 A0 E2 C2 04 A0 C2 51 A0 C2 05 2E 52
 35 B2 A1 01 C0 05 60 2F A0 C1 2E 05 62 61 05 60
 A0 C0 61 01 C0 50 63 A2 04 C6 2E A0 01 E1 04 64
 A0 64 A0 61 01 C6 53 2E 55 A0 C4 2E A0 C5 2E B2
 E1 64 52 B3 C1 04 A3 05 80 C0 05 A2 05 81 60 01
 53 A1 C3 51 05 63 2E 05 64 01 A0 C1 55 01 C1 2E
 05 60 55 A0 E6 C1 04 05 A3 C0 35 A1 41 C1 A3 41
 C6 51 53 2E 05 80 C0 2E 57 50 01 C4 2E 35 05 60
 05 63 01 C2 58 A3 C1 B2 A2 05 80 C0 A1 C1 A1 CA
 2E A0 C8 05 6D 01 E4 43 C3 54 01 C5 B2 44 41 65
 01 E0 CB 04 61 0F 46 C0 0F E3 41 C0 0F C3 B3 E1
 40 42 D3 01 C0 51 A0 42 46 45 63 01 C2 51 01 C7
 B2 67 04 A1 E6 C5 A1 64 52 2E 05 61 2E 54 2E A0
 C4 05 60 52 01 E1 05 80 A1 C4 A4 52 01 C0 2E 52
 01 60 64 2E 51 60 01 46 60 2E 55 62 2E A0 40 05
 01 60 66 2E 35 C1 55 01 35 C1 05 80 C5 35 01 46
 05 81 C7 50 50 64 05 80 C3 60 01 2E 50 01 C2 2E
 B2 CB 04 C2 05 2E A3 C4 A2 50 01 C0 B3 42 E4 E2
 C2 64 05 2E 80 53 51 2E 04 C1 B3 60 A0 E2 C2 2E
 B4 62 A0 E1 40 C2 A2 C3 05 80 40 41 C1 A1 04 52
 A0 10 05 70 A0 C4 10 52 A0 C6 53 50 2E 05 80 2F
 C0 2E A0 63 2F 05 70 2E A0 60 10 B2 10 01 2F 51
 10 2F 05 10 00
  Encoded length: 389 bytes
  Wall pattern: 01, Wall color: 05     Floor pattern: 06, Floor color: 09
  Flags: EXIT_CHOOSE_ONE WRAP_H 
  Random food adds: 0
  Secret trick:  6 - Watch What You Shoot (shoot secret walls)
 02 02 02 02 02 02 02 02 02 02 02 02 02 02 02 02 02 02 02 02 02 02 02 02 02 02 02 02 02 02 02 02
 00 00 00 00 47 05 46 16 02 47 00 00 46 02 16 00 00 05 00 46 05 16 00 01 00 47 05 46 16 02 16 00
 00 00 02 02 02 00 00 00 02 16 00 00 00 02 00 00 00 02 00 00 00 04 02 00 00 00 05 00 00 02 00 00
 00 05 46 05 00 00 00 53 02 02 02 01 00 05 46 00 47 02 00 00 46 05 46 00 00 00 46 00 00 05 46 00
 02 00 46 02 00 01 00 05 00 46 00 00 00 00 02 02 02 04 00 00 00 02 00 00 00 46 02 01 00 00 02 04
 46 00 00 02 00 00 02 46 00 00 00 00 00 02 46 00 00 01 00 00 00 02 00 00 00 05 00 00 00 00 46 05
 00 00 00 02 00 00 02 00 00 00 00 00 46 02 00 00 00 00 00 00 46 02 00 00 02 46 00 00 00 00 00 05
 00 00 00 02 00 00 04 02 02 02 02 05 05 00 05 02 02 02 05 05 05 46 00 01 05 00 00 00 00 02 02 00
 00 00 00 05 00 00 05 46 00 00 00 00 46 05 46 00 00 00 00 00 01 02 00 00 05 00 00 00 00 00 00 01
 00 00 46 05 46 00 05 00 00 00 00 00 00 02 00 00 00 00 00 00 00 02 00 00 04 05 02 02 02 02 00 53
 02 02 00 00 01 00 00 02 02 02 02 00 00 01 00 00 00 00 02 00 00 05 00 00 05 00 00 00 00 46 05 05
 00 46 05 00 00 00 00 00 00 00 00 05 00 01 00 00 00 00 02 46 53 05 46 00 05 46 00 00 00 00 01 00
 00 00 05 00 00 00 00 00 00 00 00 00 02 02 02 02 00 00 02 02 02 02 05 05 00 02 02 00 00 02 02 00
 00 00 02 00 00 00 00 00 00 00 46 02 00 00 00 00 00 00 00 00 00 05 46 00 00 00 00 00 00 00 00 02
 00 00 02 00 00 01 00 00 00 00 00 02 00 00 00 00 01 00 00 00 00 05 00 00 00 00 00 01 00 00 00 02
 00 00 02 00 00 00 00 00 01 00 00 01 46 00 00 00 00 00 00 01 00 02 00 00 00 00 00 00 00 00 00 02
 00 00 04 46 00 00 15 00 00 00 00 00 00 00 01 00 15 00 00 00 00 02 00 00 01 00 15 00 00 00 00 02
 00 00 02 00 01 00 00 00 01 00 00 02 00 00 00 00 00 00 00 00 00 00 00 00 00 00 00 00 00 01 00 05
 00 00 02 00 00 00 01 00 00 00 00 02 00 00 01 00 00 00 00 00 00 01 46 00 00 00 00 01 00 00 00 05
 00 00 01 00 00 00 00 00 00 00 00 02 46 00 00 00 00 00 00 00 00 04 02 02 00 00 00 00 00 00 00 02
 00 00 00 00 00 00 02 02 46 00 00 00 00 00 05 00 00 00 46 05 46 00 00 46 05 00 00 00 00 00 46 02
 00 00 00 00 00 05 46 00 05 00 00 00 01 00 00 02 05 05 02 02 00 00 00 00 00 02 02 02 02 02 05 00
 00 00 01 00 46 05 00 00 00 01 46 00 46 00 00 00 00 00 46 05 00 00 46 00 01 00 00 00 00 00 00 00
 01 46 00 46 05 00 00 00 00 00 00 46 00 00 00 46 02 00 01 05 01 46 00 46 00 00 00 00 00 00 00 46
 53 00 00 05 00 00 02 00 00 02 01 53 00 00 05 05 00 00 00 00 00 00 53 01 00 00 00 00 02 00 00 01
 05 05 05 00 00 00 02 00 00 02 00 05 00 05 00 46 02 00 00 00 00 05 05 00 00 00 00 46 02 01 46 05
 00 01 00 00 00 46 02 00 00 02 00 00 00 00 00 00 02 00 00 04 00 00 00 05 46 02 02 02 02 00 00 00
 00 00 02 02 02 05 00 01 00 02 00 00 00 01 00 00 02 00 00 02 00 00 00 02 00 00 00 46 02 00 00 00
 00 05 46 46 05 00 00 00 00 05 00 00 46 04 00 00 02 46 00 02 00 00 00 02 00 00 00 46 02 46 00 00
 00 02 00 00 02 00 01 00 00 00 02 02 02 00 00 00 00 05 05 00 01 02 00 01 00 00 02 02 04 05 00 00
 00 02 16 05 16 00 02 00 00 00 00 00 16 05 00 00 00 02 00 00 00 02 00 00 00 05 00 00 00 00 05 00
 46 05 05 47 00 46 02 46 00 00 00 00 47 05 16 00 46 02 46 00 16 02 16 01 47 05 00 00 16 47 05 16
 02 02 02 02 02 02 02 02 02 02 02 02 02 02 02 02 02 02 02 02 02 02 02 02 02 02 02 02 02 02 02 02
