Gauntlet II
Maze number: 8
Offset for maze 7: 230961 - 0x038631
big endian buf: [%!l(uint8=0) %!l(uint8=3) %!l(uint8=134) %!l(uint8=49)]
G:2 Maze real addr: 230961 - 0x038631, bank 0, boff: 0x0000
Maze read from: 0x038631 - 230961
compresssed: 378
 0D 00 00 84 04 20 38 0D 9D 0E 09 32 80 18 C1 1D
 A0 60 10 35 C0 1D 81 2F 10 2E 1D 07 10 C0 35 2E
 C0 25 C0 2E 1D 19 10 33 C0 10 C9 0C C5 07 D9 0C
 C2 0A 07 0A D0 52 C4 2E C5 07 CA 1D 81 C2 2E A0
 C2 0B C1 74 1C C2 1C 07 21 C3 1C 81 C2 2E C0 07
 80 42 07 08 84 04 A0 41 09 83 41 08 80 55 45 10
 C2 0A 07 63 0B A0 1D 35 C0 0C 1D 81 C0 0C 80 C0
 22 08 1C C1 10 1C C0 25 C3 07 E5 C3 0A 72 C5 08
 C5 2E C3 0E D1 35 08 C3 2E C0 35 CA 51 C4 51 C4
 0B 08 0A C2 35 C6 0B D1 08 C5 62 60 0B 80 C2 1D
 81 C2 65 1D 08 0B C2 1C A1 41 09 83 42 A0 B2 07
 83 B2 A6 07 83 C0 1C C3 74 1C C3 1C C2 0A C1 08
 CA 66 35 CA 08 CA 0A BF 2E CD 0F C0 0B 08 C5 53
 C3 2F C5 52 35 C4 53 C4 08 CC 10 C0 0A C0 1C A0
 1C C3 1C A0 C1 0C C1 08 19 83 35 C0 20 0C 80 0B
 60 07 83 04 A0 43 A1 09 83 A2 43 72 09 80 08 81
 C0 63 08 1C C3 1C 81 C2 1C A0 C4 20 07 0A C2 65
 08 D2 07 C5 2F C2 0B 08 D2 07 C3 2E C4 0C C5 35
 CC 07 C5 10 C2 1C 71 CB 53 C5 07 C5 45 1C C3 1C
 55 C1 20 35 E0 63 1D 07 62 10 C0 1C C4 08 84 A0
 44 A1 42 A1 44 A0 C4 1D 81 C4 07 62 0A C0 63 60
 19 C2 6B 0A 07 DE 07 DE 07 CB 53 C3 18 BE 10 33
 19 80 2E 55 10 C0 2E C1 1D 07 10 35 2E C0 1D 75
 0A 2F C1 20 10 A0 61 10 32 00
  Encoded length: 378 bytes
  Wall pattern: 00, Wall color: 08     Floor pattern: 02, Floor color: 03
  Flags: TRAPS_LOCAL EXIT_CHOOSE_ONE 
  Random food adds: 4
  Secret trick: 13 - Don't Be Greedy (no treasure)
 02 02 02 02 02 02 02 02 02 02 02 02 02 02 02 02 02 02 02 02 02 02 02 02 02 02 02 02 02 02 02 02
 02 50 24 00 00 29 02 29 00 16 53 00 29 09 29 47 16 46 29 07 16 00 53 46 00 37 14 46 29 25 16 51
 02 16 00 00 00 00 14 00 00 00 00 00 12 09 00 00 00 00 00 07 00 00 00 00 00 00 14 00 00 00 00 00
 02 00 00 00 00 00 14 00 00 00 00 00 00 09 12 00 00 00 10 07 10 00 00 00 00 00 14 00 00 00 00 00
 02 00 00 00 00 00 14 00 00 00 00 00 46 09 00 00 00 00 00 07 00 00 00 00 00 00 14 00 00 00 00 29
 02 29 00 00 00 46 02 00 00 00 11 00 00 09 28 00 00 00 28 07 33 00 00 00 00 28 14 28 00 00 00 46
 02 07 07 13 13 13 07 08 08 08 08 08 08 04 02 13 13 09 09 09 09 09 13 13 08 08 14 13 13 13 13 13
 02 16 00 00 00 10 07 29 00 00 00 00 11 02 29 53 00 12 29 09 29 00 12 12 00 34 08 28 00 00 16 28
 02 37 00 00 00 00 07 00 00 00 00 00 00 02 00 00 00 00 10 09 00 00 00 00 00 00 08 00 00 00 00 00
 02 46 00 00 00 00 14 00 00 00 00 00 00 14 00 00 00 00 00 14 00 00 00 00 00 53 08 00 00 00 00 46
 02 53 00 00 00 00 09 00 00 00 00 00 00 14 00 00 00 00 00 14 00 00 00 00 00 11 08 10 00 00 00 53
 02 00 00 00 00 00 09 11 00 00 00 00 00 02 00 00 00 00 00 02 00 00 00 00 00 00 08 00 00 00 00 00
 02 29 00 00 00 29 09 11 11 00 00 00 29 02 29 00 00 00 29 02 00 00 00 00 00 29 08 11 00 00 00 28
 02 02 13 13 09 09 09 09 09 13 13 13 02 02 07 07 07 07 07 02 02 02 02 02 02 02 14 07 07 07 07 07
 02 28 00 00 00 00 09 28 00 00 00 00 28 14 00 00 10 00 00 08 00 00 00 00 00 00 14 00 00 00 00 29
 02 00 00 00 00 00 14 53 00 00 00 00 00 14 00 00 00 00 00 08 00 00 00 00 00 00 14 00 00 00 00 10
 02 46 00 00 00 00 14 00 00 00 00 00 00 14 00 00 15 00 11 08 00 00 00 00 00 00 14 00 00 00 00 47
 02 00 00 00 00 00 14 53 00 00 00 00 00 14 00 00 00 00 00 08 00 00 00 00 00 00 09 00 00 00 00 00
 02 16 00 10 00 28 02 28 00 00 00 00 28 02 00 00 12 00 00 08 25 25 25 25 25 53 09 32 12 12 11 29
 02 07 07 07 07 07 04 02 13 13 13 13 02 02 09 09 09 09 09 02 02 02 13 13 13 13 09 09 09 08 08 08
 02 29 00 00 00 00 08 28 00 00 00 00 28 14 28 00 00 00 28 02 00 00 00 00 00 32 07 10 00 00 00 29
 02 00 00 00 00 00 08 00 00 00 00 00 00 14 00 00 00 00 00 14 00 00 00 00 00 00 07 00 00 00 00 00
 02 47 00 00 00 11 08 00 00 00 00 00 00 14 00 00 00 00 00 14 00 00 00 00 00 00 07 00 00 00 00 46
 02 00 00 00 00 12 09 00 00 00 00 00 53 14 00 00 00 00 00 14 00 00 00 00 00 00 07 00 00 00 00 00
 02 16 00 00 00 28 09 00 00 00 00 00 00 14 00 00 00 00 00 14 00 00 00 00 00 00 07 00 00 00 00 00
 02 13 13 13 13 13 13 28 00 00 00 00 28 14 00 00 32 53 00 02 29 00 00 00 00 29 07 29 00 00 00 16
 02 28 00 00 00 00 14 08 08 08 08 08 08 02 13 13 13 13 13 09 02 13 13 13 02 02 13 13 13 13 13 02
 02 00 00 00 00 29 14 29 00 00 00 00 00 07 29 00 00 00 10 09 29 00 00 00 00 29 14 25 00 00 00 29
 02 00 00 00 00 00 14 00 00 00 00 00 10 07 00 00 00 00 00 09 00 00 00 00 00 00 14 00 00 00 00 00
 02 00 00 00 00 00 14 00 00 00 00 00 00 07 00 00 00 00 00 09 00 00 00 00 00 00 14 00 00 00 00 00
 02 00 00 00 00 00 14 00 00 00 00 00 00 07 00 00 00 00 00 09 00 00 00 00 00 00 14 00 00 00 00 24
 02 16 51 25 25 46 14 16 00 46 00 00 29 07 16 53 46 00 29 09 10 47 00 00 32 16 02 29 00 00 16 50
 02 02 02 02 02 02 02 02 02 02 02 02 02 02 02 02 02 02 02 02 02 02 02 02 02 02 02 02 02 02 02 02
