Gauntlet II
Maze number: 17
Offset for maze 16: 233144 - 0x038eb8
big endian buf: [%!l(uint8=0) %!l(uint8=3) %!l(uint8=142) %!l(uint8=184)]
G:2 Maze real addr: 233144 - 0x038EB8, bank 0, boff: 0x0000
Maze read from: 0x038eb8 - 233144
compresssed: 345
 02 00 00 42 25 51 74 45 A0 7E DE C3 63 19 2E C0
 15 84 C9 1C 4E 83 50 C8 1C C5 67 05 83 B2 A7 C5
 1A B2 62 19 D0 3E A0 E5 05 A3 31 52 4D A5 C2 19
 1A B4 A3 05 C3 0F D9 20 B6 A9 C9 1A A0 2E 19 CE
 1A 31 70 C8 A7 2F A0 69 B2 AA 1D 70 70 15 A1 3E
 A2 E8 35 05 1C A0 1D A0 1D A0 2E 40 40 40 1E E1
 C2 A2 05 A1 19 80 E1 40 40 E0 40 A0 40 E0 40 E8
 1D C0 A1 40 40 E0 40 40 C0 2F A0 40 E0 C0 B4 A0
 C7 1D E2 E0 40 E0 E0 E0 05 E0 40 15 08 C1 A2 E9
 E0 2E A0 E0 E0 41 E0 15 A0 C0 1E A0 18 81 A5 E2
 E0 E0 1E A0 40 E0 05 40 E0 C0 0B C0 2E 07 81 C4
 1D A0 1D A0 40 40 E0 40 40 C0 1E 70 A0 C0 1E 3E
 C8 B2 A0 40 40 E0 1E 05 E0 E0 1E A0 05 40 40 A2
 E9 E0 C0 A2 40 40 E0 E1 40 50 EC E0 C1 1E A0 E0
 E0 C0 A1 E0 C7 A5 E8 E0 E0 15 C3 B2 C5 33 E4 CD
 A3 C2 B6 C9 A2 C0 A9 C4 22 A0 ED EE 62 B3 0A 80
 A2 CF A4 C0 A1 3E A0 2E C3 2E A2 C4 20 A6 6B A2
 C1 0A A5 2E 19 C3 07 C2 A2 C2 2E E1 C3 60 08 C1
 19 33 C6 07 0C A1 51 A0 07 81 50 C3 61 08 C2 10
 B2 10 19 C3 07 A0 E4 18 81 B3 C0 AB C0 A6 C6 A2
 E0 C5 0B 07 C2 10 A0 10 C3 09 0A C2 61 A0 50 C3
 64 07 19 E2 C3 19 09 C0 00
  Encoded length: 345 bytes
  Wall pattern: 01, Wall color: 04     Floor pattern: 05, Floor color: 07
  Flags: WRAP_H TRAPS_LOCAL EXIT_MOVES SHOTS_STUN 
  Random food adds: 2
  Secret trick:  2 - Try Transportability (onto death)
 02 02 02 02 02 02 02 02 02 02 02 02 02 02 02 02 02 02 02 02 02 02 02 02 02 02 02 02 02 02 02 02
 00 00 00 00 32 00 00 00 00 25 46 02 21 21 21 21 21 02 00 00 00 00 00 00 00 00 00 00 28 00 00 00
 00 02 00 00 00 02 00 00 00 00 00 02 05 05 05 05 05 02 62 00 00 00 00 00 00 00 00 00 28 00 00 00
 00 02 00 32 00 02 00 00 00 00 00 02 05 05 05 05 05 02 02 02 02 02 02 02 02 02 00 00 00 00 00 00
 26 02 32 00 00 02 25 00 00 00 00 02 00 00 00 00 00 00 00 00 00 00 00 00 62 02 00 00 00 00 00 00
 02 05 02 02 02 02 49 00 00 00 62 02 00 00 00 00 00 00 00 00 00 00 00 00 00 05 02 02 02 02 02 02
 00 00 00 25 26 02 02 02 02 02 05 02 00 00 00 15 00 00 00 00 00 00 00 00 00 00 00 00 00 00 00 00
 00 00 00 00 00 00 00 00 00 00 32 02 02 02 02 02 02 02 02 02 02 02 00 00 00 00 00 00 00 00 00 00
 26 02 46 25 00 00 00 00 00 00 00 00 00 00 00 00 00 00 00 26 49 02 30 00 00 00 00 00 00 00 00 00
 02 02 02 02 02 02 02 02 47 02 32 00 00 00 00 00 00 00 00 00 00 02 02 02 02 02 02 02 02 02 02 02
 02 29 02 30 02 30 21 02 02 62 02 02 02 00 00 00 00 00 00 00 00 00 02 53 05 28 02 29 02 29 02 46
 00 05 00 05 00 05 30 02 00 02 00 00 00 02 02 02 05 02 02 25 25 00 00 02 00 05 00 05 00 02 00 05
 02 00 05 00 02 00 05 02 00 00 00 00 00 00 00 00 02 29 00 02 02 00 05 00 05 00 02 00 05 00 05 00
 47 02 00 05 00 02 00 02 02 00 00 00 00 00 00 00 00 29 00 00 00 02 00 02 00 05 00 02 00 02 00 02
 05 00 02 00 05 21 08 00 00 02 02 02 00 00 00 00 00 00 00 00 00 00 02 00 02 46 02 00 02 00 02 00
 00 05 00 02 21 02 00 30 02 24 24 24 02 02 02 02 02 02 00 00 00 02 00 02 00 02 30 02 00 05 00 02
 05 00 05 00 02 00 11 02 46 07 07 07 00 00 00 00 02 29 02 29 02 00 05 00 05 00 02 00 05 00 05 00
 30 02 30 02 00 30 62 02 00 00 00 00 00 00 00 00 02 02 00 05 00 05 00 02 30 05 00 02 00 02 30 02
 05 00 05 00 05 02 02 02 00 00 00 00 00 00 00 00 00 00 02 00 02 00 02 02 02 00 05 00 05 00 02 00
 00 02 00 05 02 62 00 02 00 00 00 00 00 00 00 00 00 00 00 02 00 02 00 00 30 02 00 02 00 02 00 02
 02 00 02 00 02 00 00 02 00 00 00 02 02 02 02 02 02 00 00 00 00 00 00 00 00 00 02 00 02 00 02 21
 00 00 00 00 02 00 00 02 00 00 02 51 00 00 00 00 00 02 00 00 00 00 00 00 00 00 00 00 00 00 00 00
 02 02 02 02 00 00 00 02 00 00 02 00 00 00 00 00 00 00 02 02 02 00 02 02 02 02 02 02 02 02 02 02
 00 00 00 00 00 34 02 00 00 00 02 00 00 00 00 00 00 00 00 00 00 02 00 00 00 00 00 00 00 00 00 00
 00 00 00 00 00 02 32 00 00 00 02 10 10 02 02 02 00 00 00 00 00 00 00 00 00 00 00 00 00 00 00 00
 02 02 02 02 02 00 02 02 62 02 46 00 00 00 00 46 02 02 02 00 00 00 00 00 32 02 02 02 02 02 02 02
 32 00 00 00 00 00 00 00 00 00 02 00 00 02 02 02 00 00 10 02 02 02 02 02 02 46 25 00 00 00 00 07
 00 00 00 02 02 02 00 00 00 46 02 00 02 00 00 00 00 32 00 08 00 00 25 51 02 00 00 00 00 00 00 07
 12 02 02 00 00 62 02 07 07 07 02 62 00 00 00 00 32 00 00 08 00 00 00 16 02 16 25 00 00 00 00 07
 02 00 00 00 00 00 02 24 24 24 02 00 02 02 02 02 02 02 02 02 02 02 02 02 00 02 02 02 02 02 02 02
 00 00 00 00 00 00 00 02 02 02 00 02 00 00 00 00 00 00 11 07 00 00 00 16 02 16 00 00 00 00 09 10
 00 00 00 32 00 00 02 00 62 00 00 00 00 32 00 00 00 00 00 07 25 00 00 00 02 00 00 00 00 25 09 00
 02 02 02 02 02 02 02 02 02 02 02 02 02 02 02 02 02 02 02 02 02 02 02 02 02 02 02 02 02 02 02 02
