Gauntlet II
Maze number: 15
Offset for maze 14: 232608 - 0x038ca0
big endian buf: [%!l(uint8=0) %!l(uint8=3) %!l(uint8=140) %!l(uint8=160)]
G:2 Maze real addr: 232608 - 0x038CA0, bank 0, boff: 0x0000
Maze read from: 0x038ca0 - 232608
compresssed: 207
 08 22 02 0A 00 60 D8 5D 6E 7F 62 31 80 40 A0 3A
 C8 1F C0 1F 72 68 E4 E4 D4 1D E3 E4 77 E5 59 E4
 EC 72 E7 E4 75 E3 E7 E4 E4 C3 B5 E3 74 E3 54 41
 A0 E0 E6 E5 E4 E6 31 E1 E4 E5 31 A1 E3 E4 E4 E2
 E5 52 54 E2 2E 64 A0 E0 E5 E4 E4 50 2E EE 44 E0
 E4 EC 7C C0 24 A0 C4 01 C3 23 60 A0 3B CC A2 31
 C3 01 C2 A2 B3 A5 19 84 E2 C0 23 33 A0 D6 BF E2
 23 E2 D9 3F 54 2E E4 46 69 A0 E4 E3 1C A0 E1 EF
 E4 23 E2 E3 43 EA E4 E8 EF 63 E9 43 C5 1C E3 C3
 B4 E2 C1 3A E2 EF E7 E5 6E A0 E7 E5 C2 1E C6 1C
 E3 E7 E5 EF 42 E3 E5 EF E7 E5 35 49 E3 42 E3 C5
 04 EF E7 64 C0 1A 81 EC C2 1E E3 C4 BE A0 21 A0
 10 A0 21 A0 2E 43 62 A0 C6 2F A0 2E C1 0F 00
  Encoded length: 207 bytes
  Wall pattern: 00, Wall color: 08     Floor pattern: 06, Floor color: 13
  Flags: ODDANGLE_GRUNTS WALLS_CYCLIC FAST_GRUNTS ODDANGLE_GRUNTS 
  Random food adds: 2
  Secret trick:  8 - Don't Use Invulnerability
 02 02 02 02 02 02 02 02 02 02 02 02 02 02 02 02 02 02 02 02 02 02 02 02 02 02 02 02 02 02 02 02 02
 02 49 00 29 02 58 00 00 00 00 00 00 00 00 00 31 00 31 00 00 02 34 00 00 00 00 00 00 00 00 00 46 02
 02 00 00 00 00 02 00 00 00 00 00 02 00 00 00 00 00 00 00 00 02 00 00 00 00 00 00 00 00 00 00 00 02
 02 29 00 00 00 00 02 00 00 00 00 00 02 00 00 00 00 00 00 00 02 34 00 00 00 00 00 00 02 00 00 00 02
 02 00 00 00 00 00 00 63 00 00 00 00 00 02 00 00 00 00 00 00 02 00 00 00 00 00 00 02 00 00 00 34 02
 02 00 00 00 00 00 00 00 02 00 00 00 00 00 02 00 00 00 00 00 02 34 00 00 00 00 02 00 00 00 00 00 02
 02 00 00 02 00 00 00 00 00 02 00 00 00 00 00 02 00 00 00 00 02 00 00 00 00 02 00 00 00 00 00 34 02
 02 00 00 00 02 00 00 00 00 00 63 00 00 29 02 00 02 00 00 00 00 00 00 00 02 00 00 00 00 00 00 02 02
 02 00 00 00 00 02 00 00 00 00 00 00 00 02 49 00 00 02 00 00 00 00 00 02 00 00 00 00 00 00 02 49 02
 02 02 00 00 00 00 02 00 00 00 00 00 02 00 00 00 00 00 02 00 00 00 02 00 00 00 00 00 00 02 00 00 02
 02 63 00 00 00 00 00 63 00 00 00 02 46 00 00 00 00 00 46 02 00 02 00 00 00 00 00 00 02 00 00 00 02
 02 00 02 00 00 00 00 00 02 00 63 46 00 00 00 00 00 00 00 00 02 00 00 00 00 00 00 02 00 00 00 00 02
 02 29 00 02 00 00 00 00 00 02 00 00 00 00 00 00 00 00 00 00 02 00 00 02 00 00 00 00 00 00 00 00 02
 02 00 00 00 00 34 00 36 02 00 00 00 00 00 01 00 00 00 00 35 02 46 02 59 00 00 00 00 00 00 00 00 02
 02 00 00 00 00 02 02 02 49 00 00 00 00 01 00 00 00 02 02 02 02 02 02 02 02 02 02 25 25 25 25 25 02
 02 00 00 00 02 00 35 51 02 00 00 00 00 00 00 00 00 00 00 00 00 00 00 00 00 00 00 00 00 00 00 00 02
 02 00 00 00 02 35 00 00 00 02 00 00 00 00 00 00 00 00 00 00 00 00 00 00 00 00 00 00 00 00 00 00 02
 02 00 00 00 63 00 00 00 00 00 63 46 00 00 00 00 00 02 00 00 00 00 00 00 00 29 00 00 00 00 00 00 02
 02 00 00 00 46 02 00 00 00 00 00 02 00 00 02 00 02 28 02 00 00 02 00 00 00 00 00 00 00 00 00 00 02
 02 00 00 00 00 00 02 00 00 00 00 00 02 35 02 00 00 02 00 00 00 00 02 00 00 00 00 29 00 00 00 00 02
 02 00 00 00 00 00 00 02 00 00 00 00 00 02 02 00 00 00 00 00 00 00 00 02 00 00 00 00 00 00 00 00 02
 02 00 00 00 00 00 00 00 02 00 00 00 00 46 02 00 00 00 00 00 00 00 00 00 02 00 00 00 00 29 00 00 02
 02 00 00 00 28 00 00 00 00 02 00 00 00 00 02 00 00 00 02 00 00 58 00 00 00 02 00 00 00 00 00 00 02
 02 00 00 00 00 00 00 00 00 00 02 00 00 00 00 00 00 00 00 02 00 00 00 00 00 00 02 00 00 00 00 00 02
 02 00 00 00 00 00 00 00 00 00 46 02 00 00 00 00 00 00 00 00 02 00 00 00 00 00 00 02 00 00 00 30 02
 02 00 00 00 00 00 00 28 00 00 00 00 02 00 00 00 00 00 00 00 00 02 00 00 00 00 00 00 02 00 00 00 02
 02 00 00 00 00 00 00 00 00 00 00 00 00 02 00 00 00 29 00 00 00 00 02 00 00 00 00 00 00 02 00 00 02
 02 00 00 00 00 00 00 00 00 00 00 00 00 00 02 00 00 00 00 00 00 00 00 02 00 00 00 00 00 00 02 53 02
 02 00 00 00 00 00 00 00 00 00 29 00 00 00 00 02 00 00 00 29 00 00 00 00 02 00 00 00 00 00 00 04 02
 02 00 00 00 00 00 00 00 00 00 00 00 00 00 00 00 02 00 00 00 00 00 00 00 00 02 00 00 00 00 00 46 02
 02 26 26 26 00 00 00 00 00 00 00 00 00 00 00 00 00 02 00 00 00 30 00 00 00 00 02 00 00 00 00 00 02
 02 02 33 02 16 02 33 02 46 00 00 00 00 29 00 00 00 46 02 00 00 00 00 00 00 00 47 02 46 00 00 15 02
 02 02 02 02 02 02 02 02 02 02 02 02 02 02 02 02 02 02 02 02 02 02 02 02 02 02 02 02 02 02 02 02 02
