Gauntlet II
Maze number: 93
Offset for maze 92: 230304 - 0x0383a0
big endian buf: [%!l(uint8=0) %!l(uint8=3) %!l(uint8=131) %!l(uint8=160)]
G:2 Maze real addr: 254880 - 0x03E3A0, bank 3, boff: 0x6000
Maze read from: 0x03e3a0 - 254880
compresssed: 279
 0C 20 60 A0 02 31 19 0D 6E 0E 47 2E 80 DF C0 08
 C5 45 35 45 60 80 2F 2E 81 2F 2E C0 1C E0 CB 35
 F1 E1 09 C2 1E C1 33 52 35 51 C1 1E 60 CE 1C C2
 A5 40 A6 7A C3 35 60 CA 35 CD A4 CD 1F C0 1F C0
 1F C0 1F C1 1C 7A C4 08 CC 2F C4 1D D8 A3 C5 1D
 C8 1D C1 A5 42 10 C0 1E 65 60 66 60 69 65 A3 B3
 A0 42 A0 B3 A3 C2 2C C4 A2 C0 A4 2E 6A C5 B3 C2
 10 C1 35 C2 33 DA 35 C0 1E C5 09 74 CB BF 1D C1
 35 C7 09 74 CA 31 C3 35 C2 1E BF C0 1C C3 0F C3
 1C C0 BF C0 B4 A6 2F C0 54 C0 54 E2 C1 35 C6 35
 C4 2C C5 42 C0 43 A3 B2 A4 B2 A3 C8 35 C7 35 C0
 31 C5 1F 61 A6 C2 4A CA B3 2E 67 C7 21 B3 73 C2
 08 71 C2 21 C7 21 C2 35 76 CF 35 C5 43 C1 20 CD
 B4 49 1E CA B2 6D C0 18 C1 1E 67 D0 19 51 C2 43
 C3 B3 C5 20 C8 43 35 31 C0 1E C1 55 C1 20 C0 09
 C2 08 C6 09 A3 C2 43 C7 09 C7 B4 C6 21 C7 20 6D
 C3 20 C0 BE 10 C1 51 2E 80 5A 35 60 B2 35 60 C2
 2B C0 B2 2E C8 31 00
  Encoded length: 279 bytes
  Wall pattern: 01, Wall color: 09     Floor pattern: 03, Floor color: 01
  Flags: FAST_AUX_GRUNTS WALLS_DELETABLE2 EXIT_CHOOSE_ONE SHOTS_HURT FAST_DEATHS ODDANGLE_GRUNTS 
  Random food adds: 0
  Secret trick: 12 - Don't Be Greedy (no keys or potions)
 02 02 02 02 02 02 02 02 02 02 02 02 02 02 02 02 02 02 02 02 02 02 02 02 02 02 02 02 02 02 02 02 02
 02 46 00 00 00 00 00 00 00 00 00 00 00 00 00 00 00 00 00 00 00 00 00 00 00 00 00 00 00 00 00 00 02
 02 00 00 08 00 00 00 00 00 02 13 13 13 13 13 14 53 13 13 13 13 13 13 02 46 46 47 46 46 46 47 46 02
 02 28 00 02 00 00 00 00 00 02 00 00 00 00 00 14 53 14 00 00 00 00 00 02 00 00 00 00 00 00 00 00 02
 02 00 00 02 00 00 02 09 00 02 00 30 00 00 51 14 53 14 00 00 30 00 46 02 00 00 00 00 00 00 00 00 02
 02 00 00 00 00 00 28 00 00 02 02 02 02 02 02 02 13 02 02 02 02 02 02 02 00 00 00 00 00 00 00 00 02
 02 00 00 07 00 00 00 00 53 02 46 00 00 00 00 00 00 00 00 00 00 00 53 02 00 00 00 00 00 00 00 00 02
 02 00 00 00 00 02 02 02 02 02 00 00 00 00 00 00 00 00 00 00 00 00 00 02 31 00 31 00 31 00 31 00 02
 02 28 00 00 00 00 00 00 00 02 00 00 00 07 00 00 00 00 00 08 00 00 00 02 00 00 00 00 00 00 00 00 02
 02 47 00 00 00 00 00 29 00 02 00 00 00 02 00 00 00 00 00 02 00 00 00 02 00 00 00 00 00 00 00 00 02
 02 02 02 02 02 00 00 00 00 02 00 29 00 02 00 00 00 00 00 02 00 29 00 02 02 02 02 02 02 02 13 13 02
 02 16 00 30 00 00 00 00 00 02 46 00 46 02 00 00 00 00 00 02 46 00 46 02 00 00 00 00 00 02 00 00 02
 02 46 00 00 00 00 00 00 46 02 02 02 02 02 02 13 13 13 02 02 02 02 02 02 00 00 00 44 00 02 00 00 02
 02 02 02 02 00 02 02 02 02 02 46 00 00 00 00 00 00 00 00 00 00 00 46 02 00 02 00 00 00 02 00 00 02
 02 16 00 14 53 14 00 00 51 02 00 00 00 00 00 00 00 00 00 00 00 00 00 02 00 02 00 00 00 00 00 00 02
 02 00 00 14 53 14 30 00 00 02 00 00 00 09 00 00 00 00 00 07 00 00 00 02 00 02 00 00 00 00 00 00 02
 02 29 00 14 53 14 00 00 00 02 00 00 00 09 00 00 00 00 00 07 00 00 00 02 00 02 00 00 00 00 00 49 02
 02 00 00 14 53 14 00 00 30 02 00 28 00 02 00 00 15 00 00 02 00 28 00 02 00 02 02 02 02 02 02 02 02
 02 47 00 14 00 14 00 00 00 02 00 00 53 02 00 00 00 00 00 02 53 00 00 02 00 00 44 00 00 00 00 00 02
 02 13 13 13 00 13 13 13 13 02 02 02 02 02 02 02 02 02 02 02 02 02 02 02 00 00 00 00 00 00 00 00 02
 02 53 00 00 00 00 00 00 00 00 53 02 49 00 00 00 00 00 00 31 00 00 46 02 02 02 02 02 02 02 00 00 02
 02 13 13 13 13 13 13 14 13 13 13 02 00 00 00 00 00 00 00 00 00 00 00 02 46 00 00 00 00 02 00 00 02
 02 46 00 00 00 00 00 14 00 00 33 02 00 00 00 00 07 00 00 00 08 00 00 07 00 00 00 33 00 02 00 00 02
 02 00 00 00 33 00 00 14 53 00 00 14 00 00 00 00 07 00 00 00 02 00 00 00 00 00 00 00 00 02 00 00 02
 02 53 00 00 00 00 00 14 13 13 13 14 00 00 32 00 02 00 00 00 02 00 00 00 00 00 00 00 00 02 13 13 02
 02 13 13 13 13 13 13 14 30 00 00 14 00 00 00 00 02 00 00 00 02 00 00 00 00 02 00 00 00 00 00 00 02
 02 00 00 46 14 24 00 14 30 00 00 14 00 00 00 00 02 46 00 00 00 00 00 00 00 02 00 00 00 00 00 00 02
 02 00 00 25 14 00 00 14 13 13 13 14 00 00 00 00 02 00 00 00 00 00 00 32 00 02 00 00 00 00 00 00 02
 02 13 13 13 13 53 49 14 30 00 00 14 00 00 32 00 09 00 00 00 08 00 00 00 00 02 00 00 09 02 02 02 02
 02 00 00 00 13 13 13 14 00 00 00 02 00 00 00 00 09 00 00 00 02 00 00 00 00 02 00 00 00 00 00 00 02
 02 33 00 00 14 00 00 14 00 00 32 02 00 00 00 00 00 00 00 00 02 00 00 00 00 46 00 00 00 00 32 00 02
 02 16 00 00 14 46 46 14 53 00 46 02 53 00 46 00 00 00 43 00 02 46 00 00 00 00 00 00 00 00 00 49 02
 02 02 02 02 02 02 02 02 02 02 02 02 02 02 02 02 02 02 02 02 02 02 02 02 02 02 02 02 02 02 02 02 02
