Gauntlet II
Maze number: 75
Offset for maze 74: 232724 - 0x038d14
big endian buf: [%!l(uint8=0) %!l(uint8=3) %!l(uint8=141) %!l(uint8=20)]
G:2 Maze real addr: 249108 - 0x03CD14, bank 2, boff: 0x4000
Maze read from: 0x03cd14 - 249108
compresssed: 417
 07 00 00 40 30 31 9F 0D 45 48 41 C8 14 81 15 C6
 15 13 81 C7 0F C7 14 81 C8 13 81 D0 14 81 C2 1A
 3E 1A C2 13 81 C7 3E AE 05 AE 1D 01 CD 33 7D 6E
 15 05 D5 1C C6 31 C6 1C C6 A5 05 A8 05 A8 05 A4
 6C 70 3E 01 60 F7 62 E2 D1 1D E2 28 A0 3A A0 E0
 3A A0 28 05 C2 1D C5 3E A9 E2 C0 22 E0 C2 A9 08
 38 C1 18 19 18 19 18 C0 1F 05 60 60 E0 E0 60 1F
 C0 18 19 18 19 18 C1 38 C3 45 E1 C0 2E C0 03 C0
 2E E0 C2 45 CA B3 60 E0 E0 60 60 60 C0 B3 57 C2
 42 60 1C A0 C1 1C 03 C0 1C C0 03 C0 1F 60 1C 05
 44 C1 1D 08 C1 2E C0 35 C0 1C 03 60 60 E0 60 E0
 60 C5 23 51 1F C2 42 60 C1 1F A0 60 E0 01 2F E0
 C0 1F A1 3F C1 3F 74 C1 19 E2 60 E0 60 60 60 60
 C0 A1 2F C1 2F 70 52 44 31 1C A0 C0 22 E0 01 22
 E0 C0 22 01 A0 1C C3 A1 08 C4 35 C0 2E E1 05 80
 E0 E0 60 E0 E0 E5 52 C2 42 60 80 25 E0 C0 2F C0
 03 60 E0 C1 35 C1 3C C8 32 18 E2 05 80 60 60 60
 E0 60 80 A0 B6 19 80 35 C7 43 2E 1C A0 C0 28 E0
 C0 28 E0 C0 28 E0 1C 2E 44 C1 28 C3 19 C1 35 05
 1C A0 E0 1C A0 E0 1C A0 E0 1C A0 19 81 54 80 C1
 10 62 C0 31 60 C0 2E 60 C0 33 60 31 2E 60 C0 10
 31 52 80 C1 BF A2 BB AF A0 B7 A2 BF 51 C1 09 07
 25 09 35 C4 23 C2 07 1E 80 09 72 33 09 25 07 09
 C4 09 08 09 80 71 64 0A 2F 05 09 80 C2 35 01 09
 80 08 09 E3 E0 74 C0 07 80 2F 0B 35 05 C5 20 E2
 E0 C2 1D C3 20 C3 07 1E 80 09 0C C1 23 C9 1D C0
 00
  Encoded length: 417 bytes
  Wall pattern: 01, Wall color: 15     Floor pattern: 03, Floor color: 09
  Flags: WRAP_H EXIT_MOVES WRAP_V 
  Random food adds: 0
  Secret trick:  7 - Save Super Shots
 02 02 02 02 02 02 02 02 02 02 02 02 02 02 02 02 02 02 02 02 02 02 02 02 02 02 02 02 02 02 02 02
 00 00 00 00 00 00 00 00 00 20 20 20 21 00 00 00 00 00 00 00 21 19 19 19 00 00 00 00 00 00 00 00
 15 00 00 00 00 00 00 00 00 20 20 20 00 00 00 00 00 00 00 00 00 19 19 19 00 00 00 00 00 00 00 00
 00 00 00 00 00 00 00 00 00 20 20 20 00 00 00 26 62 26 00 00 00 19 19 19 00 00 00 00 00 00 00 00
 62 02 02 02 02 02 02 02 02 02 02 02 02 02 02 02 05 02 02 02 02 02 02 02 02 02 02 02 02 02 02 02
 29 01 00 00 00 00 00 00 00 00 00 00 00 00 00 00 51 00 00 00 00 00 00 00 00 00 00 00 00 00 00 01
 00 00 00 00 00 00 00 00 00 00 00 00 00 00 00 05 21 05 00 00 00 00 00 00 00 00 00 00 00 00 00 00
 00 00 00 00 00 00 00 00 28 00 00 00 00 00 00 00 49 00 00 00 00 00 00 00 28 00 00 00 00 00 00 00
 02 02 02 02 02 02 05 02 02 02 02 02 02 02 02 02 05 02 02 02 02 02 02 02 02 02 05 02 02 02 02 02
 00 00 00 00 00 00 00 00 00 00 00 00 00 05 00 01 62 01 00 05 00 00 00 00 00 00 00 00 00 00 00 00
 00 00 00 00 00 00 00 00 00 00 00 00 02 00 00 00 05 00 00 00 02 00 00 00 00 00 00 00 00 00 00 00
 00 00 00 00 00 00 00 29 00 00 00 02 40 02 58 02 00 02 58 02 40 05 00 00 00 29 00 00 00 00 00 00
 62 02 02 02 02 02 02 02 02 02 02 00 00 00 02 00 34 00 02 00 00 00 02 02 02 02 02 02 02 02 02 02
 08 56 00 02 24 25 24 25 24 02 31 05 00 05 00 05 00 02 00 02 00 05 31 02 24 25 24 25 24 02 00 56
 00 00 00 02 13 13 13 13 13 02 00 00 02 00 46 00 03 00 46 00 02 00 00 02 13 13 13 13 13 02 00 00
 00 00 00 02 00 00 00 00 00 02 00 05 00 02 00 02 00 05 00 05 00 05 00 02 00 00 00 00 00 02 00 00
 08 00 00 02 13 13 13 02 05 28 02 00 00 28 03 00 28 00 03 00 31 00 05 28 05 13 13 13 13 02 00 00
 29 08 00 02 46 00 53 02 28 03 00 05 00 05 00 02 00 05 00 02 00 05 00 00 02 00 00 00 35 02 00 08
 31 00 00 02 13 13 13 02 05 00 00 31 02 00 05 00 02 01 47 00 02 00 31 02 02 63 00 00 63 02 00 00
 00 00 01 02 00 25 00 02 00 02 00 05 00 02 00 05 00 05 00 05 00 05 00 02 02 47 00 00 47 02 01 00
 00 00 08 02 13 13 13 02 49 28 02 00 34 00 02 01 34 00 02 00 34 01 02 28 02 02 00 00 02 02 08 00
 00 00 00 02 53 00 46 02 00 02 05 05 00 02 00 02 00 05 00 02 00 02 00 00 02 02 00 00 02 02 00 00
 08 00 00 02 13 13 13 02 05 05 37 00 02 00 47 00 03 00 05 00 02 00 00 53 02 02 60 00 00 02 00 00
 00 00 00 02 50 24 00 02 00 02 05 05 00 05 00 05 00 05 00 02 00 05 05 02 02 02 25 53 00 02 00 00
 00 00 00 02 13 13 13 02 46 28 02 00 40 00 02 00 40 00 02 00 40 00 02 28 46 02 13 13 13 02 00 00
 40 00 00 02 00 25 00 02 53 05 28 02 00 02 28 02 00 02 28 02 00 02 28 02 25 02 25 00 00 02 00 00
 08 08 00 02 16 00 00 02 05 00 49 00 05 00 46 00 05 00 51 00 05 49 46 00 05 02 16 49 00 02 00 08
 08 00 00 02 02 02 02 02 02 02 02 02 02 02 02 02 02 02 02 02 02 02 02 02 02 02 02 02 02 02 00 00
 08 00 00 09 07 37 09 53 00 00 00 00 00 35 00 00 00 07 30 30 09 00 00 00 01 51 09 37 07 09 00 00
 00 00 00 09 08 09 09 00 00 01 00 00 00 00 00 05 10 47 05 09 09 00 00 00 53 01 09 09 08 09 00 00
 00 00 02 00 02 00 00 00 00 00 01 00 07 07 47 11 53 05 00 00 00 00 00 00 32 00 00 00 02 00 02 00
 00 00 29 00 00 00 00 32 00 00 00 00 07 30 30 09 12 00 00 35 00 00 00 00 00 00 00 00 00 00 29 00
