Gauntlet II
Maze number: 65
Offset for maze 64: 229756 - 0x03817c
big endian buf: [%!l(uint8=0) %!l(uint8=3) %!l(uint8=129) %!l(uint8=124)]
G:2 Maze real addr: 246140 - 0x03C17C, bank 2, boff: 0x4000
Maze read from: 0x03c17c - 246140
compresssed: 280
 04 00 60 88 00 72 0E 48 49 07 12 A0 1A C0 21 C2
 2F C3 01 D1 1A A0 C5 07 08 09 E0 01 CE 1E C2 3F
 C4 B2 41 C1 01 AE 3F C5 3F C1 3F 10 39 07 C0 A1
 D8 04 A3 22 C8 1E D0 35 C6 AB 04 3F A3 CB A1 C0
 31 C8 35 C0 10 39 09 2F C9 2D A1 38 4F C9 A1 C4
 1F C4 A1 63 08 07 C4 21 E3 04 09 89 04 A0 C2 B3
 1D D0 19 C0 33 C0 19 E4 C1 2E A0 E0 C2 25 C8 07
 87 E2 E2 01 82 4A 46 C2 38 A0 D1 08 40 83 40 E3
 1D D0 08 60 62 40 D6 08 3B 09 C0 0F 60 3B 08 D0
 BB 2E 43 60 62 40 D0 1D A0 43 40 83 40 CA BF C1
 BE E2 38 42 46 CB 01 81 A0 E2 C2 07 87 C8 25 E2
 E0 E2 7A 5A C2 19 C0 33 C0 19 C2 5A 7A CB 1D E3
 04 09 89 04 A0 C3 21 C4 07 08 09 C3 A1 C4 1F C4
 A1 49 CF 38 A1 2D C9 2F 09 39 10 B3 35 C8 31 C0
 A1 CC A2 3F 04 AB C6 35 BB D0 1E C7 22 A3 04 C1
 BE C1 B8 D2 A1 C0 07 39 10 3F C1 3F C1 3F C2 3F
 AE 01 41 E7 C2 1E CE 01 A0 60 08 07 E5 1A D1 01
 C3 2F B2 C1 21 C0 1A 00
  Encoded length: 280 bytes
  Wall pattern: 02, Wall color: 14     Floor pattern: 07, Floor color: 00
  Flags: FAST_DEATHS WALLS_CYCLIC EXIT_CHOOSE_ONE FAST_AUX_GRUNTS 
  Random food adds: 0
  Secret trick:  4 - Try Transportability (onto secret wall)
 02 02 02 02 02 02 02 02 02 02 02 02 02 02 02 02 02 02 02 02 02 02 02 02 02 02 02 02 02 02 02 02 02
 02 26 00 33 00 00 02 47 00 00 00 00 01 00 00 00 00 00 00 00 00 00 00 00 00 00 00 00 00 00 00 26 02
 02 00 00 00 00 00 02 07 08 09 00 02 01 00 00 00 00 00 00 00 00 00 00 00 00 00 00 00 30 00 00 00 02
 63 00 00 00 00 00 02 00 00 08 00 00 01 02 02 02 02 02 02 02 02 02 02 02 02 02 02 02 63 00 00 00 63
 02 00 00 63 00 00 63 16 57 07 00 02 02 00 00 00 00 00 00 00 00 00 00 00 00 00 00 00 00 00 00 00 02
 02 00 00 02 00 00 04 02 02 02 02 34 00 00 00 00 00 00 00 00 00 30 00 00 00 00 00 00 00 00 00 00 02
 02 00 00 02 00 00 02 53 00 00 00 00 00 00 00 02 02 02 02 02 02 02 02 02 02 02 02 04 63 02 02 02 02
 02 00 00 02 00 00 02 00 00 00 00 00 00 02 02 00 49 00 00 00 00 00 00 00 00 00 53 02 16 57 09 47 02
 02 00 00 02 00 00 02 00 00 00 45 02 02 56 00 00 00 00 00 00 00 00 00 00 00 00 00 02 00 00 08 00 02
 02 00 00 02 00 00 02 00 00 02 02 00 00 00 00 00 31 00 00 00 00 00 02 02 00 00 00 02 09 08 07 00 02
 02 00 00 02 33 00 02 00 00 02 04 09 09 09 09 09 09 09 09 09 09 09 04 02 00 00 00 02 29 00 00 00 02
 02 00 00 02 00 00 02 00 00 18 07 00 00 00 25 00 51 00 25 00 00 00 07 18 02 00 00 46 02 00 02 00 02
 02 00 37 02 00 00 02 00 00 18 07 00 07 07 07 07 07 07 07 07 07 00 07 18 02 00 00 00 02 01 01 01 02
 02 00 00 02 00 00 02 00 00 18 07 00 08 00 00 00 00 00 00 00 08 00 07 18 56 02 00 00 00 02 00 00 02
 02 00 00 02 00 00 02 00 00 18 07 00 08 00 08 08 08 08 08 00 08 00 07 18 00 02 29 00 00 02 00 00 02
 02 00 00 02 00 00 02 00 00 18 07 00 08 00 09 00 00 00 09 00 08 00 07 18 00 00 02 00 00 02 00 00 02
 02 00 00 02 00 00 02 00 00 18 07 00 08 59 09 00 15 00 09 59 08 00 07 18 00 00 02 00 00 02 00 00 02
 02 00 00 02 00 00 02 46 00 18 07 00 08 00 09 00 00 00 09 00 08 00 07 18 00 00 02 00 00 02 00 00 02
 02 00 00 02 00 00 29 02 00 18 07 00 08 00 08 08 08 08 08 00 08 00 07 18 00 00 02 00 00 02 00 00 02
 02 00 00 02 00 00 00 02 56 18 07 00 08 00 00 00 00 00 00 00 08 00 07 18 00 00 02 00 00 02 00 00 02
 02 01 01 01 02 00 00 00 02 18 07 00 07 07 07 07 07 07 07 07 07 00 07 18 00 00 02 00 00 02 37 00 02
 02 00 02 00 02 00 00 00 02 18 07 00 00 00 25 00 51 00 25 00 00 00 07 18 00 00 02 00 00 02 00 00 02
 02 00 00 00 29 02 00 00 00 02 04 09 09 09 09 09 09 09 09 09 09 09 04 02 00 00 02 00 33 02 00 00 02
 02 00 07 08 09 02 00 00 00 02 02 00 00 00 00 00 31 00 00 00 00 00 02 02 00 00 02 00 00 02 00 00 02
 02 00 08 00 00 02 00 00 00 00 00 00 00 00 00 00 00 00 00 56 02 02 45 00 00 00 02 00 00 02 00 00 02
 02 47 09 57 16 02 53 00 00 00 00 00 00 00 00 00 49 00 02 02 00 00 00 00 00 00 02 00 00 02 00 00 02
 02 02 02 02 63 04 02 02 02 02 02 02 02 02 02 02 02 02 00 00 00 00 00 00 00 53 02 00 00 02 00 00 02
 02 00 00 00 00 00 00 00 00 00 00 00 30 00 00 00 00 00 00 00 00 34 02 02 02 02 04 00 00 02 00 00 02
 02 00 00 00 00 00 00 00 00 00 00 00 00 00 00 00 00 00 00 00 02 02 00 07 57 16 63 00 00 63 00 00 02
 63 00 00 00 63 02 02 02 02 02 02 02 02 02 02 02 02 02 02 02 01 00 00 08 00 00 02 00 00 00 00 00 63
 02 00 00 00 30 00 00 00 00 00 00 00 00 00 00 00 00 00 00 00 01 02 00 09 08 07 02 00 00 00 00 00 02
 02 26 00 00 00 00 00 00 00 00 00 00 00 00 00 00 00 00 00 00 01 00 00 00 00 47 02 00 00 33 00 26 02
 02 02 02 02 02 02 02 02 02 02 02 02 02 02 02 02 02 02 02 02 02 02 02 02 02 02 02 02 02 02 02 02 02
