Gauntlet II
Maze number: 16
Offset for maze 15: 232815 - 0x038d6f
big endian buf: [%!l(uint8=0) %!l(uint8=3) %!l(uint8=141) %!l(uint8=111)]
G:2 Maze real addr: 232815 - 0x038D6F, bank 0, boff: 0x0000
Maze read from: 0x038d6f - 232815
compresssed: 329
 0B 01 02 80 64 2F 11 47 6E 9C 71 C9 35 C0 0F C0
 0E 38 C5 38 05 1A 18 A0 28 46 1F 40 80 21 C4 0E
 E0 54 A0 4F C4 0E E1 E4 C7 B3 40 81 C3 B3 C3 0E
 E4 C1 05 E1 28 C0 2F 2E 41 42 40 0A 07 A4 E5 C1
 A4 E1 45 C1 0A 62 E5 74 CD 0A E0 E6 1F 20 35 C4
 35 15 C1 B2 C1 A1 43 E1 C1 38 75 B2 C1 A3 0D 80
 73 40 82 0D 80 07 80 A1 05 A0 C0 A3 E0 51 2E C5
 A2 F2 C1 A1 C1 1F E5 E3 C6 A1 53 B6 E5 C2 1A 22
 A0 E1 22 E8 C2 0B 04 E2 C1 2F 60 C0 35 C7 1C 18
 61 1A 80 1D C2 1D 04 2E 71 A2 B2 A0 B5 A4 C3 0D
 81 C0 08 86 A0 08 B2 A2 C5 35 2F F1 22 63 19 E2
 1F E4 C6 0B E7 C0 B5 E5 C4 23 76 C1 22 A0 33 C4
 0C C8 0B 08 82 C0 15 81 C0 25 C2 A8 E2 E4 C6 B9
 E7 C3 09 E1 E0 C3 52 BF C2 1D 05 C5 15 80 2E 1A
 C1 09 E0 C0 1D E0 CB 05 EB C7 B8 C2 1D D1 15 A3
 09 82 15 A0 05 80 A0 B2 A8 C3 A4 E2 0C CA 2F C3
 5B A0 29 A0 E7 29 C3 10 C1 BC C2 B4 62 E3 CB 0A
 B4 32 42 C2 0B A0 E3 C4 A5 07 80 A2 15 A8 C9 19
 80 1A B4 35 C4 1A 61 C2 0A C2 08 CD 2F E2 53 10
 64 08 E8 63 E1 59 A0 E0 C3 B5 33 E1 1E E2 C7 B3
 31 C2 1A 51 A0 19 1A C1 00
  Encoded length: 329 bytes
  Wall pattern: 15, Wall color: 01     Floor pattern: 02, Floor color: 01
  Flags: EXIT_CHOOSE_ONE TRAPS_LOCAL FAST_GRUNTS EXIT_FAKE WRAP_H ODDANGLE_GHOSTS 
  Random food adds: 0
  Secret trick: 11 - Don't Be Fooled
 02 02 02 02 02 02 02 02 02 02 02 02 02 02 02 02 02 02 02 02 02 02 02 02 02 02 02 02 02 02 02 02
 02 00 00 00 00 00 00 00 00 02 53 00 15 00 14 56 00 00 00 00 00 00 56 05 26 24 02 40 00 00 00 00
 02 00 00 07 31 00 07 07 33 02 00 00 00 00 14 00 02 28 00 00 00 00 00 02 00 00 00 00 00 00 00 00
 02 00 00 00 00 00 00 00 07 02 00 00 00 00 14 00 00 02 00 00 00 00 00 02 00 00 00 00 00 00 00 00
 02 00 07 07 07 00 00 00 00 02 00 00 00 00 14 00 00 00 00 00 02 00 00 05 00 00 02 40 00 47 46 00
 00 07 00 00 00 07 00 07 10 07 02 02 02 02 02 00 00 00 00 00 00 02 00 00 02 02 02 02 02 00 00 02
 02 00 00 00 00 00 07 00 00 10 00 00 00 46 02 00 00 00 00 00 02 00 00 02 00 00 49 02 00 00 00 00
 02 00 00 00 00 00 00 00 00 10 00 02 00 00 02 00 00 00 00 02 31 32 53 02 00 00 00 02 53 21 00 00
 02 00 00 02 02 00 00 00 00 07 00 00 02 00 02 56 00 00 00 00 00 00 49 02 00 00 02 02 02 02 13 13
 00 00 00 00 49 02 07 07 07 07 13 13 07 07 02 02 05 02 00 02 02 02 02 00 02 28 00 02 46 00 00 00
 00 00 00 02 02 02 00 00 00 00 00 00 00 00 02 00 00 00 02 00 00 00 00 00 00 02 00 02 02 02 00 00
 31 00 00 00 00 02 00 02 00 00 00 00 02 00 02 00 00 00 02 00 02 02 28 00 00 00 00 02 00 00 00 00
 02 00 02 02 00 02 26 34 02 00 00 02 34 00 02 00 00 00 02 00 00 00 02 00 00 00 11 04 00 02 00 02
 02 00 47 02 46 02 53 00 00 00 00 00 00 00 02 28 24 00 02 46 26 26 29 02 00 00 29 04 46 02 00 49
 02 02 02 02 02 02 02 02 02 02 02 00 00 00 02 13 13 13 02 08 08 08 08 02 08 08 08 02 08 02 02 02
 02 00 00 00 00 00 00 53 47 02 00 00 00 00 02 00 00 00 02 00 00 00 00 02 00 00 00 02 34 00 00 00
 02 46 25 00 00 00 02 31 00 02 00 00 00 02 02 00 00 00 02 00 00 11 00 02 00 00 00 00 00 00 02 00
 02 00 00 00 00 00 00 02 00 02 00 00 00 35 02 00 00 00 02 00 00 49 00 02 34 02 51 00 00 00 00 00
 12 00 00 00 00 00 00 00 00 02 11 08 08 08 02 00 21 21 02 00 37 00 00 02 02 02 02 02 02 02 02 02
 02 00 00 00 02 00 00 00 00 02 02 00 00 00 02 00 00 00 02 00 00 00 00 02 00 00 00 02 00 00 00 00
 09 00 00 02 00 02 00 00 00 02 28 00 00 00 02 00 00 00 29 05 00 00 00 02 00 00 21 21 46 26 00 00
 09 00 02 00 29 00 02 00 00 02 00 00 00 00 02 00 00 00 00 05 00 00 00 02 00 00 00 02 00 00 00 00
 02 00 00 00 00 00 00 00 00 02 00 00 00 29 02 00 00 00 02 00 00 00 00 02 00 00 00 02 00 00 00 00
 21 02 02 02 02 09 09 09 09 21 02 05 05 02 02 02 02 02 02 02 02 02 02 02 00 00 00 02 02 02 02 02
 02 00 00 00 02 12 00 00 00 02 00 00 00 00 00 00 00 47 02 00 00 00 28 02 00 00 00 02 00 00 00 00
 00 00 00 02 41 02 00 00 00 02 00 00 00 00 02 41 00 00 02 00 16 00 00 02 00 00 00 02 00 00 00 46
 02 00 00 00 02 00 00 00 00 02 00 00 00 00 00 00 00 10 02 50 00 00 00 07 00 00 00 11 02 00 00 00
 02 02 00 00 00 00 00 02 02 02 02 02 02 07 07 02 02 02 21 02 02 02 02 02 02 02 02 02 00 00 00 00
 02 00 00 00 00 00 25 25 26 02 53 00 00 00 00 00 26 00 02 46 00 00 00 10 00 00 00 08 00 00 00 00
 02 00 00 00 00 00 00 00 00 00 47 00 00 00 02 28 00 00 02 00 16 00 00 00 00 00 46 08 00 00 00 00
 02 00 00 00 00 02 00 00 00 00 46 00 00 02 28 00 00 00 02 00 00 00 00 00 00 02 00 02 00 00 00 00
 02 51 00 00 02 30 00 00 00 02 00 00 00 00 00 00 00 00 02 49 00 00 00 26 28 00 00 02 25 26 00 00
 02 02 02 02 02 02 02 02 02 02 02 02 02 02 02 02 02 02 02 02 02 02 02 02 02 02 02 02 02 02 02 02
