Gauntlet II
Maze number: 29
Offset for maze 28: 236168 - 0x039a88
big endian buf: [%!l(uint8=0) %!l(uint8=3) %!l(uint8=154) %!l(uint8=136)]
G:2 Maze real addr: 236168 - 0x039A88, bank 0, boff: 0x0000
Maze read from: 0x039a88 - 236168
compresssed: 178
 08 00 00 03 01 40 15 60 5C 5D 59 33 80 CD 0E C6
 32 10 C8 0F 64 43 E4 C2 10 42 F6 D9 35 43 D3 31
 DF 52 4B 19 A0 CD B6 C6 B4 C9 2E 64 63 C0 0E ED
 C0 21 19 2E C1 A4 31 C2 35 0E C5 35 40 C8 2E C1
 A3 B2 A5 C1 1F CB 2E 81 1A DF C1 3C D5 35 C8 A5
 C2 B3 A3 BB 0D 84 BC A4 0D A0 0D D6 12 84 50 4D
 5B C4 BF C2 1F DF D8 20 C8 B4 2E D0 3A C8 1F C1
 04 AF A2 B6 E0 1A C8 18 79 D7 1C 4E C6 33 5C 4D
 D4 1E 75 47 DF 63 CB 31 C1 1E CB B7 56 D6 0E CC
 1E 75 43 C4 0E DF 58 BA C6 1E 1A 81 6B C6 0E 78
 BE 3B 1A C4 1A 35 B2 2E 72 BA 35 C2 0E C1 1E C5
 35 00
  Encoded length: 178 bytes
  Wall pattern: 00, Wall color: 05     Floor pattern: 04, Floor color: 01
  Flags: SHOTS_STUN 
  Random food adds: 3
  Secret trick:  8 - Don't Use Invulnerability
 02 02 02 02 02 02 02 02 02 02 02 02 02 02 02 02 02 02 02 02 02 02 02 02 02 02 02 02 02 02 02 02 02
 02 51 00 00 00 00 00 00 00 00 00 02 00 00 00 00 14 00 00 00 00 00 00 02 50 16 00 00 00 00 00 00 02
 02 00 00 15 00 00 00 00 00 28 00 02 00 00 32 00 02 00 00 00 02 00 00 02 16 00 00 00 32 00 00 00 02
 02 00 00 00 00 00 00 00 00 00 00 02 00 00 00 00 02 00 00 02 02 00 00 02 00 00 00 00 00 00 00 00 02
 02 00 00 00 00 00 00 00 00 00 00 02 00 00 00 53 02 00 00 02 32 00 00 02 00 00 00 00 00 00 00 00 02
 02 00 00 00 00 00 00 00 00 49 00 02 00 00 00 00 02 00 00 02 00 00 00 02 00 00 00 00 00 00 00 00 02
 02 00 00 00 00 00 00 00 00 00 00 02 00 29 00 00 02 00 00 02 00 00 00 02 00 00 32 25 02 00 00 00 02
 02 00 00 00 00 00 00 00 00 00 00 02 00 00 00 00 02 00 00 02 00 00 00 02 00 00 00 00 00 00 46 00 02
 02 00 00 00 28 02 00 00 00 28 00 14 00 00 00 00 02 00 00 00 00 00 00 02 00 00 02 00 33 25 46 00 02
 02 02 02 02 02 02 49 00 00 00 53 14 00 00 00 00 02 00 53 00 32 00 00 02 00 00 00 00 00 00 46 00 02
 02 02 02 02 02 02 02 02 02 02 02 02 00 00 31 00 02 00 00 00 00 00 00 02 00 00 00 46 46 46 26 00 02
 02 00 00 00 00 00 00 00 00 00 00 02 00 00 00 00 02 00 00 00 00 00 00 02 00 00 00 00 00 00 00 00 02
 02 60 00 00 00 00 00 00 00 00 00 02 00 00 00 00 02 00 00 00 00 00 00 02 53 00 00 00 00 00 00 00 02
 02 00 02 02 02 02 02 02 00 00 00 02 02 02 02 02 02 13 13 13 13 13 13 02 02 02 02 02 02 13 02 13 02
 02 00 00 00 00 00 00 00 02 00 00 00 00 00 00 00 00 00 00 00 00 00 00 18 18 18 18 18 02 00 29 00 02
 02 00 00 00 00 00 00 00 02 00 00 00 00 32 00 00 00 00 00 00 00 00 00 00 00 00 29 00 02 00 00 00 02
 02 00 00 00 31 00 00 00 02 00 00 00 00 00 00 00 00 00 00 00 00 00 00 00 00 00 00 00 02 00 00 00 02
 02 00 00 00 00 00 00 00 02 00 00 00 00 00 00 00 00 00 00 00 00 00 00 00 00 00 00 00 02 00 32 00 02
 02 00 00 00 00 00 00 00 02 46 00 00 00 00 00 00 00 00 00 00 00 00 00 00 00 00 00 58 02 00 00 00 02
 02 00 00 00 00 31 00 00 04 02 02 02 02 02 02 02 02 02 02 02 02 02 02 02 02 02 02 02 02 00 02 26 02
 02 00 00 00 00 00 00 00 00 24 02 00 00 00 00 00 00 00 00 00 25 02 00 00 00 00 00 00 00 00 00 00 02
 02 00 00 00 00 00 00 00 00 00 02 00 00 28 00 00 02 00 00 00 00 02 00 00 00 00 00 00 00 32 00 00 02
 02 00 00 00 00 51 00 00 00 00 02 00 00 00 00 00 02 00 00 29 00 02 00 00 00 00 00 00 00 00 00 00 02
 02 00 32 00 00 00 00 00 00 00 02 00 00 00 00 00 02 00 00 00 00 02 00 00 30 00 00 00 00 00 00 25 02
 02 00 00 00 00 00 00 00 32 00 02 00 00 00 00 00 02 00 00 00 00 02 00 00 00 00 00 00 00 00 00 00 02
 02 00 00 00 00 00 00 00 00 00 02 00 00 28 00 00 02 00 00 00 00 02 00 00 00 00 49 00 00 30 00 00 02
 02 00 00 00 00 00 00 00 00 00 02 00 00 00 00 00 02 00 29 00 00 02 00 00 00 00 00 00 00 00 00 00 02
 02 00 00 00 00 00 00 00 00 00 14 00 00 00 00 00 02 00 00 00 00 02 00 00 30 00 00 00 00 00 00 25 02
 02 00 00 00 32 00 00 00 00 00 14 00 00 00 00 00 02 00 00 00 00 02 00 00 00 00 00 00 00 00 00 00 02
 02 00 00 00 00 00 00 00 00 00 02 00 00 00 00 00 02 00 00 00 29 02 00 00 00 00 00 00 00 30 26 26 02
 02 00 00 00 00 00 00 00 00 00 02 00 00 28 00 00 02 00 00 00 00 14 00 00 00 00 00 00 00 00 00 25 02
 02 59 26 00 00 00 00 00 26 53 02 46 00 00 00 25 02 53 00 00 00 14 00 00 30 00 00 00 00 00 00 53 02
 02 02 02 02 02 02 02 02 02 02 02 02 02 02 02 02 02 02 02 02 02 02 02 02 02 02 02 02 02 02 02 02 02
