Gauntlet II
Maze number: 26
Offset for maze 25: 235401 - 0x039789
big endian buf: [%!l(uint8=0) %!l(uint8=3) %!l(uint8=151) %!l(uint8=137)]
G:2 Maze real addr: 235401 - 0x039789, bank 0, boff: 0x0000
Maze read from: 0x039789 - 235401
compresssed: 268
 0C 00 00 40 20 74 B9 AE 5C 35 41 10 C0 27 10 C0
 27 C0 10 81 C5 31 C0 10 80 C0 48 0E 0D C5 40 01
 80 70 A4 21 81 C9 0D 31 C6 B2 C4 15 82 C4 A3 C5
 B3 0D 80 B3 E1 70 70 C0 B2 A2 B3 0D 80 B3 C4 22
 A0 1D FE C4 22 D8 22 A0 1D FE E0 23 C1 4F 1C C7
 22 A0 C0 A3 C8 09 C5 33 1C ED CD B2 A1 CD 23 A0
 CF 47 A5 C0 05 CA A8 C4 05 84 E0 C9 07 15 83 31
 2F E4 05 A0 05 A0 05 A1 23 A0 C8 07 15 84 44 A0
 05 84 0C A0 0C A0 C7 A7 B3 2E A2 D8 28 A0 1C A1
 0A 80 CF 0F C6 0B A0 4F CB 0B A0 61 6A A2 B3 EA
 61 6A A0 ED 6D A0 ED 40 1C C0 36 68 A0 C2 1D 80
 C2 5C C5 10 60 6A A0 C8 34 C5 31 CA 2E 1C A0 C8
 BF A0 BF D0 1C A0 70 CE B4 1C C4 43 A1 72 73 E9
 1C A8 32 0E E8 0D 82 C1 0D E2 C0 40 2A C3 40 0E
 C2 A1 C3 1E D8 15 08 C3 0D 83 E7 B3 CA 15 08 C2
 B3 C6 44 0E C2 27 C3 B2 40 B3 10 08 41 05 1E C1
 10 B4 2E B4 10 B4 C3 0E C3 10 C1 00
  Encoded length: 268 bytes
  Wall pattern: 04, Wall color: 09     Floor pattern: 07, Floor color: 11
  Flags: WRAP_H EXIT_MOVES 
  Random food adds: 0
  Secret trick: 12 - Don't Be Greedy (no keys or potions)
 02 02 02 02 02 02 02 02 02 02 02 02 02 02 02 02 02 02 02 02 02 02 02 02 02 02 02 02 02 02 02 02
 16 02 39 16 02 39 00 16 02 16 00 00 00 00 00 00 49 02 16 16 02 46 00 00 00 00 00 00 00 00 00 14
 13 02 00 00 02 00 00 46 02 01 01 00 01 02 02 02 02 02 33 33 02 00 00 00 00 00 00 00 00 00 00 13
 49 02 00 00 02 00 00 00 02 00 00 00 00 02 21 21 21 02 00 00 02 00 00 02 02 02 02 00 00 00 00 00
 00 02 13 13 02 00 00 02 00 01 00 01 00 02 02 02 02 02 13 13 02 00 00 00 00 00 34 02 29 00 00 00
 00 00 00 00 00 00 00 00 00 00 00 00 00 00 00 00 00 00 00 00 00 00 00 00 00 00 00 00 02 00 00 00
 00 00 34 00 00 00 00 00 00 00 00 00 00 00 00 00 00 00 00 00 00 00 00 00 00 00 00 00 34 02 29 00
 00 00 00 00 00 00 00 00 00 00 00 00 00 00 00 00 00 00 00 00 00 00 00 00 00 00 00 00 00 00 02 00
 02 35 00 00 46 00 00 00 00 00 00 00 00 00 00 00 00 00 00 00 02 28 00 00 00 00 00 00 00 00 34 02
 00 02 02 02 02 00 00 00 00 00 00 00 00 02 09 02 00 00 00 00 02 51 28 00 00 00 00 00 00 00 00 00
 00 00 00 00 00 02 00 00 00 00 00 00 00 02 53 02 00 00 00 00 02 02 02 00 00 00 00 00 00 00 00 00
 00 00 00 00 00 35 02 00 00 00 00 00 00 02 53 02 00 00 00 00 00 00 00 46 00 00 00 00 00 00 00 00
 02 02 02 02 02 02 00 05 00 00 00 00 00 02 53 02 00 00 00 02 02 02 02 02 02 02 02 02 00 00 00 00
 00 05 05 05 05 05 05 00 02 00 00 00 00 02 53 02 00 00 00 07 21 21 21 21 21 49 47 02 00 00 00 00
 02 05 02 05 02 05 02 02 35 02 00 00 00 02 53 02 00 00 00 07 21 21 21 21 21 21 46 02 00 00 00 00
 02 05 05 05 05 05 05 12 02 12 02 00 00 02 53 02 00 00 00 02 02 02 02 02 02 02 02 02 46 02 02 02
 00 00 00 00 00 00 00 00 00 00 00 02 00 02 53 02 00 00 00 00 00 00 00 00 00 40 02 28 02 02 10 10
 00 00 00 00 00 00 00 00 00 00 00 02 00 02 53 02 15 00 00 00 00 00 00 00 11 02 46 00 00 00 00 00
 00 00 00 00 00 00 00 00 00 00 00 02 00 02 53 02 00 00 00 00 00 00 00 11 02 00 00 28 00 00 00 00
 00 00 00 00 00 00 00 28 02 02 02 02 00 02 53 02 00 00 00 00 00 00 00 02 00 00 28 00 00 00 00 00
 00 00 00 00 00 00 28 02 00 00 00 00 00 02 53 02 00 00 00 00 00 00 02 00 00 00 00 00 00 00 00 00
 00 00 00 00 00 28 02 00 00 00 00 00 00 02 53 02 00 00 00 00 02 02 46 00 28 00 54 00 00 00 00 00
 00 00 00 00 28 02 00 00 00 29 29 00 00 02 53 02 00 00 00 00 02 16 00 28 00 00 00 00 00 00 00 00
 00 00 00 28 02 00 00 00 00 00 00 00 00 02 52 02 00 00 00 00 02 49 00 00 00 00 00 00 00 00 00 00
 00 46 28 02 00 00 00 00 00 00 00 00 00 02 02 02 00 00 00 00 02 00 00 00 00 00 00 00 00 00 00 00
 00 28 02 00 01 00 00 00 00 00 00 00 00 00 00 00 00 00 00 00 02 28 00 00 00 00 00 46 00 00 00 00
 02 02 00 00 00 01 00 00 00 00 01 00 00 00 00 00 00 00 00 00 00 02 28 02 02 02 02 02 02 02 02 02
 50 14 00 00 00 00 00 00 00 00 02 02 13 13 13 02 00 02 13 02 00 00 02 00 46 02 42 00 00 00 00 46
 00 14 00 00 02 02 02 00 00 00 02 30 00 00 00 02 00 02 00 02 00 00 00 00 00 02 00 00 00 00 00 00
 00 02 00 00 02 21 08 00 00 00 02 13 13 13 13 02 00 02 00 02 00 00 00 00 02 02 00 00 00 00 00 00
 00 02 00 00 02 21 08 00 00 00 02 00 00 00 00 02 00 02 46 02 00 00 00 00 14 00 00 00 39 00 00 00
 00 02 46 00 02 16 08 46 00 00 05 30 00 00 16 02 46 02 16 02 00 00 00 00 14 00 00 00 00 16 00 00
 02 02 02 02 02 02 02 02 02 02 02 02 02 02 02 02 02 02 02 02 02 02 02 02 02 02 02 02 02 02 02 02
